Date_reported,Country_code,Country,New_cases,Cumulative_cases,New_deaths,Cumulative_deaths,lethality_rate
2022-03-27,AS,American Samoa,1881,3278,2,2,0.06101281269066504
2022-04-03,AS,American Samoa,1378,4656,5,7,0.15034364261168387
2022-04-10,AS,American Samoa,746,5402,4,11,0.20362828582006662
2022-04-17,AS,American Samoa,133,5535,7,18,0.3252032520325203
2022-04-24,AS,American Samoa,230,5765,5,23,0.398959236773634
2022-05-01,AS,American Samoa,92,5857,3,26,0.4439132661772239
2022-05-08,AS,American Samoa,98,5955,3,29,0.48698572628043657
2022-05-15,AS,American Samoa,63,6018,1,30,0.4985044865403789
2022-05-22,AS,American Samoa,65,6083,0,30,0.4931777083675818
2022-05-29,AS,American Samoa,62,6145,1,31,0.5044751830756713
2022-06-05,AS,American Samoa,124,6269,0,31,0.49449672994097943
2022-06-12,AS,American Samoa,73,6342,0,31,0.48880479344055505
2022-06-19,AS,American Samoa,72,6414,0,31,0.48331774243841596
2022-06-26,AS,American Samoa,91,6505,0,31,0.47655649500384323
2022-07-03,AS,American Samoa,0,6505,0,31,0.47655649500384323
2022-07-10,AS,American Samoa,0,6505,0,31,0.47655649500384323
2022-07-17,AS,American Samoa,963,7468,2,33,0.4418853776111409
2022-07-24,AS,American Samoa,0,7468,0,33,0.4418853776111409
2022-07-31,AS,American Samoa,298,7766,0,33,0.424929178470255
2022-08-07,AS,American Samoa,186,7952,0,33,0.414989939637827
2022-08-14,AS,American Samoa,90,8042,0,33,0.410345685152947
2022-08-21,AS,American Samoa,0,8042,0,33,0.410345685152947
2022-08-28,AS,American Samoa,126,8168,1,34,0.416258570029383
2022-09-04,AS,American Samoa,0,8168,0,34,0.416258570029383
2022-09-11,AS,American Samoa,49,8217,0,34,0.4137763173907752
2022-09-18,AS,American Samoa,18,8235,0,34,0.4128718882817244
2022-09-25,AS,American Samoa,12,8247,0,34,0.41227112889535594
2022-10-02,AS,American Samoa,3,8250,0,34,0.4121212121212121
2022-10-09,AS,American Samoa,0,8250,0,34,0.4121212121212121
2022-10-16,AS,American Samoa,1,8251,0,34,0.41207126408920136
2022-10-23,AS,American Samoa,2,8253,0,34,0.41197140433781654
2022-10-30,AS,American Samoa,4,8257,0,34,0.4117718299624561
2022-11-06,AS,American Samoa,0,8257,0,34,0.4117718299624561
2022-11-13,AS,American Samoa,5,8262,0,34,0.411522633744856
2022-11-20,AS,American Samoa,1,8263,0,34,0.41147283069103235
2022-11-27,AS,American Samoa,1,8264,0,34,0.41142303969022265
2022-12-04,AS,American Samoa,0,8264,0,34,0.41142303969022265
2022-12-11,AS,American Samoa,1,8265,0,34,0.411373260738052
2022-12-18,AS,American Samoa,1,8266,0,34,0.4113234938301476
2022-12-25,AS,American Samoa,0,8266,0,34,0.4113234938301476
2023-01-01,AS,American Samoa,19,8285,0,34,0.4103802051901026
2023-01-08,AS,American Samoa,17,8302,0,34,0.4095398699108649
2023-01-15,AS,American Samoa,7,8309,0,34,0.40919484895896013
2023-01-22,AS,American Samoa,8,8317,0,34,0.4088012504508838
2023-01-29,AS,American Samoa,3,8320,0,34,0.4086538461538462
2023-02-05,AS,American Samoa,0,8320,0,34,0.4086538461538462
2023-02-12,AS,American Samoa,0,8320,0,34,0.4086538461538462
2023-02-19,AS,American Samoa,0,8320,0,34,0.4086538461538462
2023-02-26,AS,American Samoa,0,8320,0,34,0.4086538461538462
2023-03-05,AS,American Samoa,0,8320,0,34,0.4086538461538462
2023-03-12,AS,American Samoa,0,8320,0,34,0.4086538461538462
2023-03-19,AS,American Samoa,1,8321,0,34,0.4086047350078116
2023-03-26,AS,American Samoa,3,8324,0,34,0.40845747236905333
2023-04-02,AS,American Samoa,2,8326,0,34,0.40835935623348546
2023-04-09,AS,American Samoa,1,8327,0,34,0.4083103158400384
2023-04-16,AS,American Samoa,2,8329,0,34,0.40821227038059793
2023-04-23,AS,American Samoa,0,8329,0,34,0.40821227038059793
2023-04-30,AS,American Samoa,0,8329,0,34,0.40821227038059793
2023-05-07,AS,American Samoa,2,8331,0,34,0.4081142719961589
2023-05-14,AS,American Samoa,0,8331,0,34,0.4081142719961589
2023-05-21,AS,American Samoa,0,8331,0,34,0.4081142719961589
2023-05-28,AS,American Samoa,0,8331,0,34,0.4081142719961589
2023-06-04,AS,American Samoa,1,8332,0,34,0.40806529044647144
2023-06-11,AS,American Samoa,0,8332,0,34,0.40806529044647144
2023-06-18,AS,American Samoa,0,8332,0,34,0.40806529044647144
2023-06-25,AS,American Samoa,0,8332,0,34,0.40806529044647144
2023-07-02,AS,American Samoa,0,8332,0,34,0.40806529044647144
2023-07-09,AS,American Samoa,9,8341,0,34,0.4076249850137873
2023-07-16,AS,American Samoa,0,8341,0,34,0.4076249850137873
2023-07-23,AS,American Samoa,0,8341,0,34,0.4076249850137873
2023-07-30,AS,American Samoa,0,8341,0,34,0.4076249850137873
2023-08-06,AS,American Samoa,0,8341,0,34,0.4076249850137873
2023-08-13,AS,American Samoa,0,8341,0,34,0.4076249850137873
2023-08-20,AS,American Samoa,0,8341,0,34,0.4076249850137873
2023-08-27,AS,American Samoa,0,8341,0,34,0.4076249850137873
2023-09-03,AS,American Samoa,0,8341,0,34,0.4076249850137873
2023-09-10,AS,American Samoa,0,8341,0,34,0.4076249850137873
2023-09-17,AS,American Samoa,18,8359,0,34,0.40674721856681423
2023-09-24,AS,American Samoa,0,8359,0,34,0.40674721856681423
2023-10-01,AS,American Samoa,0,8359,0,34,0.40674721856681423
2023-10-08,AS,American Samoa,0,8359,0,34,0.40674721856681423
2023-10-15,AS,American Samoa,0,8359,0,34,0.40674721856681423
2023-10-22,AS,American Samoa,0,8359,0,34,0.40674721856681423
2023-10-29,AS,American Samoa,0,8359,0,34,0.40674721856681423
2023-11-05,AS,American Samoa,0,8359,0,34,0.40674721856681423
2023-11-12,AS,American Samoa,0,8359,0,34,0.40674721856681423
2023-11-19,AS,American Samoa,0,8359,0,34,0.40674721856681423
2023-11-26,AS,American Samoa,0,8359,0,34,0.40674721856681423
2023-12-03,AS,American Samoa,0,8359,0,34,0.40674721856681423
2023-12-10,AS,American Samoa,0,8359,0,34,0.40674721856681423
2023-12-17,AS,American Samoa,0,8359,0,34,0.40674721856681423
2023-12-24,AS,American Samoa,0,8359,0,34,0.40674721856681423
2023-12-31,AS,American Samoa,0,8359,0,34,0.40674721856681423
2024-01-07,AS,American Samoa,0,8359,0,34,0.40674721856681423
2024-01-14,AS,American Samoa,0,8359,0,34,0.40674721856681423
2020-03-22,AD,Andorra,131,133,1,1,0.7518796992481203
2021-01-10,AD,Andorra,420,8586,1,85,0.9899836943862101
2021-03-21,AD,Andorra,253,11481,1,113,0.9842348227506315
2021-03-28,AD,Andorra,328,11809,2,115,0.9738335168092133
2021-04-04,AD,Andorra,365,12174,2,117,0.9610645638245442
2021-04-11,AD,Andorra,323,12497,3,120,0.9602304553092742
2021-04-18,AD,Andorra,274,12771,3,123,0.9631195677707306
2021-04-25,AD,Andorra,253,13024,1,124,0.9520884520884522
2021-05-02,AD,Andorra,208,13232,1,125,0.9446795646916566
2021-05-09,AD,Andorra,174,13406,2,127,0.9473370132776369
2021-05-16,AD,Andorra,104,13510,0,127,0.9400444115470021
2021-05-23,AD,Andorra,99,13609,0,127,0.9332059666397238
2021-05-30,AD,Andorra,84,13693,0,127,0.9274811947710508
2021-06-06,AD,Andorra,65,13758,0,127,0.9230992876871638
2021-06-13,AD,Andorra,55,13813,0,127,0.9194237312676464
2021-06-20,AD,Andorra,29,13842,0,127,0.9174974714636612
2021-06-27,AD,Andorra,40,13882,0,127,0.9148537674686645
2021-07-04,AD,Andorra,36,13918,0,127,0.9124874263543612
2021-07-11,AD,Andorra,157,14075,0,127,0.9023090586145649
2021-07-18,AD,Andorra,198,14273,0,127,0.8897919148041756
2021-07-25,AD,Andorra,225,14498,0,127,0.8759828941923025
2021-08-01,AD,Andorra,180,14678,1,128,0.8720534132715628
2021-08-08,AD,Andorra,158,14836,0,128,0.8627662442706929
2021-08-15,AD,Andorra,88,14924,1,129,0.8643795229161083
2021-08-22,AD,Andorra,64,14988,0,129,0.8606885508406724
2021-08-29,AD,Andorra,37,15025,1,130,0.8652246256239602
2021-09-05,AD,Andorra,30,15055,0,130,0.8635004981733644
2021-09-12,AD,Andorra,28,15083,0,130,0.8618975004972486
2021-09-19,AD,Andorra,41,15124,0,130,0.8595609627082782
2021-09-26,AD,Andorra,43,15167,0,130,0.8571240192523242
2021-10-03,AD,Andorra,55,15222,0,130,0.854027066088556
2021-10-10,AD,Andorra,69,15291,0,130,0.8501733045582369
2021-10-17,AD,Andorra,47,15338,0,130,0.8475681314382579
2021-10-24,AD,Andorra,66,15404,0,130,0.8439366398338094
2021-10-31,AD,Andorra,112,15516,0,130,0.8378448053622067
2021-11-07,AD,Andorra,102,15618,0,130,0.8323729030605711
2021-11-14,AD,Andorra,201,15819,0,130,0.8217965737404387
2021-11-21,AD,Andorra,267,16086,0,130,0.8081561606365784
2021-11-28,AD,Andorra,626,16712,1,131,0.7838678793681186
2021-12-05,AD,Andorra,1298,18010,1,132,0.7329261521377013
2021-12-12,AD,Andorra,1430,19440,1,133,0.6841563786008231
2021-12-19,AD,Andorra,1109,20549,1,134,0.6520998588739111
2021-12-26,AD,Andorra,1181,21730,5,139,0.6396686608375518
2022-01-02,AD,Andorra,2010,23740,1,140,0.5897219882055602
2022-01-09,AD,Andorra,2668,26408,1,141,0.5339291123901848
2022-01-16,AD,Andorra,3480,29888,1,142,0.47510706638115635
2022-01-23,AD,Andorra,3137,33025,2,144,0.4360333080999243
2022-01-30,AD,Andorra,2531,35556,1,145,0.4078074024074699
2022-02-06,AD,Andorra,1043,36599,2,147,0.40165031831470804
2022-02-13,AD,Andorra,541,37140,1,148,0.3984921917070544
2022-02-20,AD,Andorra,449,37589,2,150,0.3990529144164516
2022-02-27,AD,Andorra,410,37999,1,151,0.3973788783915366
2022-03-06,AD,Andorra,435,38434,0,151,0.3928813030129573
2022-03-13,AD,Andorra,360,38794,1,152,0.39181316698458524
2022-03-20,AD,Andorra,440,39234,1,153,0.38996788499770607
2022-03-27,AD,Andorra,479,39713,0,153,0.38526427114546874
2022-04-03,AD,Andorra,311,40024,0,153,0.3822706376174295
2022-04-10,AD,Andorra,304,40328,0,153,0.37938901011704024
2022-04-17,AD,Andorra,381,40709,0,153,0.37583826672234644
2022-04-24,AD,Andorra,304,41013,0,153,0.3730524467851657
2022-05-01,AD,Andorra,336,41349,0,153,0.3700210404121019
2022-05-08,AD,Andorra,368,41717,0,153,0.366756957595225
2022-05-15,AD,Andorra,439,42156,0,153,0.3629376601195559
2022-05-22,AD,Andorra,416,42572,0,153,0.35939114911209247
2022-05-29,AD,Andorra,322,42894,0,153,0.35669324381032314
2022-06-05,AD,Andorra,173,43067,0,153,0.3552604082011749
2022-06-12,AD,Andorra,157,43224,0,153,0.3539700166574125
2022-06-19,AD,Andorra,225,43449,0,153,0.35213698819305395
2022-06-26,AD,Andorra,325,43774,0,153,0.3495225476310138
2022-07-03,AD,Andorra,403,44177,0,153,0.34633406523756705
2022-07-10,AD,Andorra,494,44671,0,153,0.34250408542454835
2022-07-17,AD,Andorra,390,45061,0,153,0.33953973502585383
2022-07-24,AD,Andorra,265,45326,0,153,0.3375546044213034
2022-07-31,AD,Andorra,182,45508,0,153,0.33620462336292517
2022-08-07,AD,Andorra,285,45793,1,154,0.33629594042757627
2022-08-14,AD,Andorra,106,45899,0,154,0.33551929235931066
2022-08-21,AD,Andorra,76,45975,0,154,0.3349646547036433
2022-08-28,AD,Andorra,52,46027,0,154,0.3345862211310753
2022-09-04,AD,Andorra,0,46027,0,154,0.3345862211310753
2022-09-11,AD,Andorra,86,46113,1,155,0.3361308090993863
2022-09-18,AD,Andorra,34,46147,0,155,0.33588315600147356
2022-09-25,AD,Andorra,0,46147,0,155,0.33588315600147356
2022-10-02,AD,Andorra,80,46227,0,155,0.3353018798537651
2022-10-09,AD,Andorra,48,46275,0,155,0.3349540788762831
2022-10-16,AD,Andorra,91,46366,0,155,0.3342966829142044
2022-10-23,AD,Andorra,83,46449,0,155,0.3336993261426511
2022-10-30,AD,Andorra,86,46535,0,155,0.3330826259804448
2022-11-06,AD,Andorra,53,46588,0,155,0.33270370052374
2022-11-13,AD,Andorra,76,46664,0,155,0.332161837819304
2022-11-20,AD,Andorra,160,46824,1,156,0.3331624807790876
2022-11-27,AD,Andorra,0,46824,0,156,0.3331624807790876
2022-12-04,AD,Andorra,395,47219,1,157,0.3324932760117749
2022-12-11,AD,Andorra,227,47446,1,158,0.33301015891750624
2022-12-18,AD,Andorra,160,47606,0,158,0.33189093811704407
2022-12-25,AD,Andorra,80,47686,0,158,0.3313341441932643
2023-01-01,AD,Andorra,65,47751,0,158,0.3308831228665368
2023-01-08,AD,Andorra,30,47781,1,159,0.3327682551641866
2023-01-15,AD,Andorra,0,47781,0,159,0.3327682551641866
2023-01-22,AD,Andorra,39,47820,0,159,0.3324968632371393
2023-01-29,AD,Andorra,19,47839,0,159,0.33236480695666715
2023-02-05,AD,Andorra,11,47850,0,159,0.3322884012539185
2023-02-12,AD,Andorra,10,47860,0,159,0.3322189720016715
2023-02-19,AD,Andorra,6,47866,0,159,0.33217732837504704
2023-02-26,AD,Andorra,9,47875,0,159,0.33211488250652743
2023-03-05,AD,Andorra,15,47890,0,159,0.3320108582167467
2023-03-12,AD,Andorra,8,47898,0,159,0.33195540523612677
2023-03-19,AD,Andorra,10,47908,0,159,0.33188611505385324
2023-03-26,AD,Andorra,9,47917,0,159,0.3318237786171922
2023-04-02,AD,Andorra,13,47930,0,159,0.3317337784268725
2023-04-09,AD,Andorra,9,47939,0,159,0.3316714991968961
2023-04-16,AD,Andorra,6,47945,0,159,0.33162999269996873
2023-04-23,AD,Andorra,0,47945,0,159,0.33162999269996873
2023-04-30,AD,Andorra,29,47974,0,159,0.3314295243256764
2023-05-07,AD,Andorra,41,48015,0,159,0.331146516713527
2023-05-14,AD,Andorra,0,48015,0,159,0.331146516713527
2023-05-21,AD,Andorra,0,48015,0,159,0.331146516713527
2023-05-28,AD,Andorra,0,48015,0,159,0.331146516713527
2023-06-04,AD,Andorra,0,48015,0,159,0.331146516713527
2023-06-11,AD,Andorra,0,48015,0,159,0.331146516713527
2023-06-18,AD,Andorra,0,48015,0,159,0.331146516713527
2023-06-25,AD,Andorra,0,48015,0,159,0.331146516713527
2023-07-02,AD,Andorra,0,48015,0,159,0.331146516713527
2023-07-09,AD,Andorra,0,48015,0,159,0.331146516713527
2023-07-16,AD,Andorra,0,48015,0,159,0.331146516713527
2023-07-23,AD,Andorra,0,48015,0,159,0.331146516713527
2023-07-30,AD,Andorra,0,48015,0,159,0.331146516713527
2023-08-06,AD,Andorra,0,48015,0,159,0.331146516713527
2023-08-13,AD,Andorra,0,48015,0,159,0.331146516713527
2023-08-20,AD,Andorra,0,48015,0,159,0.331146516713527
2023-08-27,AD,Andorra,0,48015,0,159,0.331146516713527
2023-09-03,AD,Andorra,0,48015,0,159,0.331146516713527
2023-09-10,AD,Andorra,0,48015,0,159,0.331146516713527
2023-09-17,AD,Andorra,0,48015,0,159,0.331146516713527
2023-09-24,AD,Andorra,0,48015,0,159,0.331146516713527
2023-10-01,AD,Andorra,0,48015,0,159,0.331146516713527
2023-10-08,AD,Andorra,0,48015,0,159,0.331146516713527
2023-10-15,AD,Andorra,0,48015,0,159,0.331146516713527
2023-10-22,AD,Andorra,0,48015,0,159,0.331146516713527
2023-10-29,AD,Andorra,0,48015,0,159,0.331146516713527
2023-11-05,AD,Andorra,0,48015,0,159,0.331146516713527
2023-11-12,AD,Andorra,0,48015,0,159,0.331146516713527
2023-11-19,AD,Andorra,0,48015,0,159,0.331146516713527
2023-11-26,AD,Andorra,0,48015,0,159,0.331146516713527
2023-12-03,AD,Andorra,0,48015,0,159,0.331146516713527
2023-12-10,AD,Andorra,0,48015,0,159,0.331146516713527
2023-12-17,AD,Andorra,0,48015,0,159,0.331146516713527
2023-12-24,AD,Andorra,0,48015,0,159,0.331146516713527
2023-12-31,AD,Andorra,0,48015,0,159,0.331146516713527
2024-01-07,AD,Andorra,0,48015,0,159,0.331146516713527
2024-01-14,AD,Andorra,0,48015,0,159,0.331146516713527
2021-09-26,AI,Anguilla,33,364,1,1,0.27472527472527475
2021-10-03,AI,Anguilla,61,425,0,1,0.2352941176470588
2021-10-10,AI,Anguilla,119,544,0,1,0.1838235294117647
2021-10-17,AI,Anguilla,124,668,0,1,0.14970059880239522
2021-10-24,AI,Anguilla,125,793,0,1,0.12610340479192939
2021-10-31,AI,Anguilla,99,892,0,1,0.11210762331838565
2021-11-07,AI,Anguilla,147,1039,0,1,0.0962463907603465
2021-11-14,AI,Anguilla,70,1109,2,3,0.2705139765554554
2021-11-21,AI,Anguilla,159,1268,0,3,0.23659305993690852
2021-11-28,AI,Anguilla,66,1334,0,3,0.22488755622188905
2021-12-05,AI,Anguilla,80,1414,0,3,0.21216407355021216
2021-12-12,AI,Anguilla,109,1523,1,4,0.2626395272488509
2021-12-19,AI,Anguilla,69,1592,0,4,0.25125628140703515
2021-12-26,AI,Anguilla,54,1646,1,5,0.3037667071688943
2022-01-02,AI,Anguilla,28,1674,0,5,0.2986857825567503
2022-01-09,AI,Anguilla,103,1777,1,6,0.3376477208778841
2022-01-16,AI,Anguilla,263,2040,0,6,0.29411764705882354
2022-01-23,AI,Anguilla,147,2187,1,7,0.3200731595793324
2022-01-30,AI,Anguilla,137,2324,1,8,0.34423407917383825
2022-02-06,AI,Anguilla,60,2384,0,8,0.33557046979865773
2022-02-13,AI,Anguilla,74,2458,1,9,0.3661513425549227
2022-02-20,AI,Anguilla,48,2506,0,9,0.3591380686352753
2022-02-27,AI,Anguilla,22,2528,0,9,0.3560126582278481
2022-03-06,AI,Anguilla,27,2555,0,9,0.35225048923679064
2022-03-13,AI,Anguilla,19,2574,0,9,0.34965034965034963
2022-03-20,AI,Anguilla,20,2594,0,9,0.3469545104086353
2022-03-27,AI,Anguilla,39,2633,0,9,0.34181541967337636
2022-04-03,AI,Anguilla,67,2700,0,9,0.33333333333333337
2022-04-10,AI,Anguilla,17,2717,0,9,0.3312476996687523
2022-04-17,AI,Anguilla,14,2731,0,9,0.3295496155254486
2022-04-24,AI,Anguilla,0,2731,0,9,0.3295496155254486
2022-05-01,AI,Anguilla,57,2788,0,9,0.32281205164992827
2022-05-08,AI,Anguilla,0,2788,0,9,0.32281205164992827
2022-05-15,AI,Anguilla,196,2984,0,9,0.30160857908847183
2022-05-22,AI,Anguilla,132,3116,0,9,0.28883183568677795
2022-05-29,AI,Anguilla,87,3203,0,9,0.280986575085857
2022-06-05,AI,Anguilla,91,3294,0,9,0.273224043715847
2022-06-12,AI,Anguilla,48,3342,0,9,0.26929982046678635
2022-06-19,AI,Anguilla,32,3374,0,9,0.26674570243034973
2022-06-26,AI,Anguilla,37,3411,0,9,0.2638522427440633
2022-07-03,AI,Anguilla,45,3456,0,9,0.26041666666666663
2022-07-10,AI,Anguilla,20,3476,0,9,0.2589182968929804
2022-07-17,AI,Anguilla,20,3496,0,9,0.2574370709382151
2022-07-24,AI,Anguilla,39,3535,0,9,0.2545968882602546
2022-07-31,AI,Anguilla,45,3580,1,10,0.27932960893854747
2022-08-07,AI,Anguilla,40,3620,0,10,0.2762430939226519
2022-08-14,AI,Anguilla,0,3620,0,10,0.2762430939226519
2022-08-21,AI,Anguilla,126,3746,0,10,0.2669514148424987
2022-08-28,AI,Anguilla,59,3805,0,10,0.2628120893561104
2022-09-04,AI,Anguilla,32,3837,1,11,0.2866823038832421
2022-09-11,AI,Anguilla,14,3851,1,12,0.3116073747078681
2022-09-18,AI,Anguilla,5,3856,0,12,0.3112033195020747
2022-09-25,AI,Anguilla,2,3858,0,12,0.3110419906687403
2022-10-02,AI,Anguilla,7,3865,0,12,0.31047865459249674
2022-10-09,AI,Anguilla,1,3866,0,12,0.3103983445421624
2022-10-16,AI,Anguilla,0,3866,0,12,0.3103983445421624
2022-10-23,AI,Anguilla,0,3866,0,12,0.3103983445421624
2022-10-30,AI,Anguilla,0,3866,0,12,0.3103983445421624
2022-11-06,AI,Anguilla,0,3866,0,12,0.3103983445421624
2022-11-13,AI,Anguilla,0,3866,0,12,0.3103983445421624
2022-11-20,AI,Anguilla,0,3866,0,12,0.3103983445421624
2022-11-27,AI,Anguilla,0,3866,0,12,0.3103983445421624
2022-12-04,AI,Anguilla,38,3904,0,12,0.3073770491803279
2022-12-11,AI,Anguilla,0,3904,0,12,0.3073770491803279
2022-12-18,AI,Anguilla,0,3904,0,12,0.3073770491803279
2022-12-25,AI,Anguilla,0,3904,0,12,0.3073770491803279
2023-01-01,AI,Anguilla,0,3904,0,12,0.3073770491803279
2023-01-08,AI,Anguilla,0,3904,0,12,0.3073770491803279
2023-01-15,AI,Anguilla,0,3904,0,12,0.3073770491803279
2023-01-22,AI,Anguilla,0,3904,0,12,0.3073770491803279
2023-01-29,AI,Anguilla,0,3904,0,12,0.3073770491803279
2023-02-05,AI,Anguilla,0,3904,0,12,0.3073770491803279
2023-02-12,AI,Anguilla,0,3904,0,12,0.3073770491803279
2023-02-19,AI,Anguilla,0,3904,0,12,0.3073770491803279
2023-02-26,AI,Anguilla,0,3904,0,12,0.3073770491803279
2023-03-05,AI,Anguilla,0,3904,0,12,0.3073770491803279
2023-03-12,AI,Anguilla,0,3904,0,12,0.3073770491803279
2023-03-19,AI,Anguilla,0,3904,0,12,0.3073770491803279
2023-03-26,AI,Anguilla,0,3904,0,12,0.3073770491803279
2023-04-02,AI,Anguilla,0,3904,0,12,0.3073770491803279
2023-04-09,AI,Anguilla,0,3904,0,12,0.3073770491803279
2023-04-16,AI,Anguilla,0,3904,0,12,0.3073770491803279
2023-04-23,AI,Anguilla,0,3904,0,12,0.3073770491803279
2023-04-30,AI,Anguilla,0,3904,0,12,0.3073770491803279
2023-05-07,AI,Anguilla,0,3904,0,12,0.3073770491803279
2023-05-14,AI,Anguilla,0,3904,0,12,0.3073770491803279
2023-05-21,AI,Anguilla,0,3904,0,12,0.3073770491803279
2023-05-28,AI,Anguilla,0,3904,0,12,0.3073770491803279
2023-06-04,AI,Anguilla,0,3904,0,12,0.3073770491803279
2023-06-11,AI,Anguilla,0,3904,0,12,0.3073770491803279
2023-06-18,AI,Anguilla,0,3904,0,12,0.3073770491803279
2023-06-25,AI,Anguilla,0,3904,0,12,0.3073770491803279
2023-07-02,AI,Anguilla,0,3904,0,12,0.3073770491803279
2023-07-09,AI,Anguilla,0,3904,0,12,0.3073770491803279
2023-07-16,AI,Anguilla,0,3904,0,12,0.3073770491803279
2023-07-23,AI,Anguilla,0,3904,0,12,0.3073770491803279
2023-07-30,AI,Anguilla,0,3904,0,12,0.3073770491803279
2023-08-06,AI,Anguilla,0,3904,0,12,0.3073770491803279
2023-08-13,AI,Anguilla,0,3904,0,12,0.3073770491803279
2023-08-20,AI,Anguilla,0,3904,0,12,0.3073770491803279
2023-08-27,AI,Anguilla,0,3904,0,12,0.3073770491803279
2023-09-03,AI,Anguilla,0,3904,0,12,0.3073770491803279
2023-09-10,AI,Anguilla,0,3904,0,12,0.3073770491803279
2023-09-17,AI,Anguilla,0,3904,0,12,0.3073770491803279
2023-09-24,AI,Anguilla,0,3904,0,12,0.3073770491803279
2023-10-01,AI,Anguilla,0,3904,0,12,0.3073770491803279
2023-10-08,AI,Anguilla,0,3904,0,12,0.3073770491803279
2023-10-15,AI,Anguilla,0,3904,0,12,0.3073770491803279
2023-10-22,AI,Anguilla,0,3904,0,12,0.3073770491803279
2023-10-29,AI,Anguilla,0,3904,0,12,0.3073770491803279
2023-11-05,AI,Anguilla,0,3904,0,12,0.3073770491803279
2023-11-12,AI,Anguilla,0,3904,0,12,0.3073770491803279
2023-11-19,AI,Anguilla,0,3904,0,12,0.3073770491803279
2023-11-26,AI,Anguilla,0,3904,0,12,0.3073770491803279
2023-12-03,AI,Anguilla,0,3904,0,12,0.3073770491803279
2023-12-10,AI,Anguilla,0,3904,0,12,0.3073770491803279
2023-12-17,AI,Anguilla,0,3904,0,12,0.3073770491803279
2023-12-24,AI,Anguilla,0,3904,0,12,0.3073770491803279
2023-12-31,AI,Anguilla,0,3904,0,12,0.3073770491803279
2024-01-07,AI,Anguilla,0,3904,0,12,0.3073770491803279
2024-01-14,AI,Anguilla,0,3904,0,12,0.3073770491803279
2020-03-29,AM,Armenia,234,424,1,1,0.2358490566037736
2020-04-05,AM,Armenia,398,822,6,7,0.851581508515815
2020-08-16,AW,Aruba,631,894,1,4,0.44742729306487694
2020-08-23,AW,Aruba,493,1387,2,6,0.43258832011535686
2020-08-30,AW,Aruba,461,1848,2,8,0.4329004329004329
2020-09-06,AW,Aruba,444,2292,5,13,0.5671902268760907
2020-09-13,AW,Aruba,527,2819,3,16,0.5675771550195104
2020-09-20,AW,Aruba,563,3382,7,23,0.6800709639266705
2020-09-27,AW,Aruba,374,3756,2,25,0.6656017039403621
2020-10-04,AW,Aruba,242,3998,2,27,0.6753376688344171
2020-10-11,AW,Aruba,152,4150,4,31,0.746987951807229
2020-10-18,AW,Aruba,135,4285,1,32,0.7467911318553092
2020-10-25,AW,Aruba,104,4389,4,36,0.8202323991797676
2020-11-01,AW,Aruba,83,4472,1,37,0.8273703041144902
2020-11-08,AW,Aruba,92,4564,2,39,0.8545135845749343
2020-11-15,AW,Aruba,75,4639,4,43,0.9269239060142271
2020-11-22,AW,Aruba,54,4693,2,45,0.9588749200937565
2020-11-29,AW,Aruba,98,4791,0,45,0.939261114589856
2020-12-06,AW,Aruba,132,4923,0,45,0.9140767824497258
2020-12-13,AW,Aruba,88,5011,1,46,0.9179804430253442
2020-12-20,AW,Aruba,113,5124,1,47,0.9172521467603435
2020-12-27,AW,Aruba,104,5228,0,47,0.8990053557765877
2021-01-03,AW,Aruba,214,5442,2,49,0.900404263138552
2021-01-10,AW,Aruba,441,5883,1,50,0.8499065102838688
2021-01-17,AW,Aruba,413,6296,2,52,0.8259212198221092
2021-01-24,AW,Aruba,327,6623,0,52,0.7851426845840254
2021-01-31,AW,Aruba,235,6858,6,58,0.8457276173811608
2021-02-07,AW,Aruba,276,7134,3,61,0.8550602747406785
2021-02-14,AW,Aruba,204,7338,7,68,0.9266830198964295
2021-02-21,AW,Aruba,215,7553,2,70,0.9267840593141797
2021-02-28,AW,Aruba,251,7804,1,71,0.9097898513582778
2021-03-07,AW,Aruba,205,8009,4,75,0.9364464976900987
2021-03-14,AW,Aruba,263,8272,2,77,0.9308510638297872
2021-03-21,AW,Aruba,352,8624,4,81,0.939239332096475
2021-03-28,AW,Aruba,449,9073,1,82,0.9037804474815386
2021-04-04,AW,Aruba,430,9503,4,86,0.904977375565611
2021-04-11,AW,Aruba,393,9896,6,92,0.9296685529506872
2021-04-18,AW,Aruba,323,10219,0,92,0.9002837851061749
2021-04-25,AW,Aruba,250,10469,3,95,0.9074410163339384
2021-05-02,AW,Aruba,139,10608,3,98,0.9238310708898945
2021-05-09,AW,Aruba,129,10737,2,100,0.9313588525658936
2021-05-16,AW,Aruba,89,10826,4,104,0.9606502863476816
2021-05-23,AW,Aruba,66,10892,2,106,0.9731913330885054
2021-05-30,AW,Aruba,65,10957,1,107,0.9765446746372182
2021-06-06,AW,Aruba,61,11018,0,107,0.9711381375930296
2021-06-13,AW,Aruba,51,11069,0,107,0.9666636552534105
2021-06-20,AW,Aruba,30,11099,0,107,0.9640508153887738
2021-06-27,AW,Aruba,26,11125,0,107,0.9617977528089887
2021-07-04,AW,Aruba,15,11140,0,107,0.9605026929982047
2021-07-11,AW,Aruba,21,11161,0,107,0.9586954573962907
2021-07-18,AW,Aruba,37,11198,1,108,0.964457938917664
2021-07-25,AW,Aruba,94,11292,1,109,0.965285157633723
2021-08-01,AW,Aruba,292,11584,0,109,0.9409530386740331
2021-08-08,AW,Aruba,544,12128,2,111,0.9152374670184698
2021-08-15,AW,Aruba,801,12929,4,115,0.8894732771289349
2021-08-22,AW,Aruba,790,13719,9,124,0.9038559661782929
2021-08-29,AW,Aruba,599,14318,9,133,0.9289006844531359
2022-01-02,AW,Aruba,2554,19719,0,181,0.9178964450529946
2022-01-09,AW,Aruba,5535,25254,0,181,0.7167181436604103
2022-01-16,AW,Aruba,4440,29694,3,184,0.6196538021149054
2022-01-23,AW,Aruba,2141,31835,3,187,0.5874038008481232
2022-01-30,AW,Aruba,883,32718,6,193,0.5898893575401919
2022-02-06,AW,Aruba,482,33200,1,194,0.5843373493975903
2022-02-13,AW,Aruba,236,33436,2,196,0.5861945208757029
2022-02-20,AW,Aruba,132,33568,2,198,0.5898474737845567
2022-02-27,AW,Aruba,87,33655,13,211,0.6269499331451494
2022-03-06,AW,Aruba,29,33684,0,211,0.6264101650635316
2022-03-13,AW,Aruba,48,33732,1,212,0.6284833392624214
2022-03-20,AW,Aruba,85,33817,0,212,0.6269036283526037
2022-03-27,AW,Aruba,26,33843,0,212,0.6264220075052448
2022-04-03,AW,Aruba,123,33966,0,212,0.624153565330036
2022-04-10,AW,Aruba,123,34089,0,212,0.6219014931502831
2022-04-17,AW,Aruba,175,34264,0,212,0.618725192621994
2022-04-24,AW,Aruba,182,34446,0,212,0.6154560761772049
2022-05-01,AW,Aruba,247,34693,0,212,0.611074280114144
2022-05-08,AW,Aruba,272,34965,0,212,0.6063206063206064
2022-05-15,AW,Aruba,369,35334,0,212,0.5999886794588781
2022-05-22,AW,Aruba,586,35920,1,213,0.5929844097995546
2022-05-29,AW,Aruba,644,36564,0,213,0.5825402034788316
2022-06-05,AW,Aruba,788,37352,0,213,0.5702505889912186
2022-06-12,AW,Aruba,949,38301,3,216,0.5639539437612595
2022-06-19,AW,Aruba,1038,39339,3,219,0.5566994585525814
2022-06-26,AW,Aruba,840,40179,2,221,0.5500385773662858
2022-07-03,AW,Aruba,539,40718,0,221,0.5427575028243038
2022-07-10,AW,Aruba,282,41000,1,222,0.5414634146341463
2022-07-17,AW,Aruba,445,41445,2,224,0.5404753287489443
2022-07-24,AW,Aruba,342,41787,0,224,0.5360518821643094
2022-07-31,AW,Aruba,293,42080,0,224,0.532319391634981
2022-08-07,AW,Aruba,206,42286,2,226,0.5344558482712954
2022-08-14,AW,Aruba,192,42478,0,226,0.5320401148829983
2022-08-21,AW,Aruba,160,42638,1,227,0.5323889488249918
2022-08-28,AW,Aruba,112,42750,0,227,0.5309941520467837
2022-09-04,AW,Aruba,98,42848,0,227,0.5297796863330844
2022-09-11,AW,Aruba,122,42970,1,228,0.5306027461019316
2022-09-18,AW,Aruba,0,42970,0,228,0.5306027461019316
2022-09-25,AW,Aruba,0,42970,0,228,0.5306027461019316
2022-10-02,AW,Aruba,175,43145,2,230,0.533086104994785
2022-10-09,AW,Aruba,66,43211,1,231,0.5345861007613802
2022-10-16,AW,Aruba,40,43251,1,232,0.5364037825715012
2022-10-23,AW,Aruba,40,43291,0,232,0.5359081564297429
2022-10-30,AW,Aruba,43,43334,0,232,0.5353763788249412
2022-11-06,AW,Aruba,45,43379,1,233,0.5371262592498675
2022-11-13,AW,Aruba,44,43423,1,234,0.5388849227367984
2022-11-20,AW,Aruba,71,43494,1,235,0.540304409803651
2022-11-27,AW,Aruba,74,43568,1,236,0.541681968417187
2022-12-04,AW,Aruba,73,43641,0,236,0.5407758758965193
2022-12-11,AW,Aruba,52,43693,44,280,0.6408349163481565
2022-12-18,AW,Aruba,0,43693,0,280,0.6408349163481565
2022-12-25,AW,Aruba,59,43752,0,280,0.639970744194551
2023-01-01,AW,Aruba,108,43860,0,280,0.6383948928408573
2023-01-08,AW,Aruba,0,43860,0,280,0.6383948928408573
2023-01-15,AW,Aruba,76,43936,1,281,0.6395666423889294
2023-01-22,AW,Aruba,29,43965,0,281,0.639144774252246
2023-01-29,AW,Aruba,28,43993,0,281,0.6387379810424386
2023-02-05,AW,Aruba,0,43993,0,281,0.6387379810424386
2023-02-12,AW,Aruba,33,44026,1,282,0.6405305955571707
2023-02-19,AW,Aruba,0,44026,0,282,0.6405305955571707
2023-02-26,AW,Aruba,18,44044,0,282,0.640268822087004
2023-03-05,AW,Aruba,22,44066,4,286,0.6490264603095357
2023-03-12,AW,Aruba,16,44082,0,286,0.6487908897055488
2023-03-19,AW,Aruba,9,44091,1,287,0.6509264929350661
2023-03-26,AW,Aruba,8,44099,0,287,0.650808408353931
2023-04-02,AW,Aruba,15,44114,0,287,0.6505871152015233
2023-04-09,AW,Aruba,0,44114,0,287,0.6505871152015233
2023-04-16,AW,Aruba,0,44114,0,287,0.6505871152015233
2023-04-23,AW,Aruba,0,44114,0,287,0.6505871152015233
2023-04-30,AW,Aruba,0,44114,0,287,0.6505871152015233
2023-05-07,AW,Aruba,66,44180,1,288,0.6518786781349026
2023-05-14,AW,Aruba,0,44180,0,288,0.6518786781349026
2023-05-21,AW,Aruba,0,44180,0,288,0.6518786781349026
2023-05-28,AW,Aruba,0,44180,0,288,0.6518786781349026
2023-06-04,AW,Aruba,20,44200,2,290,0.6561085972850679
2023-06-11,AW,Aruba,0,44200,0,290,0.6561085972850679
2023-06-18,AW,Aruba,0,44200,0,290,0.6561085972850679
2023-06-25,AW,Aruba,0,44200,0,290,0.6561085972850679
2023-07-02,AW,Aruba,24,44224,2,292,0.66027496382055
2023-07-09,AW,Aruba,0,44224,0,292,0.66027496382055
2023-07-16,AW,Aruba,0,44224,0,292,0.66027496382055
2023-07-23,AW,Aruba,0,44224,0,292,0.66027496382055
2023-07-30,AW,Aruba,0,44224,0,292,0.66027496382055
2023-08-06,AW,Aruba,0,44224,0,292,0.66027496382055
2023-08-13,AW,Aruba,0,44224,0,292,0.66027496382055
2023-08-20,AW,Aruba,0,44224,0,292,0.66027496382055
2023-08-27,AW,Aruba,0,44224,0,292,0.66027496382055
2023-09-03,AW,Aruba,0,44224,0,292,0.66027496382055
2023-09-10,AW,Aruba,0,44224,0,292,0.66027496382055
2023-09-17,AW,Aruba,0,44224,0,292,0.66027496382055
2023-09-24,AW,Aruba,0,44224,0,292,0.66027496382055
2023-10-01,AW,Aruba,0,44224,0,292,0.66027496382055
2023-10-08,AW,Aruba,0,44224,0,292,0.66027496382055
2023-10-15,AW,Aruba,0,44224,0,292,0.66027496382055
2023-10-22,AW,Aruba,0,44224,0,292,0.66027496382055
2023-10-29,AW,Aruba,0,44224,0,292,0.66027496382055
2023-11-05,AW,Aruba,0,44224,0,292,0.66027496382055
2023-11-12,AW,Aruba,0,44224,0,292,0.66027496382055
2023-11-19,AW,Aruba,0,44224,0,292,0.66027496382055
2023-11-26,AW,Aruba,0,44224,0,292,0.66027496382055
2023-12-03,AW,Aruba,0,44224,0,292,0.66027496382055
2023-12-10,AW,Aruba,0,44224,0,292,0.66027496382055
2023-12-17,AW,Aruba,0,44224,0,292,0.66027496382055
2023-12-24,AW,Aruba,0,44224,0,292,0.66027496382055
2023-12-31,AW,Aruba,0,44224,0,292,0.66027496382055
2024-01-07,AW,Aruba,0,44224,0,292,0.66027496382055
2024-01-14,AW,Aruba,0,44224,0,292,0.66027496382055
2020-03-22,AU,Australia,832,1081,2,9,0.8325624421831638
2020-03-29,AU,Australia,2728,3809,7,16,0.420057757941717
2020-04-05,AU,Australia,1826,5635,20,36,0.6388642413487134
2020-04-12,AU,Australia,654,6289,25,61,0.969947527428844
2021-12-12,AU,Australia,13403,235354,36,2254,0.9577062637558741
2021-12-19,AU,Australia,31489,266843,54,2308,0.8649280663161485
2021-12-26,AU,Australia,99764,366607,69,2377,0.6483782360947826
2022-01-02,AU,Australia,289614,656221,103,2480,0.3779214624341495
2022-01-09,AU,Australia,588813,1245034,219,2699,0.21678122846444356
2022-01-16,AU,Australia,462325,1707359,440,3139,0.18385119942554554
2022-01-23,AU,Australia,347960,2055319,660,3799,0.18483748751410364
2022-01-30,AU,Australia,267817,2323136,670,4469,0.19236928014545854
2022-02-06,AU,Australia,201112,2524248,581,5050,0.20005958210128325
2022-02-13,AU,Australia,171754,2696002,436,5486,0.20348649592989917
2022-02-20,AU,Australia,160429,2856431,324,5810,0.203400677278744
2022-02-27,AU,Australia,160402,3016833,242,6052,0.20060772339735078
2022-03-06,AU,Australia,195717,3212550,151,6203,0.1930864889262424
2022-03-13,AU,Australia,241848,3454398,140,6343,0.1836209956119706
2022-03-20,AU,Australia,327240,3781638,139,6482,0.17140720502597023
2022-03-27,AU,Australia,385762,4167400,149,6631,0.15911599558477707
2022-04-03,AU,Australia,395982,4563382,200,6831,0.14969161030130723
2022-04-10,AU,Australia,359765,4923147,198,7029,0.14277453019379677
2022-04-17,AU,Australia,306184,5229331,250,7279,0.13919562559723223
2022-04-24,AU,Australia,289282,5518613,315,7594,0.1376070400298046
2022-05-01,AU,Australia,272054,5790667,295,7889,0.13623646464215608
2022-05-08,AU,Australia,304061,6094728,315,8204,0.13460814001871782
2022-05-15,AU,Australia,350375,6445103,339,8543,0.13255024783932856
2022-05-22,AU,Australia,311716,6756819,317,8860,0.13112679205999153
2022-05-29,AU,Australia,240429,6997248,344,9204,0.13153742728569862
2022-06-05,AU,Australia,199964,7197212,375,9579,0.13309320331261607
2022-06-12,AU,Australia,184472,7381684,331,9910,0.13425120880276098
2022-06-19,AU,Australia,191043,7572727,344,10254,0.1354069676617155
2022-06-26,AU,Australia,204308,7777035,324,10578,0.1360158466562128
2022-07-03,AU,Australia,0,7777035,344,10922,0.1404391262222685
2022-07-10,AU,Australia,243697,8020732,400,11322,0.14115918596955987
2022-07-17,AU,Australia,271605,8292337,451,11773,0.14197445183426577
2022-07-24,AU,Australia,303029,8595366,607,12380,0.14403109768682335
2022-07-31,AU,Australia,319779,8915145,618,12998,0.1457968434613234
2022-08-07,AU,Australia,259334,9174479,603,13601,0.1482482002520252
2022-08-14,AU,Australia,200397,9374876,526,14127,0.1506899931263091
2022-08-21,AU,Australia,139178,9514054,375,14502,0.15242713568789917
2022-08-28,AU,Australia,103184,9617238,329,14831,0.15421267519843015
2022-09-04,AU,Australia,79985,9697223,240,15071,0.1554156277523988
2022-09-11,AU,Australia,63392,9760615,214,15285,0.1565987389114313
2022-09-18,AU,Australia,51273,9811888,184,15469,0.1576556927677935
2022-09-25,AU,Australia,43401,9855289,147,15616,0.15845298904983912
2022-10-02,AU,Australia,37578,9892867,113,15729,0.15899334338569396
2022-10-09,AU,Australia,38674,9931541,102,15831,0.15940124498302932
2022-10-16,AU,Australia,31327,9962868,74,15905,0.1596427855914582
2022-10-23,AU,Australia,29620,9992488,103,16008,0.16020034249728396
2022-10-30,AU,Australia,30363,10022851,85,16093,0.16056309726643647
2022-11-06,AU,Australia,35763,10058614,111,16204,0.16109575335130666
2022-11-13,AU,Australia,52310,10110924,116,16320,0.16140958037069608
2022-11-20,AU,Australia,73573,10184497,154,16474,0.16175565666129607
2022-11-27,AU,Australia,83407,10267904,178,16652,0.1621752599167269
2022-12-04,AU,Australia,97897,10365801,259,16911,0.16314224052728776
2022-12-11,AU,Australia,107902,10473703,272,17183,0.16405849965384736
2022-12-18,AU,Australia,112016,10585719,299,17482,0.16514702496826147
2022-12-25,AU,Australia,108322,10694041,334,17816,0.1665974536660183
2023-01-01,AU,Australia,91518,10785559,1094,18910,0.17532702755601262
2023-01-08,AU,Australia,86989,10872548,0,18910,0.17392427239686592
2023-01-15,AU,Australia,46003,10918551,0,18910,0.1731914793455652
2023-01-22,AU,Australia,30909,10949460,0,18910,0.17270258076654008
2023-01-29,AU,Australia,22041,10971501,0,18910,0.17235563301684972
2023-02-05,AU,Australia,18922,10990423,1161,20071,0.18262263426985478
2023-02-12,AU,Australia,17067,11007490,96,20167,0.18321161318338694
2023-02-19,AU,Australia,17927,11025417,89,20256,0.1837209422555174
2023-02-26,AU,Australia,17814,11043231,90,20346,0.18423955815105197
2023-03-05,AU,Australia,18262,11061493,78,20424,0.18464053631819863
2023-03-12,AU,Australia,19780,11081273,78,20502,0.18501484441363372
2023-03-19,AU,Australia,21681,11102954,88,20590,0.18544614343173899
2023-03-26,AU,Australia,23014,11125968,93,20683,0.18589843148928703
2023-04-02,AU,Australia,25521,11151489,103,20786,0.18639663277253826
2023-04-09,AU,Australia,27650,11179139,123,20909,0.18703587100938632
2023-04-16,AU,Australia,27055,11206194,131,21040,0.18775330857202724
2023-04-23,AU,Australia,29966,11236160,146,21186,0.18855196081223477
2023-04-30,AU,Australia,29431,11265591,155,21341,0.18943524578515233
2023-05-07,AU,Australia,29663,11295254,173,21514,0.19046937766959468
2023-05-14,AU,Australia,31859,11327113,173,21687,0.19146096626739753
2023-05-21,AU,Australia,37720,11364833,170,21857,0.19232134779279203
2023-05-28,AU,Australia,41012,11405845,213,22070,0.193497281437719
2023-06-04,AU,Australia,39051,11444896,232,22302,0.19486415603951315
2023-06-11,AU,Australia,33125,11478021,226,22528,0.19627076827965378
2023-06-18,AU,Australia,22769,11500790,183,22711,0.19747339095836028
2023-06-25,AU,Australia,16822,11517612,59,22770,0.197697230988507
2023-07-02,AU,Australia,13551,11531163,0,22770,0.19746490445066123
2023-07-09,AU,Australia,10511,11541674,0,22770,0.19728507320515204
2023-07-16,AU,Australia,7826,11549500,-76,22694,0.19649335469067922
2023-07-23,AU,Australia,6495,11555995,85,22779,0.19711846535066863
2023-07-30,AU,Australia,5525,11561520,60,22839,0.1975432296099475
2023-08-06,AU,Australia,5410,11566930,67,22906,0.19803007366691075
2023-08-13,AU,Australia,5116,11572046,0,22906,0.19794252459763817
2023-08-20,AU,Australia,5194,11577240,56,22962,0.19833742757341127
2023-08-27,AU,Australia,5176,11582416,53,23015,0.19870638388398412
2023-09-03,AU,Australia,5491,11587907,39,23054,0.1989487834170571
2023-09-10,AU,Australia,5033,11592940,40,23094,0.19920744867134654
2023-09-17,AU,Australia,5017,11597957,38,23132,0.19944892018482221
2023-09-24,AU,Australia,5189,11603146,37,23169,0.19967860440608093
2023-10-01,AU,Australia,5393,11608539,33,23202,0.1998701128539948
2023-10-08,AU,Australia,5561,11614100,78,23280,0.2004460095917893
2023-10-15,AU,Australia,4691,11618791,45,23325,0.2007523846500036
2023-10-22,AU,Australia,5358,11624149,52,23377,0.20110719502993293
2023-10-29,AU,Australia,6347,11630496,72,23449,0.2016165088746
2023-11-05,AU,Australia,7687,11638183,51,23500,0.20192155424949065
2023-11-12,AU,Australia,0,11638183,0,23500,0.20192155424949065
2023-11-19,AU,Australia,21092,11659275,204,23704,0.20330595169939814
2023-11-26,AU,Australia,10282,11669557,89,23793,0.20388948783574218
2023-12-03,AU,Australia,9620,11679177,152,23945,0.20502300804243315
2023-12-10,AU,Australia,9889,11689066,114,24059,0.2058248280914831
2023-12-17,AU,Australia,10569,11699635,81,24140,0.20633122315354283
2023-12-24,AU,Australia,11099,11710734,36,24176,0.20644308033979766
2023-12-31,AU,Australia,10671,11721405,35,24211,0.20655373651878767
2024-01-07,AU,Australia,9626,11731031,33,24244,0.2066655522434473
2024-01-14,AU,Australia,10663,11741694,21,24265,0.20665672261600412
2020-03-15,AT,Austria,513,588,1,1,0.17006802721088435
2022-01-30,AT,Austria,220484,1799543,106,17079,0.9490742927509929
2022-02-06,AT,Austria,231714,2031257,127,17206,0.8470616962796927
2022-02-13,AT,Austria,223088,2254345,170,17376,0.7707782083044078
2022-02-20,AT,Austria,200933,2455278,201,17577,0.7158863476966763
2022-02-27,AT,Austria,185138,2640416,213,17790,0.673757468520112
2022-03-06,AT,Austria,206248,2846664,228,18018,0.6329514126008549
2022-03-13,AT,Austria,281597,3128261,192,18210,0.5821125539077462
2022-03-20,AT,Austria,319108,3447369,226,18436,0.534784643013266
2022-03-27,AT,Austria,270232,3717601,288,18724,0.5036581386759903
2022-04-03,AT,Austria,172589,3890190,289,19013,0.48874219511129274
2022-04-10,AT,Austria,103990,3994180,226,19239,0.48167583834479166
2022-04-17,AT,Austria,68173,4062353,179,19418,0.4779988346655251
2022-04-24,AT,Austria,52197,4114550,138,19556,0.475288913732972
2022-05-01,AT,Austria,41690,4156240,100,19656,0.47292745366003885
2022-05-08,AT,Austria,37988,4194228,76,19732,0.4704560648586581
2022-05-15,AT,Austria,31290,4225518,61,19793,0.4684159433233985
2022-05-22,AT,Austria,22565,4248083,34,19827,0.46672816891760355
2022-05-29,AT,Austria,15151,4263234,39,19866,0.4659842739103695
2022-06-05,AT,Austria,18678,4281912,21,19887,0.4644420529894122
2022-06-12,AT,Austria,23968,4305880,22,19909,0.4623677389987645
2022-06-19,AT,Austria,35416,4341296,28,19937,0.459240742856511
2022-06-26,AT,Austria,58037,4399333,33,19970,0.4539324483961546
2022-07-03,AT,Austria,68562,4467895,53,20023,0.4481528773617106
2022-07-10,AT,Austria,74223,4542118,58,20081,0.4421065238727836
2022-07-17,AT,Austria,80557,4622675,57,20138,0.4356352112142861
2022-07-24,AT,Austria,82554,4705229,89,20227,0.42988343394125983
2022-07-31,AT,Austria,60380,4765609,104,20331,0.42661913723933287
2022-08-07,AT,Austria,44332,4809941,76,20407,0.4242671583705496
2022-08-14,AT,Austria,39284,4849225,83,20490,0.422541746361532
2022-08-21,AT,Austria,37611,4886836,57,20547,0.42045609879275675
2022-08-28,AT,Austria,34819,4921655,55,20602,0.4185990281724339
2022-09-04,AT,Austria,30154,4951809,32,20634,0.41669620132763596
2022-09-11,AT,Austria,28946,4980755,52,20686,0.4153185611418349
2022-09-18,AT,Austria,33920,5014675,34,20720,0.41318729528832876
2022-09-25,AT,Austria,47759,5062434,33,20753,0.40994114688705074
2022-10-02,AT,Austria,77655,5140089,51,20804,0.4047400735668195
2022-10-09,AT,Austria,96821,5236910,86,20890,0.3988993509531384
2022-10-16,AT,Austria,90835,5327745,93,20983,0.39384392458723155
2022-10-23,AT,Austria,64550,5392295,69,21052,0.39040890752453267
2022-10-30,AT,Austria,39248,5431543,91,21143,0.38926323514331007
2022-11-06,AT,Austria,30833,5462376,57,21200,0.38810949667324257
2022-11-13,AT,Austria,25591,5487967,49,21249,0.3871925614713062
2022-11-20,AT,Austria,26519,5514486,61,21310,0.386436741339084
2022-11-27,AT,Austria,29327,5543813,41,21351,0.38513203818382763
2022-12-04,AT,Austria,33020,5576833,50,21401,0.3837482671616669
2022-12-11,AT,Austria,31822,5608655,43,21444,0.382337654927964
2022-12-18,AT,Austria,36251,5644906,52,21496,0.3808035067368704
2022-12-25,AT,Austria,33439,5678345,75,21571,0.3798818141553569
2023-01-01,AT,Austria,26728,5705073,73,21644,0.37938164857837925
2023-01-08,AT,Austria,19106,5724179,64,21708,0.37923342369272517
2023-01-15,AT,Austria,16350,5740529,66,21774,0.3793030224218012
2023-01-22,AT,Austria,13499,5754028,42,21816,0.3791430976700148
2023-01-29,AT,Austria,18243,5772271,42,21858,0.3786724497169312
2023-02-05,AT,Austria,26105,5798376,54,21912,0.37789891514451635
2023-02-12,AT,Austria,27763,5826139,37,21949,0.37673320186833853
2023-02-19,AT,Austria,33324,5859463,34,21983,0.3751708987666617
2023-02-26,AT,Austria,37763,5897226,60,22043,0.3737859122238151
2023-03-05,AT,Austria,39473,5936699,54,22097,0.37221021311675057
2023-03-12,AT,Austria,34418,5971117,72,22169,0.3712705679691086
2023-03-19,AT,Austria,28347,5999464,47,22216,0.3702997467773788
2023-03-26,AT,Austria,22317,6021781,58,22274,0.3698905689197266
2023-04-02,AT,Austria,14310,6036091,41,22315,0.3696929022441842
2023-04-09,AT,Austria,9089,6045180,38,22353,0.3697656645459688
2023-04-16,AT,Austria,7508,6052688,36,22389,0.36990176926350743
2023-04-23,AT,Austria,6676,6059364,29,22418,0.36997282223018785
2023-04-30,AT,Austria,5463,6064827,33,22451,0.370183683722553
2023-05-07,AT,Austria,4026,6068853,20,22471,0.37026766013281254
2023-05-14,AT,Austria,3061,6071914,13,22484,0.3702950997000287
2023-05-21,AT,Austria,2145,6074059,12,22496,0.37036189473958026
2023-05-28,AT,Austria,2345,6076404,12,22508,0.37041645025577624
2023-06-04,AT,Austria,1468,6077872,12,22520,0.3705244203892415
2023-06-11,AT,Austria,1018,6078890,5,22525,0.37054462245574443
2023-06-18,AT,Austria,1057,6079947,7,22532,0.37059533578170994
2023-06-25,AT,Austria,828,6080775,2,22534,0.37057776352520855
2023-07-02,AT,Austria,512,6081287,0,22534,0.37054656358103144
2023-07-09,AT,Austria,0,6081287,0,22534,0.37054656358103144
2023-07-16,AT,Austria,0,6081287,0,22534,0.37054656358103144
2023-07-23,AT,Austria,0,6081287,0,22534,0.37054656358103144
2023-07-30,AT,Austria,0,6081287,0,22534,0.37054656358103144
2023-08-06,AT,Austria,0,6081287,0,22534,0.37054656358103144
2023-08-13,AT,Austria,0,6081287,0,22534,0.37054656358103144
2023-08-20,AT,Austria,0,6081287,0,22534,0.37054656358103144
2023-08-27,AT,Austria,0,6081287,0,22534,0.37054656358103144
2023-09-03,AT,Austria,0,6081287,0,22534,0.37054656358103144
2023-09-10,AT,Austria,0,6081287,0,22534,0.37054656358103144
2023-09-17,AT,Austria,0,6081287,0,22534,0.37054656358103144
2023-09-24,AT,Austria,0,6081287,0,22534,0.37054656358103144
2023-10-01,AT,Austria,0,6081287,0,22534,0.37054656358103144
2023-10-08,AT,Austria,0,6081287,0,22534,0.37054656358103144
2023-10-15,AT,Austria,0,6081287,0,22534,0.37054656358103144
2023-10-22,AT,Austria,0,6081287,0,22534,0.37054656358103144
2023-10-29,AT,Austria,0,6081287,0,22534,0.37054656358103144
2023-11-05,AT,Austria,0,6081287,0,22534,0.37054656358103144
2023-11-12,AT,Austria,0,6081287,0,22534,0.37054656358103144
2023-11-19,AT,Austria,0,6081287,0,22534,0.37054656358103144
2023-11-26,AT,Austria,0,6081287,0,22534,0.37054656358103144
2023-12-03,AT,Austria,0,6081287,0,22534,0.37054656358103144
2023-12-10,AT,Austria,0,6081287,0,22534,0.37054656358103144
2023-12-17,AT,Austria,0,6081287,0,22534,0.37054656358103144
2023-12-24,AT,Austria,0,6081287,0,22534,0.37054656358103144
2023-12-31,AT,Austria,0,6081287,0,22534,0.37054656358103144
2024-01-07,AT,Austria,0,6081287,0,22534,0.37054656358103144
2024-01-14,AT,Austria,0,6081287,0,22534,0.37054656358103144
2020-03-22,BH,Bahrain,100,311,1,1,0.3215434083601286
2020-03-29,BH,Bahrain,165,476,3,4,0.8403361344537815
2020-04-05,BH,Bahrain,212,688,0,4,0.5813953488372093
2020-04-12,BH,Bahrain,352,1040,2,6,0.576923076923077
2020-04-19,BH,Bahrain,733,1773,1,7,0.39481105470953193
2020-04-26,BH,Bahrain,816,2589,1,8,0.3089996137504828
2020-05-03,BH,Bahrain,695,3284,0,8,0.24360535931790497
2020-05-10,BH,Bahrain,1490,4774,0,8,0.1675743611227482
2020-05-17,BH,Bahrain,1973,6747,4,12,0.17785682525566918
2020-05-24,BH,Bahrain,2055,8802,1,13,0.14769370597591455
2020-05-31,BH,Bahrain,1991,10793,4,17,0.1575094968961364
2020-06-07,BH,Bahrain,3590,14383,7,24,0.1668636584857123
2020-06-14,BH,Bahrain,3844,18227,15,39,0.2139682888023262
2020-06-21,BH,Bahrain,3104,21331,21,60,0.28128076508368105
2020-06-28,BH,Bahrain,3936,25267,18,78,0.30870305141093124
2020-07-05,BH,Bahrain,3590,28857,18,96,0.33267491423224865
2020-07-12,BH,Bahrain,3613,32470,8,104,0.32029565753002776
2020-07-19,BH,Bahrain,3534,36004,20,124,0.3444061770914343
2020-07-26,BH,Bahrain,2743,38747,13,137,0.3535757607040545
2020-08-02,BH,Bahrain,2443,41190,10,147,0.3568827385287691
2020-08-09,BH,Bahrain,2439,43629,14,161,0.3690206055605217
2020-08-16,BH,Bahrain,2801,46430,9,170,0.3661425802283007
2020-08-23,BH,Bahrain,2608,49038,13,183,0.37317998287042703
2020-08-30,BH,Bahrain,2353,51391,6,189,0.3677686754490086
2020-09-06,BH,Bahrain,3380,54771,7,196,0.35785360866151794
2020-09-13,BH,Bahrain,4815,59586,16,212,0.3557882724129829
2020-09-20,BH,Bahrain,4913,64499,9,221,0.34264097117784775
2020-09-27,BH,Bahrain,4276,68775,18,239,0.3475099963649582
2020-10-04,BH,Bahrain,3535,72310,19,258,0.35679712349605863
2020-10-11,BH,Bahrain,2977,75287,15,273,0.3626124032037404
2020-10-18,BH,Bahrain,2284,77571,20,293,0.3777184772659886
2020-10-25,BH,Bahrain,2404,79975,19,312,0.3901219130978431
2020-11-01,BH,Bahrain,1670,81645,9,321,0.39316553371302587
2020-11-08,BH,Bahrain,1619,83264,8,329,0.3951287471176019
2020-11-15,BH,Bahrain,1259,84523,4,333,0.393975604273393
2020-11-22,BH,Bahrain,1068,85591,5,338,0.3949013330840859
2020-11-29,BH,Bahrain,1054,86645,3,341,0.3935599284436494
2020-12-06,BH,Bahrain,1087,87732,0,341,0.3886837185975471
2020-12-13,BH,Bahrain,1233,88965,7,348,0.39116506491316805
2020-12-20,BH,Bahrain,1097,90062,1,349,0.387510825875508
2020-12-27,BH,Bahrain,1456,91518,2,351,0.383531108634367
2021-01-03,BH,Bahrain,1666,93184,1,352,0.37774725274725274
2021-01-10,BH,Bahrain,2133,95317,3,355,0.3724414322733615
2021-01-17,BH,Bahrain,1951,97268,3,358,0.3680552699757372
2021-01-24,BH,Bahrain,2188,99456,9,367,0.36900740025740025
2021-01-31,BH,Bahrain,3170,102626,5,372,0.36248124257010894
2021-02-07,BH,Bahrain,4087,106713,7,379,0.35515822814464965
2021-02-14,BH,Bahrain,5389,112102,19,398,0.35503380849583416
2021-02-21,BH,Bahrain,5132,117234,22,420,0.35825784328778343
2021-02-28,BH,Bahrain,4544,121778,24,444,0.36459787482139633
2021-03-07,BH,Bahrain,4348,126126,25,469,0.37185037185037184
2021-03-14,BH,Bahrain,4278,130404,12,481,0.36885371614367657
2021-03-21,BH,Bahrain,4922,135326,17,498,0.3680002364660154
2021-03-28,BH,Bahrain,5492,140818,15,513,0.3643000184635487
2021-04-04,BH,Bahrain,6952,147770,18,531,0.35934222101915136
2021-04-11,BH,Bahrain,7632,155402,23,554,0.35649476840709904
2021-04-18,BH,Bahrain,7711,163113,34,588,0.3604862886465211
2021-04-25,BH,Bahrain,7222,170335,32,620,0.36398861067895616
2021-05-02,BH,Bahrain,7662,177997,28,648,0.36405107951257604
2021-05-09,BH,Bahrain,9908,187905,30,678,0.36082062744471943
2021-05-16,BH,Bahrain,11188,199093,59,737,0.37017876067968236
2021-05-23,BH,Bahrain,15777,214870,72,809,0.3765067249965095
2021-05-30,BH,Bahrain,20829,235699,130,939,0.39838947131723085
2021-06-06,BH,Bahrain,13883,249582,152,1091,0.43713088283610196
2021-06-13,BH,Bahrain,8270,257852,115,1206,0.46771015931619686
2021-06-20,BH,Bahrain,4575,262427,91,1297,0.49423268185057173
2021-06-27,BH,Bahrain,2568,264995,44,1341,0.5060472839110172
2021-07-04,BH,Bahrain,1291,266286,17,1358,0.5099779935858438
2021-07-11,BH,Bahrain,826,267112,18,1376,0.5151397166731558
2021-07-18,BH,Bahrain,684,267796,4,1380,0.5153176298376376
2021-07-25,BH,Bahrain,617,268413,2,1382,0.5148781914437826
2021-08-01,BH,Bahrain,773,269186,2,1384,0.514142637432853
2021-08-08,BH,Bahrain,763,269949,0,1384,0.5126894339301127
2021-08-15,BH,Bahrain,867,270816,0,1384,0.5110480916932529
2021-08-22,BH,Bahrain,718,271534,2,1386,0.5104333159015078
2021-08-29,BH,Bahrain,712,272246,2,1388,0.5098330186669409
2021-09-05,BH,Bahrain,670,272916,0,1388,0.5085813950079878
2021-09-12,BH,Bahrain,706,273622,0,1388,0.5072691523342421
2021-09-19,BH,Bahrain,557,274179,0,1388,0.506238625131757
2021-09-26,BH,Bahrain,566,274745,1,1389,0.5055597008134816
2021-10-03,BH,Bahrain,430,275175,0,1389,0.5047696920141729
2021-10-10,BH,Bahrain,422,275597,1,1390,0.5043596265561672
2021-10-17,BH,Bahrain,433,276030,1,1391,0.5039307321667934
2021-10-24,BH,Bahrain,496,276526,2,1393,0.5037500994481531
2021-10-31,BH,Bahrain,268,276794,0,1393,0.5032623539527591
2021-11-07,BH,Bahrain,247,277041,0,1393,0.5028136629596341
2021-11-14,BH,Bahrain,160,277201,0,1393,0.502523439670131
2021-11-21,BH,Bahrain,147,277348,1,1394,0.5026176500281235
2021-11-28,BH,Bahrain,204,277552,0,1394,0.5022482273591975
2021-12-05,BH,Bahrain,251,277803,0,1394,0.5017944370651145
2021-12-12,BH,Bahrain,234,278037,0,1394,0.5013721195380471
2021-12-19,BH,Bahrain,373,278410,0,1394,0.5007004058762257
2021-12-26,BH,Bahrain,1108,279518,0,1394,0.4987156462195637
2022-01-02,BH,Bahrain,3159,282677,0,1394,0.49314234974900684
2022-01-09,BH,Bahrain,8201,290878,3,1397,0.48027007886467865
2022-01-16,BH,Bahrain,14536,305414,1,1398,0.45773933087546737
2022-01-23,BH,Bahrain,22052,327466,1,1399,0.42721992512199736
2022-01-30,BH,Bahrain,34556,362022,5,1404,0.38782173459071545
2022-02-06,BH,Bahrain,51350,413372,7,1411,0.3413390360256621
2022-02-13,BH,Bahrain,45167,458539,14,1425,0.31076964009604413
2022-02-20,BH,Bahrain,29884,488423,12,1437,0.2942121890246774
2022-02-27,BH,Bahrain,20967,509390,13,1450,0.2846541942323171
2022-03-06,BH,Bahrain,15781,525171,8,1458,0.27762385965714026
2022-03-13,BH,Bahrain,11070,536241,4,1462,0.2726386083869007
2022-03-20,BH,Bahrain,7594,543835,3,1465,0.2693831768826942
2022-03-27,BH,Bahrain,6527,550362,3,1468,0.2667335317481948
2022-04-03,BH,Bahrain,5198,555560,3,1471,0.2647778817769458
2022-04-10,BH,Bahrain,3871,559431,1,1472,0.2631244961398278
2022-04-17,BH,Bahrain,3328,562759,1,1473,0.26174614710737637
2022-04-24,BH,Bahrain,3071,565830,2,1475,0.26067900252726084
2022-05-01,BH,Bahrain,2876,568706,0,1475,0.2593607241703095
2022-05-08,BH,Bahrain,3376,572082,2,1477,0.2581797714313682
2022-05-15,BH,Bahrain,4915,576997,2,1479,0.25632715594708466
2022-05-22,BH,Bahrain,3800,580797,1,1480,0.25482225286976345
2022-05-29,BH,Bahrain,3187,583984,7,1487,0.25463026384284504
2022-06-05,BH,Bahrain,4086,588070,1,1488,0.2530311017395888
2022-06-12,BH,Bahrain,6551,594621,1,1489,0.2504116067209197
2022-06-19,BH,Bahrain,9227,603848,2,1491,0.24691644254845588
2022-06-26,BH,Bahrain,12740,616588,1,1492,0.24197681433955898
2022-07-03,BH,Bahrain,12155,628743,2,1494,0.23761695955263118
2022-07-10,BH,Bahrain,9732,638475,4,1498,0.23462155918399313
2022-07-17,BH,Bahrain,9460,647935,7,1505,0.23227638574857046
2022-07-24,BH,Bahrain,6938,654873,1,1506,0.22996825338653445
2022-07-31,BH,Bahrain,4351,659224,3,1509,0.2289055010133126
2022-08-07,BH,Bahrain,3182,662406,2,1511,0.2281078371874651
2022-08-14,BH,Bahrain,3967,666373,1,1512,0.22689994942772293
2022-08-21,BH,Bahrain,3019,669392,1,1513,0.2260260056887444
2022-08-28,BH,Bahrain,1462,670854,0,1513,0.22553342456033654
2022-09-04,BH,Bahrain,1391,672245,2,1515,0.22536426451665686
2022-09-11,BH,Bahrain,1448,673693,3,1518,0.22532518521047423
2022-09-18,BH,Bahrain,2048,675741,2,1520,0.22493825296970288
2022-09-25,BH,Bahrain,2539,678280,0,1520,0.22409624343928763
2022-10-02,BH,Bahrain,2525,680805,0,1520,0.22326510527977908
2022-10-09,BH,Bahrain,2437,683242,0,1520,0.22246875923903975
2022-10-16,BH,Bahrain,2027,685269,1,1521,0.22195663308861194
2022-10-23,BH,Bahrain,2084,687353,3,1524,0.2217201350688802
2022-10-30,BH,Bahrain,2127,689480,3,1527,0.22147125369843942
2022-11-06,BH,Bahrain,2029,691509,2,1529,0.22111064353464668
2022-11-13,BH,Bahrain,1752,693261,2,1531,0.2208403472862313
2022-11-20,BH,Bahrain,1479,694740,2,1533,0.2206580879177822
2022-11-27,BH,Bahrain,1026,695766,3,1536,0.22076387751054236
2022-12-04,BH,Bahrain,848,696614,0,1536,0.22049513790994724
2022-12-11,BH,Bahrain,0,696614,0,1536,0.22049513790994724
2022-12-18,BH,Bahrain,0,696614,0,1536,0.22049513790994724
2022-12-25,BH,Bahrain,0,696614,0,1536,0.22049513790994724
2023-01-01,BH,Bahrain,0,696614,0,1536,0.22049513790994724
2023-01-08,BH,Bahrain,0,696614,0,1536,0.22049513790994724
2023-01-15,BH,Bahrain,0,696614,0,1536,0.22049513790994724
2023-01-22,BH,Bahrain,0,696614,0,1536,0.22049513790994724
2023-01-29,BH,Bahrain,0,696614,0,1536,0.22049513790994724
2023-02-05,BH,Bahrain,0,696614,0,1536,0.22049513790994724
2023-02-12,BH,Bahrain,0,696614,0,1536,0.22049513790994724
2023-02-19,BH,Bahrain,0,696614,0,1536,0.22049513790994724
2023-02-26,BH,Bahrain,0,696614,0,1536,0.22049513790994724
2023-03-05,BH,Bahrain,0,696614,0,1536,0.22049513790994724
2023-03-12,BH,Bahrain,0,696614,0,1536,0.22049513790994724
2023-03-19,BH,Bahrain,0,696614,0,1536,0.22049513790994724
2023-03-26,BH,Bahrain,0,696614,0,1536,0.22049513790994724
2023-04-02,BH,Bahrain,0,696614,0,1536,0.22049513790994724
2023-04-09,BH,Bahrain,0,696614,0,1536,0.22049513790994724
2023-04-16,BH,Bahrain,0,696614,0,1536,0.22049513790994724
2023-04-23,BH,Bahrain,0,696614,0,1536,0.22049513790994724
2023-04-30,BH,Bahrain,0,696614,0,1536,0.22049513790994724
2023-05-07,BH,Bahrain,0,696614,0,1536,0.22049513790994724
2023-05-14,BH,Bahrain,0,696614,0,1536,0.22049513790994724
2023-05-21,BH,Bahrain,0,696614,0,1536,0.22049513790994724
2023-05-28,BH,Bahrain,0,696614,0,1536,0.22049513790994724
2023-06-04,BH,Bahrain,0,696614,0,1536,0.22049513790994724
2023-06-11,BH,Bahrain,0,696614,0,1536,0.22049513790994724
2023-06-18,BH,Bahrain,0,696614,0,1536,0.22049513790994724
2023-06-25,BH,Bahrain,0,696614,0,1536,0.22049513790994724
2023-07-02,BH,Bahrain,0,696614,0,1536,0.22049513790994724
2023-07-09,BH,Bahrain,0,696614,0,1536,0.22049513790994724
2023-07-16,BH,Bahrain,0,696614,0,1536,0.22049513790994724
2023-07-23,BH,Bahrain,0,696614,0,1536,0.22049513790994724
2023-07-30,BH,Bahrain,0,696614,0,1536,0.22049513790994724
2023-08-06,BH,Bahrain,0,696614,0,1536,0.22049513790994724
2023-08-13,BH,Bahrain,0,696614,0,1536,0.22049513790994724
2023-08-20,BH,Bahrain,0,696614,0,1536,0.22049513790994724
2023-08-27,BH,Bahrain,0,696614,0,1536,0.22049513790994724
2023-09-03,BH,Bahrain,0,696614,0,1536,0.22049513790994724
2023-09-10,BH,Bahrain,0,696614,0,1536,0.22049513790994724
2023-09-17,BH,Bahrain,0,696614,0,1536,0.22049513790994724
2023-09-24,BH,Bahrain,0,696614,0,1536,0.22049513790994724
2023-10-01,BH,Bahrain,0,696614,0,1536,0.22049513790994724
2023-10-08,BH,Bahrain,0,696614,0,1536,0.22049513790994724
2023-10-15,BH,Bahrain,0,696614,0,1536,0.22049513790994724
2023-10-22,BH,Bahrain,0,696614,0,1536,0.22049513790994724
2023-10-29,BH,Bahrain,0,696614,0,1536,0.22049513790994724
2023-11-05,BH,Bahrain,0,696614,0,1536,0.22049513790994724
2023-11-12,BH,Bahrain,0,696614,0,1536,0.22049513790994724
2023-11-19,BH,Bahrain,0,696614,0,1536,0.22049513790994724
2023-11-26,BH,Bahrain,0,696614,0,1536,0.22049513790994724
2023-12-03,BH,Bahrain,0,696614,0,1536,0.22049513790994724
2023-12-10,BH,Bahrain,0,696614,0,1536,0.22049513790994724
2023-12-17,BH,Bahrain,0,696614,0,1536,0.22049513790994724
2023-12-24,BH,Bahrain,0,696614,0,1536,0.22049513790994724
2023-12-31,BH,Bahrain,0,696614,0,1536,0.22049513790994724
2024-01-07,BH,Bahrain,0,696614,0,1536,0.22049513790994724
2024-01-14,BH,Bahrain,0,696614,0,1536,0.22049513790994724
2021-01-10,BB,Barbados,413,808,0,7,0.8663366336633664
2021-01-17,BB,Barbados,228,1036,0,7,0.6756756756756757
2021-01-24,BB,Barbados,305,1341,2,9,0.6711409395973155
2021-01-31,BB,Barbados,157,1498,3,12,0.801068090787717
2021-09-05,BB,Barbados,394,5183,3,51,0.9839861084314104
2021-09-12,BB,Barbados,576,5759,0,51,0.8855704115297794
2021-09-19,BB,Barbados,599,6358,6,57,0.8965083359547028
2021-09-26,BB,Barbados,1043,7401,6,63,0.8512363194162952
2021-10-03,BB,Barbados,1208,8609,15,78,0.9060285747473574
2021-10-10,BB,Barbados,1774,10383,10,88,0.8475392468458057
2021-10-17,BB,Barbados,1722,12105,20,108,0.8921933085501859
2021-10-24,BB,Barbados,2648,14753,16,124,0.8405070155222667
2021-10-31,BB,Barbados,2712,17465,28,152,0.8703120526767822
2021-11-07,BB,Barbados,2051,19516,18,170,0.8710801393728222
2021-11-14,BB,Barbados,2361,21877,21,191,0.8730630342368697
2021-11-21,BB,Barbados,1549,23426,15,206,0.8793648083326219
2021-11-28,BB,Barbados,1497,24923,17,223,0.8947558480118766
2021-12-05,BB,Barbados,1041,25964,11,234,0.9012478816823294
2021-12-12,BB,Barbados,776,26740,17,251,0.9386686611817501
2021-12-19,BB,Barbados,429,27169,5,256,0.9422503588648828
2021-12-26,BB,Barbados,460,27629,4,260,0.941040211372109
2022-01-02,BB,Barbados,1181,28810,2,262,0.9094064560916348
2022-01-09,BB,Barbados,2194,31004,3,265,0.8547284221390788
2022-01-16,BB,Barbados,3687,34691,4,269,0.7754172551958721
2022-01-23,BB,Barbados,3895,38586,5,274,0.7101021095734205
2022-01-30,BB,Barbados,4265,42851,3,277,0.6464259877249072
2022-02-06,BB,Barbados,4273,47124,9,286,0.6069094304388423
2022-02-13,BB,Barbados,3756,50880,5,291,0.5719339622641509
2022-02-20,BB,Barbados,2628,53508,17,308,0.5756148613291471
2022-02-27,BB,Barbados,1394,54902,5,313,0.5701067356380459
2022-03-06,BB,Barbados,961,55863,3,316,0.5656695845192704
2022-03-13,BB,Barbados,942,56805,7,323,0.5686119179649679
2022-03-20,BB,Barbados,743,57548,3,326,0.5664836310558143
2022-03-27,BB,Barbados,722,58270,4,330,0.5663291573708598
2022-04-03,BB,Barbados,1225,59495,45,375,0.630305067652744
2022-04-10,BB,Barbados,1772,61267,4,379,0.6186038160836992
2022-04-17,BB,Barbados,2910,64177,2,381,0.5936706296648332
2022-04-24,BB,Barbados,2633,66810,7,388,0.5807513845232749
2022-05-01,BB,Barbados,2752,69562,4,392,0.5635260630804175
2022-05-08,BB,Barbados,3181,72743,11,403,0.5540051963762835
2022-05-15,BB,Barbados,3102,75845,29,432,0.569582701562397
2022-05-22,BB,Barbados,2603,78448,4,436,0.555782174179074
2022-05-29,BB,Barbados,1590,80038,8,444,0.5547365001624229
2022-06-05,BB,Barbados,1136,81174,18,462,0.5691477566708552
2022-06-12,BB,Barbados,897,82071,5,467,0.5690195074996041
2022-06-19,BB,Barbados,659,82730,4,471,0.5693218904871268
2022-06-26,BB,Barbados,794,83524,2,473,0.5663042957712753
2022-07-03,BB,Barbados,1038,84562,4,477,0.5640831579196329
2022-07-10,BB,Barbados,1117,85679,1,478,0.5578963339908263
2022-07-17,BB,Barbados,1784,87463,1,479,0.5476601534363101
2022-07-24,BB,Barbados,1876,89339,3,482,0.5395180156482611
2022-07-31,BB,Barbados,2254,91593,10,492,0.5371589531951132
2022-08-07,BB,Barbados,2500,94093,6,498,0.5292636009054872
2022-08-14,BB,Barbados,3011,97104,17,515,0.5303592025045313
2022-08-21,BB,Barbados,2100,99204,14,529,0.5332446272327729
2022-08-28,BB,Barbados,1322,100526,8,537,0.5341901597596642
2022-09-04,BB,Barbados,689,101215,7,544,0.537469742627081
2022-09-11,BB,Barbados,594,101809,12,556,0.5461206769539039
2022-09-18,BB,Barbados,351,102160,3,559,0.5471808927173062
2022-09-25,BB,Barbados,223,102383,0,559,0.5459890802183957
2022-10-02,BB,Barbados,226,102609,1,560,0.5457610930815036
2022-10-09,BB,Barbados,0,102609,0,560,0.5457610930815036
2022-10-16,BB,Barbados,405,103014,0,560,0.5436154309123032
2022-10-23,BB,Barbados,0,103014,0,560,0.5436154309123032
2022-10-30,BB,Barbados,410,103424,0,560,0.5414603960396039
2022-11-06,BB,Barbados,0,103424,0,560,0.5414603960396039
2022-11-13,BB,Barbados,121,103545,4,564,0.5446907141822396
2022-11-20,BB,Barbados,0,103545,0,564,0.5446907141822396
2022-11-27,BB,Barbados,871,104416,3,567,0.543020226785167
2022-12-04,BB,Barbados,0,104416,0,567,0.543020226785167
2022-12-11,BB,Barbados,528,104944,1,568,0.5412410428418967
2022-12-18,BB,Barbados,0,104944,0,568,0.5412410428418967
2022-12-25,BB,Barbados,571,105515,0,568,0.5383120883286736
2023-01-01,BB,Barbados,0,105515,0,568,0.5383120883286736
2023-01-08,BB,Barbados,390,105905,1,569,0.5372739719559984
2023-01-15,BB,Barbados,0,105905,0,569,0.5372739719559984
2023-01-22,BB,Barbados,252,106157,2,571,0.5378825701555244
2023-01-29,BB,Barbados,0,106157,0,571,0.5378825701555244
2023-02-05,BB,Barbados,277,106434,2,573,0.5383618016799143
2023-02-12,BB,Barbados,0,106434,0,573,0.5383618016799143
2023-02-19,BB,Barbados,211,106645,2,575,0.5391720193164237
2023-02-26,BB,Barbados,0,106645,0,575,0.5391720193164237
2023-03-05,BB,Barbados,153,106798,4,579,0.5421449839884642
2023-03-12,BB,Barbados,0,106798,0,579,0.5421449839884642
2023-03-19,BB,Barbados,0,106798,0,579,0.5421449839884642
2023-03-26,BB,Barbados,0,106798,0,579,0.5421449839884642
2023-04-02,BB,Barbados,534,107332,3,582,0.5422427607796371
2023-04-09,BB,Barbados,0,107332,0,582,0.5422427607796371
2023-04-16,BB,Barbados,0,107332,0,582,0.5422427607796371
2023-04-23,BB,Barbados,134,107466,6,588,0.5471497962146167
2023-04-30,BB,Barbados,0,107466,0,588,0.5471497962146167
2023-05-07,BB,Barbados,100,107566,1,589,0.5475707937452355
2023-05-14,BB,Barbados,228,107794,4,593,0.5501233834907323
2023-05-21,BB,Barbados,0,107794,0,593,0.5501233834907323
2023-05-28,BB,Barbados,144,107938,0,593,0.5493894643221109
2023-06-04,BB,Barbados,138,108076,0,593,0.5486879603242163
2023-06-11,BB,Barbados,263,108339,0,593,0.5473559844561977
2023-06-18,BB,Barbados,249,108588,0,593,0.5461008582900505
2023-06-25,BB,Barbados,197,108785,0,593,0.5451119180034012
2023-07-02,BB,Barbados,199,108984,0,593,0.5441165675695515
2023-07-09,BB,Barbados,166,109150,0,593,0.5432890517636281
2023-07-16,BB,Barbados,125,109275,0,593,0.5426675817890643
2023-07-23,BB,Barbados,96,109371,0,593,0.5421912572802662
2023-07-30,BB,Barbados,81,109452,0,593,0.5417900084055111
2023-08-06,BB,Barbados,83,109535,0,593,0.5413794677500343
2023-08-13,BB,Barbados,123,109658,0,593,0.5407722190811431
2023-08-20,BB,Barbados,151,109809,0,593,0.5400285951060478
2023-08-27,BB,Barbados,65,109874,0,593,0.539709121357191
2023-09-03,BB,Barbados,69,109943,0,593,0.5393704010259861
2023-09-10,BB,Barbados,83,110026,0,593,0.5389635177139949
2023-09-17,BB,Barbados,29,110055,0,593,0.5388214983417382
2023-09-24,BB,Barbados,19,110074,0,593,0.5387284917419191
2023-10-01,BB,Barbados,17,110091,0,593,0.5386453025224587
2023-10-08,BB,Barbados,15,110106,0,593,0.5385719216028191
2023-10-15,BB,Barbados,8,110114,0,593,0.5385327932869571
2023-10-22,BB,Barbados,9,110123,0,593,0.5384887807270052
2023-10-29,BB,Barbados,1,110124,0,593,0.5384838908866368
2023-11-05,BB,Barbados,1,110125,0,593,0.5384790011350737
2023-11-12,BB,Barbados,2,110127,0,593,0.5384692218983537
2023-11-19,BB,Barbados,1,110128,0,593,0.5384643324131919
2023-11-26,BB,Barbados,4,110132,0,593,0.5384447753604765
2023-12-03,BB,Barbados,4,110136,0,593,0.5384252197283359
2023-12-10,BB,Barbados,5,110141,0,593,0.5384007771856075
2023-12-17,BB,Barbados,4,110145,0,593,0.5383812247491943
2023-12-24,BB,Barbados,8,110153,0,593,0.5383421241364283
2023-12-31,BB,Barbados,21,110174,0,593,0.538239512044584
2024-01-07,BB,Barbados,0,110174,0,593,0.538239512044584
2024-01-14,BB,Barbados,0,110174,0,593,0.538239512044584
2020-04-05,BY,Belarus,346,440,4,4,0.9090909090909091
2020-04-19,BY,Belarus,3063,5289,22,45,0.8508224617129893
2020-04-26,BY,Belarus,4301,9590,22,67,0.6986444212721585
2020-05-03,BY,Belarus,6238,15828,30,97,0.6128380085923679
2020-05-10,BY,Belarus,7145,22973,34,131,0.5702346232533845
2020-05-17,BY,Belarus,5708,28681,29,160,0.5578606045814302
2020-05-24,BY,Belarus,6563,35244,34,194,0.550448303257292
2020-05-31,BY,Belarus,6414,41658,35,229,0.5497143405828412
2020-06-07,BY,Belarus,5210,46868,30,259,0.5526158573013571
2020-06-14,BY,Belarus,6373,53241,44,303,0.5691102721586747
2020-06-21,BY,Belarus,4695,57936,40,343,0.5920325876829605
2020-06-28,BY,Belarus,3159,61095,34,377,0.6170717734675505
2020-07-05,BY,Belarus,2175,63270,41,418,0.6606606606606606
2020-07-12,BY,Belarus,1494,64764,41,459,0.7087270705947749
2020-07-19,BY,Belarus,1189,65953,36,495,0.7505344715175959
2020-07-26,BY,Belarus,1049,67002,35,530,0.7910211635473569
2020-08-02,BY,Belarus,944,67946,33,563,0.8285991817031171
2020-08-09,BY,Belarus,792,68738,22,585,0.8510576391515611
2020-08-16,BY,Belarus,686,69424,22,607,0.874337404932012
2020-08-23,BY,Belarus,861,70285,30,637,0.9063100234758483
2020-08-30,BY,Belarus,1238,71523,34,671,0.9381597528067893
2020-09-06,BY,Belarus,1140,72663,34,705,0.9702324429214318
2020-11-08,BY,Belarus,5824,105283,19,1004,0.9536202425842728
2020-11-15,BY,Belarus,7587,112870,35,1039,0.9205280411092407
2020-11-22,BY,Belarus,9565,122435,50,1089,0.8894515457181361
2020-11-29,BY,Belarus,10889,133324,54,1143,0.857310011700819
2020-12-06,BY,Belarus,11955,145279,55,1198,0.8246202135201922
2020-12-13,BY,Belarus,13055,158334,56,1254,0.7919966652771988
2020-12-20,BY,Belarus,13245,171579,62,1316,0.7669936297565553
2020-12-27,BY,Belarus,13343,184922,60,1376,0.7440975113831778
2021-01-03,BY,Belarus,13203,198125,66,1442,0.7278233438485804
2021-01-10,BY,Belarus,12243,210368,65,1507,0.7163637055065409
2021-01-17,BY,Belarus,13169,223537,66,1573,0.7036866380062361
2021-01-24,BY,Belarus,12322,235859,66,1639,0.6949067027334128
2021-01-31,BY,Belarus,10711,246570,69,1708,0.6927038974733342
2021-02-07,BY,Belarus,10389,256959,65,1773,0.6899933452418479
2021-02-14,BY,Belarus,10070,267029,67,1840,0.6890637346505436
2021-02-21,BY,Belarus,9961,276990,63,1903,0.6870284125780713
2021-02-28,BY,Belarus,8969,285959,63,1966,0.6875111467028491
2021-03-07,BY,Belarus,8473,294432,63,2029,0.6891234648407782
2021-03-14,BY,Belarus,6896,301328,58,2087,0.6926007539956459
2021-03-21,BY,Belarus,7965,309293,61,2148,0.6944871044608187
2021-03-28,BY,Belarus,8338,317631,63,2211,0.6960907468099776
2021-04-04,BY,Belarus,8434,326065,65,2276,0.6980203333691135
2021-04-11,BY,Belarus,8798,334863,68,2344,0.6999877561868585
2021-04-18,BY,Belarus,8060,342923,69,2413,0.7036565059794765
2021-04-25,BY,Belarus,8751,351674,70,2483,0.7060516273594295
2021-05-02,BY,Belarus,8308,359982,69,2552,0.7089243351056442
2021-05-09,BY,Belarus,7692,367674,70,2622,0.7131317417059677
2021-05-16,BY,Belarus,7040,374714,69,2691,0.7181477073181146
2021-05-23,BY,Belarus,10059,384773,70,2761,0.7175659414771827
2021-05-30,BY,Belarus,6864,391637,60,2821,0.7203098787908191
2021-06-06,BY,Belarus,7272,398909,79,2900,0.7269828457116786
2021-06-13,BY,Belarus,5831,404740,69,2969,0.7335573454563423
2021-06-20,BY,Belarus,5356,410096,66,3035,0.7400706176114861
2021-06-27,BY,Belarus,4634,414730,68,3103,0.7481976225496105
2021-07-04,BY,Belarus,5676,420406,72,3175,0.7552223326974401
2021-07-11,BY,Belarus,6480,426886,72,3247,0.7606246164081277
2021-07-18,BY,Belarus,6523,433409,69,3316,0.7650971714939007
2021-07-25,BY,Belarus,6419,439828,69,3385,0.769619032894677
2021-08-01,BY,Belarus,6212,446040,69,3454,0.7743700116581473
2021-08-08,BY,Belarus,6913,452953,69,3523,0.7777848915891936
2021-08-15,BY,Belarus,7045,459998,70,3593,0.7810903525667503
2021-08-22,BY,Belarus,8417,468415,77,3670,0.7834932698568577
2021-08-29,BY,Belarus,9486,477901,75,3745,0.7836351043416943
2021-09-05,BY,Belarus,11062,488963,81,3826,0.7824722934046134
2021-09-12,BY,Belarus,12203,501166,79,3905,0.7791829453713939
2021-09-19,BY,Belarus,13280,514446,86,3991,0.7757859911438713
2021-09-26,BY,Belarus,13783,528229,90,4081,0.7725815886670364
2021-10-03,BY,Belarus,13749,541978,92,4173,0.7699574521475042
2021-10-10,BY,Belarus,13815,555793,102,4275,0.769171256205098
2021-10-17,BY,Belarus,14213,570006,111,4386,0.769465584572794
2021-10-24,BY,Belarus,14184,584190,113,4499,0.770126157585717
2021-10-31,BY,Belarus,13942,598132,115,4614,0.7714016304093411
2021-11-07,BY,Belarus,13883,612015,116,4730,0.7728568744230125
2021-11-14,BY,Belarus,13577,625592,104,4834,0.7727080908963031
2021-11-21,BY,Belarus,12810,638402,98,4932,0.7725539706955805
2021-11-28,BY,Belarus,11766,650168,109,5041,0.7753380664689742
2021-12-05,BY,Belarus,11888,662056,106,5147,0.7774266829392076
2021-12-12,BY,Belarus,11213,673269,114,5261,0.7814112932572271
2021-12-19,BY,Belarus,9903,683172,110,5371,0.7861856165065313
2021-12-26,BY,Belarus,9429,692601,113,5484,0.7917978749669723
2022-01-02,BY,Belarus,7820,700421,110,5594,0.7986625186851908
2022-01-09,BY,Belarus,7293,707714,105,5699,0.8052687950217179
2022-01-16,BY,Belarus,6581,714295,109,5808,0.8131094295774155
2022-01-23,BY,Belarus,10608,724903,108,5916,0.8161091897812535
2022-01-30,BY,Belarus,13698,738601,108,6024,0.815595971302503
2022-02-06,BY,Belarus,30475,769076,108,6132,0.7973204208686788
2022-02-13,BY,Belarus,53969,823045,105,6237,0.7577957462836176
2022-02-20,BY,Belarus,52889,875934,111,6348,0.7247121358458514
2022-02-27,BY,Belarus,37399,913333,106,6454,0.7066425936651801
2022-03-06,BY,Belarus,16007,929340,96,6550,0.7048012568059052
2022-03-13,BY,Belarus,10174,939514,97,6647,0.7074934487405191
2022-03-20,BY,Belarus,10480,949994,69,6716,0.7069518333800002
2022-03-27,BY,Belarus,8498,958492,52,6768,0.7061091798366601
2022-04-03,BY,Belarus,6185,964677,68,6836,0.7086309718175099
2022-04-10,BY,Belarus,4939,969616,36,6872,0.7087341793039719
2022-04-17,BY,Belarus,4430,974046,27,6899,0.7082827710395607
2022-04-24,BY,Belarus,3388,977434,23,6922,0.7081808081159444
2022-05-01,BY,Belarus,2911,980345,25,6947,0.708628085010889
2022-05-08,BY,Belarus,1986,982331,22,6969,0.7094350071411775
2022-05-15,BY,Belarus,536,982867,9,6978,0.7099638099559757
2022-05-22,BY,Belarus,0,982867,0,6978,0.7099638099559757
2022-05-29,BY,Belarus,0,982867,0,6978,0.7099638099559757
2022-06-05,BY,Belarus,0,982867,0,6978,0.7099638099559757
2022-06-12,BY,Belarus,0,982867,0,6978,0.7099638099559757
2022-06-19,BY,Belarus,0,982867,0,6978,0.7099638099559757
2022-06-26,BY,Belarus,0,982867,0,6978,0.7099638099559757
2022-07-03,BY,Belarus,11170,994037,140,7118,0.7160699249625517
2022-07-10,BY,Belarus,0,994037,0,7118,0.7160699249625517
2022-07-17,BY,Belarus,0,994037,0,7118,0.7160699249625517
2022-07-24,BY,Belarus,0,994037,0,7118,0.7160699249625517
2022-07-31,BY,Belarus,0,994037,0,7118,0.7160699249625517
2022-08-07,BY,Belarus,0,994037,0,7118,0.7160699249625517
2022-08-14,BY,Belarus,0,994037,0,7118,0.7160699249625517
2022-08-21,BY,Belarus,0,994037,0,7118,0.7160699249625517
2022-08-28,BY,Belarus,0,994037,0,7118,0.7160699249625517
2022-09-04,BY,Belarus,0,994037,0,7118,0.7160699249625517
2022-09-11,BY,Belarus,0,994037,0,7118,0.7160699249625517
2022-09-18,BY,Belarus,0,994037,0,7118,0.7160699249625517
2022-09-25,BY,Belarus,0,994037,0,7118,0.7160699249625517
2022-10-02,BY,Belarus,0,994037,0,7118,0.7160699249625517
2022-10-09,BY,Belarus,0,994037,0,7118,0.7160699249625517
2022-10-16,BY,Belarus,0,994037,0,7118,0.7160699249625517
2022-10-23,BY,Belarus,0,994037,0,7118,0.7160699249625517
2022-10-30,BY,Belarus,0,994037,0,7118,0.7160699249625517
2022-11-06,BY,Belarus,0,994037,0,7118,0.7160699249625517
2022-11-13,BY,Belarus,0,994037,0,7118,0.7160699249625517
2022-11-20,BY,Belarus,0,994037,0,7118,0.7160699249625517
2022-11-27,BY,Belarus,0,994037,0,7118,0.7160699249625517
2022-12-04,BY,Belarus,0,994037,0,7118,0.7160699249625517
2022-12-11,BY,Belarus,0,994037,0,7118,0.7160699249625517
2022-12-18,BY,Belarus,0,994037,0,7118,0.7160699249625517
2022-12-25,BY,Belarus,0,994037,0,7118,0.7160699249625517
2023-01-01,BY,Belarus,0,994037,0,7118,0.7160699249625517
2023-01-08,BY,Belarus,0,994037,0,7118,0.7160699249625517
2023-01-15,BY,Belarus,0,994037,0,7118,0.7160699249625517
2023-01-22,BY,Belarus,0,994037,0,7118,0.7160699249625517
2023-01-29,BY,Belarus,0,994037,0,7118,0.7160699249625517
2023-02-05,BY,Belarus,0,994037,0,7118,0.7160699249625517
2023-02-12,BY,Belarus,0,994037,0,7118,0.7160699249625517
2023-02-19,BY,Belarus,0,994037,0,7118,0.7160699249625517
2023-02-26,BY,Belarus,0,994037,0,7118,0.7160699249625517
2023-03-05,BY,Belarus,0,994037,0,7118,0.7160699249625517
2023-03-12,BY,Belarus,0,994037,0,7118,0.7160699249625517
2023-03-19,BY,Belarus,0,994037,0,7118,0.7160699249625517
2023-03-26,BY,Belarus,0,994037,0,7118,0.7160699249625517
2023-04-02,BY,Belarus,0,994037,0,7118,0.7160699249625517
2023-04-09,BY,Belarus,0,994037,0,7118,0.7160699249625517
2023-04-16,BY,Belarus,0,994037,0,7118,0.7160699249625517
2023-04-23,BY,Belarus,0,994037,0,7118,0.7160699249625517
2023-04-30,BY,Belarus,0,994037,0,7118,0.7160699249625517
2023-05-07,BY,Belarus,0,994037,0,7118,0.7160699249625517
2023-05-14,BY,Belarus,0,994037,0,7118,0.7160699249625517
2023-05-21,BY,Belarus,0,994037,0,7118,0.7160699249625517
2023-05-28,BY,Belarus,0,994037,0,7118,0.7160699249625517
2023-06-04,BY,Belarus,0,994037,0,7118,0.7160699249625517
2023-06-11,BY,Belarus,0,994037,0,7118,0.7160699249625517
2023-06-18,BY,Belarus,0,994037,0,7118,0.7160699249625517
2023-06-25,BY,Belarus,0,994037,0,7118,0.7160699249625517
2023-07-02,BY,Belarus,0,994037,0,7118,0.7160699249625517
2023-07-09,BY,Belarus,0,994037,0,7118,0.7160699249625517
2023-07-16,BY,Belarus,0,994037,0,7118,0.7160699249625517
2023-07-23,BY,Belarus,0,994037,0,7118,0.7160699249625517
2023-07-30,BY,Belarus,0,994037,0,7118,0.7160699249625517
2023-08-06,BY,Belarus,0,994037,0,7118,0.7160699249625517
2023-08-13,BY,Belarus,0,994037,0,7118,0.7160699249625517
2023-08-20,BY,Belarus,0,994037,0,7118,0.7160699249625517
2023-08-27,BY,Belarus,0,994037,0,7118,0.7160699249625517
2023-09-03,BY,Belarus,0,994037,0,7118,0.7160699249625517
2023-09-10,BY,Belarus,0,994037,0,7118,0.7160699249625517
2023-09-17,BY,Belarus,0,994037,0,7118,0.7160699249625517
2023-09-24,BY,Belarus,0,994037,0,7118,0.7160699249625517
2023-10-01,BY,Belarus,0,994037,0,7118,0.7160699249625517
2023-10-08,BY,Belarus,0,994037,0,7118,0.7160699249625517
2023-10-15,BY,Belarus,0,994037,0,7118,0.7160699249625517
2023-10-22,BY,Belarus,0,994037,0,7118,0.7160699249625517
2023-10-29,BY,Belarus,0,994037,0,7118,0.7160699249625517
2023-11-05,BY,Belarus,0,994037,0,7118,0.7160699249625517
2023-11-12,BY,Belarus,0,994037,0,7118,0.7160699249625517
2023-11-19,BY,Belarus,0,994037,0,7118,0.7160699249625517
2023-11-26,BY,Belarus,0,994037,0,7118,0.7160699249625517
2023-12-03,BY,Belarus,0,994037,0,7118,0.7160699249625517
2023-12-10,BY,Belarus,0,994037,0,7118,0.7160699249625517
2023-12-17,BY,Belarus,0,994037,0,7118,0.7160699249625517
2023-12-24,BY,Belarus,0,994037,0,7118,0.7160699249625517
2023-12-31,BY,Belarus,0,994037,0,7118,0.7160699249625517
2024-01-07,BY,Belarus,0,994037,0,7118,0.7160699249625517
2024-01-14,BY,Belarus,0,994037,0,7118,0.7160699249625517
2020-03-15,BE,Belgium,1046,1362,9,9,0.6607929515418502
2022-01-30,BE,Belgium,336348,3128165,210,29024,0.9278282955023153
2022-02-06,BE,Belgium,202844,3331009,287,29311,0.8799435846615845
2022-02-13,BE,Belgium,110136,3441145,325,29636,0.8612249701770778
2022-02-20,BE,Belgium,67474,3508619,292,29928,0.8529851773589552
2022-02-27,BE,Belgium,46661,3555280,174,30102,0.8466843680385229
2022-03-06,BE,Belgium,42733,3598013,139,30241,0.8404916824925313
2022-03-13,BE,Belgium,56086,3654099,142,30383,0.8314771986199608
2022-03-20,BE,Belgium,71510,3725609,130,30513,0.8190070401912815
2022-03-27,BE,Belgium,79185,3804794,152,30665,0.8059569059454992
2022-04-03,BE,Belgium,73163,3877957,169,30834,0.7951093836264818
2022-04-10,BE,Belgium,64176,3942133,176,31010,0.786629979252349
2022-04-17,BE,Belgium,53684,3995817,164,31174,0.7801658584464704
2022-04-24,BE,Belgium,42050,4037867,138,31312,0.7754589242290546
2022-05-01,BE,Belgium,33693,4071560,111,31423,0.7717680692412736
2022-05-08,BE,Belgium,31079,4102639,107,31530,0.7685297195293078
2022-05-15,BE,Belgium,26107,4128746,64,31594,0.765220238784367
2022-05-22,BE,Belgium,16893,4145639,58,31652,0.763501115268358
2022-05-29,BE,Belgium,9459,4155098,48,31700,0.7629182271994548
2022-06-05,BE,Belgium,11121,4166219,43,31743,0.7619138600251211
2022-06-12,BE,Belgium,13293,4179512,44,31787,0.7605433361598196
2022-06-19,BE,Belgium,19471,4198983,38,31825,0.7579216205447843
2022-06-26,BE,Belgium,27121,4226104,33,31858,0.7538385236141847
2022-07-03,BE,Belgium,39113,4265217,57,31915,0.7482620462217984
2022-07-10,BE,Belgium,54259,4319476,54,31969,0.7401129211043191
2022-07-17,BE,Belgium,50068,4369544,79,32048,0.7334403773025286
2022-07-24,BE,Belgium,30244,4399788,77,32125,0.7301488162611471
2022-07-31,BE,Belgium,28023,4427811,99,32224,0.7277636737430754
2022-08-07,BE,Belgium,20468,4448279,71,32295,0.7260111157596005
2022-08-14,BE,Belgium,15148,4463427,69,32364,0.7250930731027975
2022-08-21,BE,Belgium,12031,4475458,65,32429,0.7245962312683976
2022-08-28,BE,Belgium,10917,4486375,50,32479,0.7239475077317433
2022-09-04,BE,Belgium,10473,4496848,40,32519,0.7231509715249437
2022-09-11,BE,Belgium,11341,4508189,35,32554,0.7221081458652243
2022-09-18,BE,Belgium,13019,4521208,46,32600,0.7210462336614462
2022-09-25,BE,Belgium,15764,4536972,20,32620,0.7189817349545027
2022-10-02,BE,Belgium,20014,4556986,27,32647,0.716416508630924
2022-10-09,BE,Belgium,22321,4579307,50,32697,0.7140163347860277
2022-10-16,BE,Belgium,19437,4598744,69,32766,0.7124988910015431
2022-10-23,BE,Belgium,13434,4612178,65,32831,0.7118328910983054
2022-10-30,BE,Belgium,8326,4620504,50,32881,0.711632324092783
2022-11-06,BE,Belgium,4596,4625100,40,32921,0.7117900153510194
2022-11-13,BE,Belgium,4600,4629700,33,32954,0.7117955807071733
2022-11-20,BE,Belgium,5268,4634968,38,32992,0.7118064245535244
2022-11-27,BE,Belgium,6650,4641618,27,33019,0.7113683202710779
2022-12-04,BE,Belgium,8170,4649788,21,33040,0.710570030289553
2022-12-11,BE,Belgium,9710,4659498,45,33085,0.7100550316793783
2022-12-18,BE,Belgium,10121,4669619,70,33155,0.710015099732976
2022-12-25,BE,Belgium,9853,4679472,85,33240,0.7103365507903456
2023-01-01,BE,Belgium,6375,4685847,96,33336,0.7114188747519926
2023-01-08,BE,Belgium,4684,4690531,72,33408,0.7122434538861379
2023-01-15,BE,Belgium,3088,4693619,62,33470,0.7130958009160948
2023-01-22,BE,Belgium,2442,4696061,36,33506,0.7134915836910978
2023-01-29,BE,Belgium,3167,4699228,31,33537,0.7136704156512517
2023-02-05,BE,Belgium,4830,4704058,21,33558,0.7133840611659125
2023-02-12,BE,Belgium,6208,4710266,48,33606,0.7134628914800141
2023-02-19,BE,Belgium,8813,4719079,48,33654,0.7131476290182893
2023-02-26,BE,Belgium,9732,4728811,59,33713,0.7129276259930879
2023-03-05,BE,Belgium,10777,4739588,57,33770,0.7125091885623814
2023-03-12,BE,Belgium,12484,4752072,57,33827,0.7118368576907084
2023-03-19,BE,Belgium,11577,4763649,77,33904,0.7117233028713912
2023-03-26,BE,Belgium,9908,4773557,84,33988,0.7120057433063017
2023-04-02,BE,Belgium,7120,4780677,69,34057,0.7123886428637618
2023-04-09,BE,Belgium,5044,4785721,52,34109,0.7127243731926705
2023-04-16,BE,Belgium,3691,4789412,35,34144,0.7129058848977703
2023-04-23,BE,Belgium,3194,4792606,30,34174,0.713056737816545
2023-04-30,BE,Belgium,2492,4795098,43,34217,0.7135829132167892
2023-05-07,BE,Belgium,1717,4796815,31,34248,0.7139737513329157
2023-05-14,BE,Belgium,1361,4798176,19,34267,0.7141672168757461
2023-05-21,BE,Belgium,956,4799132,23,34290,0.7145042061772837
2023-05-28,BE,Belgium,873,4800005,17,34307,0.7147284221578936
2023-06-04,BE,Belgium,547,4800552,10,34317,0.7148552916414612
2023-06-11,BE,Belgium,532,4801084,7,34324,0.7149218801420679
2023-06-18,BE,Belgium,332,4801416,8,34332,0.7150390634762746
2023-06-25,BE,Belgium,236,4801652,6,34338,0.7151288764783454
2023-07-02,BE,Belgium,180,4801832,1,34339,0.7151228947618326
2023-07-09,BE,Belgium,160,4801992,0,34339,0.7150990672204369
2023-07-16,BE,Belgium,225,4802217,0,34339,0.7150655624266875
2023-07-23,BE,Belgium,193,4802410,0,34339,0.7150368252606504
2023-07-30,BE,Belgium,330,4802740,0,34339,0.7149876945243757
2023-08-06,BE,Belgium,513,4803253,0,34339,0.7149113319660655
2023-08-13,BE,Belgium,820,4804073,0,34339,0.7147893048253013
2023-08-20,BE,Belgium,1232,4805305,0,34339,0.7146060447775947
2023-08-27,BE,Belgium,1622,4806927,0,34339,0.7143649154647034
2023-09-03,BE,Belgium,2006,4808933,0,34339,0.7140669250330582
2023-09-10,BE,Belgium,2729,4811662,0,34339,0.7136619321972325
2023-09-17,BE,Belgium,2546,4814208,0,34339,0.7132845111802398
2023-09-24,BE,Belgium,2348,4816556,0,34339,0.7129367955028448
2023-10-01,BE,Belgium,2373,4818929,0,34339,0.7125857218481534
2023-10-08,BE,Belgium,2220,4821149,0,34339,0.7122575966849396
2023-10-15,BE,Belgium,2045,4823194,0,34339,0.7119556045226463
2023-10-22,BE,Belgium,1780,4824974,0,34339,0.7116929542003749
2023-10-29,BE,Belgium,1756,4826730,0,34339,0.7114340350506451
2023-11-05,BE,Belgium,1350,4828080,0,34339,0.7112351079518152
2023-11-12,BE,Belgium,1389,4829469,0,34339,0.7110305501495092
2023-11-19,BE,Belgium,1463,4830932,0,34339,0.7108152215762921
2023-11-26,BE,Belgium,1671,4832603,0,34339,0.7105694384579077
2023-12-03,BE,Belgium,2219,4834822,0,34339,0.7102433140247977
2023-12-10,BE,Belgium,3270,4838092,0,34339,0.7097632703139998
2023-12-17,BE,Belgium,3991,4842083,0,34339,0.7091782606783072
2023-12-24,BE,Belgium,3739,4845822,0,34339,0.7086310640382582
2023-12-31,BE,Belgium,2923,4848745,0,34339,0.7082038754358086
2024-01-07,BE,Belgium,0,4848745,0,34339,0.7082038754358086
2024-01-14,BE,Belgium,0,4848745,0,34339,0.7082038754358086
2020-08-16,BZ,Belize,242,388,1,3,0.7731958762886598
2020-08-23,BZ,Belize,260,648,2,5,0.7716049382716049
2022-09-18,BZ,Belize,231,68704,0,680,0.9897531439217513
2022-12-25,BZ,Belize,299,69675,0,688,0.9874416935773234
2023-01-01,BZ,Belize,271,69946,0,688,0.9836159322906243
2023-01-08,BZ,Belize,228,70174,0,688,0.9804200986120216
2023-01-15,BZ,Belize,223,70397,0,688,0.977314374192082
2023-01-22,BZ,Belize,158,70555,0,688,0.9751257883920346
2023-01-29,BZ,Belize,55,70610,0,688,0.9743662370769013
2023-02-05,BZ,Belize,50,70660,0,688,0.9736767619586754
2023-02-12,BZ,Belize,37,70697,0,688,0.9731671782395294
2023-02-19,BZ,Belize,24,70721,0,688,0.9728369225548282
2023-02-26,BZ,Belize,19,70740,0,688,0.9725756290641787
2023-03-05,BZ,Belize,17,70757,0,688,0.972341959099453
2023-03-12,BZ,Belize,25,70782,0,688,0.9719985306998955
2023-03-19,BZ,Belize,0,70782,0,688,0.9719985306998955
2023-03-26,BZ,Belize,0,70782,0,688,0.9719985306998955
2023-04-02,BZ,Belize,0,70782,0,688,0.9719985306998955
2023-04-09,BZ,Belize,0,70782,0,688,0.9719985306998955
2023-04-16,BZ,Belize,0,70782,0,688,0.9719985306998955
2023-04-23,BZ,Belize,0,70782,0,688,0.9719985306998955
2023-04-30,BZ,Belize,0,70782,0,688,0.9719985306998955
2023-05-07,BZ,Belize,0,70782,0,688,0.9719985306998955
2023-05-14,BZ,Belize,0,70782,0,688,0.9719985306998955
2023-05-21,BZ,Belize,0,70782,0,688,0.9719985306998955
2023-05-28,BZ,Belize,11,70793,0,688,0.9718474990465159
2023-06-04,BZ,Belize,7,70800,0,688,0.9717514124293786
2023-06-11,BZ,Belize,28,70828,0,688,0.9713672558875021
2023-06-18,BZ,Belize,28,70856,0,688,0.9709834029581123
2023-06-25,BZ,Belize,29,70885,0,688,0.9705861606827961
2023-07-02,BZ,Belize,33,70918,0,688,0.9701345215601117
2023-07-09,BZ,Belize,20,70938,0,688,0.9698610053849841
2023-07-16,BZ,Belize,41,70979,0,688,0.9693007791036785
2023-07-23,BZ,Belize,21,71000,0,688,0.9690140845070423
2023-07-30,BZ,Belize,42,71042,0,688,0.9684412037949381
2023-08-06,BZ,Belize,53,71095,0,688,0.9677192488923271
2023-08-13,BZ,Belize,59,71154,0,688,0.9669168282879389
2023-08-20,BZ,Belize,88,71242,0,688,0.9657224670840234
2023-08-27,BZ,Belize,20,71262,0,688,0.9654514327411524
2023-09-03,BZ,Belize,52,71314,0,688,0.9647474549176879
2023-09-10,BZ,Belize,29,71343,0,688,0.9643552976465806
2023-09-17,BZ,Belize,18,71361,0,688,0.9641120499992992
2023-09-24,BZ,Belize,12,71373,0,688,0.9639499530634834
2023-10-01,BZ,Belize,0,71373,0,688,0.9639499530634834
2023-10-08,BZ,Belize,0,71373,0,688,0.9639499530634834
2023-10-15,BZ,Belize,0,71373,0,688,0.9639499530634834
2023-10-22,BZ,Belize,0,71373,0,688,0.9639499530634834
2023-10-29,BZ,Belize,0,71373,0,688,0.9639499530634834
2023-11-05,BZ,Belize,0,71373,0,688,0.9639499530634834
2023-11-12,BZ,Belize,0,71373,0,688,0.9639499530634834
2023-11-19,BZ,Belize,0,71373,0,688,0.9639499530634834
2023-11-26,BZ,Belize,0,71373,0,688,0.9639499530634834
2023-12-03,BZ,Belize,0,71373,0,688,0.9639499530634834
2023-12-10,BZ,Belize,0,71373,0,688,0.9639499530634834
2023-12-17,BZ,Belize,0,71373,0,688,0.9639499530634834
2023-12-24,BZ,Belize,0,71373,0,688,0.9639499530634834
2023-12-31,BZ,Belize,0,71373,0,688,0.9639499530634834
2024-01-07,BZ,Belize,0,71373,0,688,0.9639499530634834
2024-01-14,BZ,Belize,0,71373,0,688,0.9639499530634834
2021-09-05,BJ,Benin,4454,16946,8,135,0.7966481765608404
2021-09-12,BJ,Benin,2344,19290,6,141,0.7309486780715396
2021-09-19,BJ,Benin,2160,21450,5,146,0.6806526806526807
2021-09-26,BJ,Benin,1508,22958,8,154,0.6707901385138079
2021-10-03,BJ,Benin,932,23890,5,159,0.6655504395144412
2021-10-10,BJ,Benin,445,24335,0,159,0.6533799054859256
2021-10-17,BJ,Benin,225,24560,2,161,0.6555374592833876
2021-10-24,BJ,Benin,118,24678,0,161,0.6524029499959478
2021-10-31,BJ,Benin,71,24749,0,161,0.6505313345993777
2021-11-07,BJ,Benin,55,24804,0,161,0.6490888566360264
2021-11-14,BJ,Benin,23,24827,0,161,0.6484875337334354
2021-11-21,BJ,Benin,19,24846,0,161,0.6479916284311358
2021-11-28,BJ,Benin,4,24850,0,161,0.647887323943662
2021-12-05,BJ,Benin,13,24863,0,161,0.6475485661424607
2021-12-12,BJ,Benin,34,24897,0,161,0.6466642567377595
2021-12-19,BJ,Benin,10,24907,0,161,0.6464046252057655
2021-12-26,BJ,Benin,28,24935,0,161,0.64567876478845
2022-01-02,BJ,Benin,109,25044,0,161,0.6428685513496246
2022-01-09,BJ,Benin,478,25522,0,161,0.6308283049917718
2022-01-16,BJ,Benin,514,26036,1,162,0.6222153940697496
2022-01-23,BJ,Benin,273,26309,1,163,0.6195598464403815
2022-01-30,BJ,Benin,141,26450,0,163,0.6162570888468809
2022-02-06,BJ,Benin,48,26498,0,163,0.6151407653407804
2022-02-13,BJ,Benin,54,26552,0,163,0.6138897258210305
2022-02-20,BJ,Benin,15,26567,0,163,0.6135431174012873
2022-02-27,BJ,Benin,0,26567,0,163,0.6135431174012873
2022-03-06,BJ,Benin,8,26575,0,163,0.6133584195672624
2022-03-13,BJ,Benin,0,26575,0,163,0.6133584195672624
2022-03-20,BJ,Benin,18,26593,0,163,0.6129432557439928
2022-03-27,BJ,Benin,0,26593,0,163,0.6129432557439928
2022-04-03,BJ,Benin,2,26595,0,163,0.6128971611205114
2022-04-10,BJ,Benin,0,26595,0,163,0.6128971611205114
2022-04-17,BJ,Benin,10,26605,0,163,0.6126667919563992
2022-04-24,BJ,Benin,0,26605,0,163,0.6126667919563992
2022-05-01,BJ,Benin,0,26605,0,163,0.6126667919563992
2022-05-08,BJ,Benin,5,26610,0,163,0.6125516723036453
2022-05-15,BJ,Benin,0,26610,0,163,0.6125516723036453
2022-05-22,BJ,Benin,60,26670,0,163,0.6111736032995876
2022-05-29,BJ,Benin,119,26789,0,163,0.6084586957333233
2022-06-05,BJ,Benin,125,26914,0,163,0.6056327561863714
2022-06-12,BJ,Benin,128,27042,0,163,0.6027660675985504
2022-06-19,BJ,Benin,80,27122,0,163,0.6009881277191947
2022-06-26,BJ,Benin,38,27160,0,163,0.6001472754050075
2022-07-03,BJ,Benin,56,27216,0,163,0.59891240446796
2022-07-10,BJ,Benin,30,27246,0,163,0.5982529545621376
2022-07-17,BJ,Benin,25,27271,0,163,0.5977045212863481
2022-07-24,BJ,Benin,24,27295,0,163,0.5971789705074189
2022-07-31,BJ,Benin,21,27316,0,163,0.5967198711377947
2022-08-07,BJ,Benin,0,27316,0,163,0.5967198711377947
2022-08-14,BJ,Benin,0,27316,0,163,0.5967198711377947
2022-08-21,BJ,Benin,0,27316,0,163,0.5967198711377947
2022-08-28,BJ,Benin,174,27490,0,163,0.5929428883230266
2022-09-04,BJ,Benin,45,27535,0,163,0.5919738514617758
2022-09-11,BJ,Benin,103,27638,0,163,0.5897677111223677
2022-09-18,BJ,Benin,89,27727,0,163,0.5878746348324738
2022-09-25,BJ,Benin,55,27782,0,163,0.5867108199553668
2022-10-02,BJ,Benin,0,27782,0,163,0.5867108199553668
2022-10-09,BJ,Benin,0,27782,0,163,0.5867108199553668
2022-10-16,BJ,Benin,0,27782,0,163,0.5867108199553668
2022-10-23,BJ,Benin,0,27782,0,163,0.5867108199553668
2022-10-30,BJ,Benin,130,27912,0,163,0.5839782172542276
2022-11-06,BJ,Benin,3,27915,0,163,0.583915457639262
2022-11-13,BJ,Benin,7,27922,0,163,0.5837690709834539
2022-11-20,BJ,Benin,53,27975,0,163,0.58266309204647
2022-11-27,BJ,Benin,5,27980,0,163,0.5825589706933524
2022-12-04,BJ,Benin,1,27981,0,163,0.5825381508881026
2022-12-11,BJ,Benin,1,27982,0,163,0.5825173325709384
2022-12-18,BJ,Benin,0,27982,0,163,0.5825173325709384
2022-12-25,BJ,Benin,3,27985,0,163,0.5824548865463641
2023-01-01,BJ,Benin,1,27986,0,163,0.5824340741799472
2023-01-08,BJ,Benin,0,27986,0,163,0.5824340741799472
2023-01-15,BJ,Benin,3,27989,0,163,0.5823716460037872
2023-01-22,BJ,Benin,1,27990,0,163,0.5823508395855663
2023-01-29,BJ,Benin,0,27990,0,163,0.5823508395855663
2023-02-05,BJ,Benin,1,27991,0,163,0.5823300346539959
2023-02-12,BJ,Benin,3,27994,0,163,0.5822676287775952
2023-02-19,BJ,Benin,5,27999,0,163,0.5821636487017393
2023-02-26,BJ,Benin,0,27999,0,163,0.5821636487017393
2023-03-05,BJ,Benin,8,28007,0,163,0.5819973578034063
2023-03-12,BJ,Benin,2,28009,0,163,0.5819557999214537
2023-03-19,BJ,Benin,3,28012,0,163,0.581893474225332
2023-03-26,BJ,Benin,1,28013,0,163,0.5818727019598043
2023-04-02,BJ,Benin,1,28014,0,163,0.5818519311772685
2023-04-09,BJ,Benin,0,28014,0,163,0.5818519311772685
2023-04-16,BJ,Benin,0,28014,0,163,0.5818519311772685
2023-04-23,BJ,Benin,0,28014,0,163,0.5818519311772685
2023-04-30,BJ,Benin,0,28014,0,163,0.5818519311772685
2023-05-07,BJ,Benin,0,28014,0,163,0.5818519311772685
2023-05-14,BJ,Benin,0,28014,0,163,0.5818519311772685
2023-05-21,BJ,Benin,0,28014,0,163,0.5818519311772685
2023-05-28,BJ,Benin,0,28014,0,163,0.5818519311772685
2023-06-04,BJ,Benin,0,28014,0,163,0.5818519311772685
2023-06-11,BJ,Benin,0,28014,0,163,0.5818519311772685
2023-06-18,BJ,Benin,0,28014,0,163,0.5818519311772685
2023-06-25,BJ,Benin,0,28014,0,163,0.5818519311772685
2023-07-02,BJ,Benin,0,28014,0,163,0.5818519311772685
2023-07-09,BJ,Benin,0,28014,0,163,0.5818519311772685
2023-07-16,BJ,Benin,0,28014,0,163,0.5818519311772685
2023-07-23,BJ,Benin,0,28014,0,163,0.5818519311772685
2023-07-30,BJ,Benin,0,28014,0,163,0.5818519311772685
2023-08-06,BJ,Benin,0,28014,0,163,0.5818519311772685
2023-08-13,BJ,Benin,0,28014,0,163,0.5818519311772685
2023-08-20,BJ,Benin,17,28031,0,163,0.5814990546181014
2023-08-27,BJ,Benin,0,28031,0,163,0.5814990546181014
2023-09-03,BJ,Benin,2,28033,0,163,0.5814575678664431
2023-09-10,BJ,Benin,0,28033,0,163,0.5814575678664431
2023-09-17,BJ,Benin,0,28033,0,163,0.5814575678664431
2023-09-24,BJ,Benin,3,28036,0,163,0.5813953488372093
2023-10-01,BJ,Benin,0,28036,0,163,0.5813953488372093
2023-10-08,BJ,Benin,0,28036,0,163,0.5813953488372093
2023-10-15,BJ,Benin,0,28036,0,163,0.5813953488372093
2023-10-22,BJ,Benin,0,28036,0,163,0.5813953488372093
2023-10-29,BJ,Benin,0,28036,0,163,0.5813953488372093
2023-11-05,BJ,Benin,0,28036,0,163,0.5813953488372093
2023-11-12,BJ,Benin,0,28036,0,163,0.5813953488372093
2023-11-19,BJ,Benin,0,28036,0,163,0.5813953488372093
2023-11-26,BJ,Benin,0,28036,0,163,0.5813953488372093
2023-12-03,BJ,Benin,0,28036,0,163,0.5813953488372093
2023-12-10,BJ,Benin,0,28036,0,163,0.5813953488372093
2023-12-17,BJ,Benin,0,28036,0,163,0.5813953488372093
2023-12-24,BJ,Benin,0,28036,0,163,0.5813953488372093
2023-12-31,BJ,Benin,0,28036,0,163,0.5813953488372093
2024-01-07,BJ,Benin,0,28036,0,163,0.5813953488372093
2024-01-14,BJ,Benin,0,28036,0,163,0.5813953488372093
2021-04-04,BM,Bermuda,415,1362,0,12,0.881057268722467
2021-04-11,BM,Bermuda,411,1773,2,14,0.7896221094190639
2021-04-18,BM,Bermuda,287,2060,3,17,0.825242718446602
2021-09-19,BM,Bermuda,699,4218,3,38,0.9009009009009009
2022-04-24,BM,Bermuda,351,13252,0,131,0.9885300332025355
2022-05-01,BM,Bermuda,307,13559,0,131,0.9661479460137179
2022-05-08,BM,Bermuda,273,13832,3,134,0.9687680740312319
2022-05-15,BM,Bermuda,303,14135,1,135,0.955076052352317
2022-05-22,BM,Bermuda,307,14442,2,137,0.9486220745049161
2022-05-29,BM,Bermuda,313,14755,1,138,0.9352761775669264
2022-06-05,BM,Bermuda,330,15085,0,138,0.9148160424262513
2022-06-12,BM,Bermuda,343,15428,0,138,0.8944775732434536
2022-06-19,BM,Bermuda,334,15762,0,138,0.8755234107346783
2022-06-26,BM,Bermuda,195,15957,0,138,0.8648242150780222
2022-07-03,BM,Bermuda,205,16162,2,140,0.8662294270511075
2022-07-10,BM,Bermuda,239,16401,0,140,0.8536064874093043
2022-07-17,BM,Bermuda,321,16722,1,141,0.843200574094008
2022-07-24,BM,Bermuda,266,16988,1,142,0.8358841535201318
2022-07-31,BM,Bermuda,205,17193,2,144,0.837550165765137
2022-08-07,BM,Bermuda,163,17356,4,148,0.8527310440193593
2022-08-14,BM,Bermuda,200,17556,0,148,0.8430166324903167
2022-08-21,BM,Bermuda,118,17674,0,148,0.8373882539323301
2022-08-28,BM,Bermuda,239,17913,0,148,0.8262155976106738
2022-09-04,BM,Bermuda,0,17913,0,148,0.8262155976106738
2022-09-11,BM,Bermuda,0,17913,0,148,0.8262155976106738
2022-09-18,BM,Bermuda,164,18077,0,148,0.8187199203407646
2022-09-25,BM,Bermuda,45,18122,0,148,0.8166868999006732
2022-10-02,BM,Bermuda,32,18154,0,148,0.815247328412471
2022-10-09,BM,Bermuda,66,18220,0,148,0.8122941822173435
2022-10-16,BM,Bermuda,60,18280,0,148,0.8096280087527352
2022-10-23,BM,Bermuda,60,18340,0,148,0.806979280261723
2022-10-30,BM,Bermuda,0,18340,0,148,0.806979280261723
2022-11-06,BM,Bermuda,88,18428,1,149,0.8085522031690905
2022-11-13,BM,Bermuda,0,18428,0,149,0.8085522031690905
2022-11-20,BM,Bermuda,35,18463,2,151,0.8178519200563289
2022-11-27,BM,Bermuda,0,18463,0,151,0.8178519200563289
2022-12-04,BM,Bermuda,56,18519,1,152,0.8207786597548463
2022-12-11,BM,Bermuda,0,18519,0,152,0.8207786597548463
2022-12-18,BM,Bermuda,38,18557,0,152,0.8190979145335993
2022-12-25,BM,Bermuda,0,18557,0,152,0.8190979145335993
2023-01-01,BM,Bermuda,65,18622,1,153,0.8216088497476104
2023-01-08,BM,Bermuda,62,18684,1,154,0.824234639263541
2023-01-15,BM,Bermuda,34,18718,1,155,0.8280799230687039
2023-01-22,BM,Bermuda,33,18751,2,157,0.8372886779371767
2023-01-29,BM,Bermuda,15,18766,0,157,0.8366194180965576
2023-02-05,BM,Bermuda,5,18771,0,157,0.8363965691758565
2023-02-12,BM,Bermuda,14,18785,1,158,0.8410966196433325
2023-02-19,BM,Bermuda,6,18791,1,159,0.8461497525411101
2023-02-26,BM,Bermuda,8,18799,1,160,0.8511091015479546
2023-03-05,BM,Bermuda,15,18814,0,160,0.8504305304560434
2023-03-12,BM,Bermuda,14,18828,0,160,0.8497981729339281
2023-03-19,BM,Bermuda,8,18836,1,161,0.8547462306222128
2023-03-26,BM,Bermuda,13,18849,2,163,0.8647673616637488
2023-04-02,BM,Bermuda,0,18849,0,163,0.8647673616637488
2023-04-09,BM,Bermuda,11,18860,2,165,0.8748674443266171
2023-04-16,BM,Bermuda,0,18860,0,165,0.8748674443266171
2023-04-23,BM,Bermuda,0,18860,0,165,0.8748674443266171
2023-04-30,BM,Bermuda,0,18860,0,165,0.8748674443266171
2023-05-07,BM,Bermuda,0,18860,0,165,0.8748674443266171
2023-05-14,BM,Bermuda,0,18860,0,165,0.8748674443266171
2023-05-21,BM,Bermuda,0,18860,0,165,0.8748674443266171
2023-05-28,BM,Bermuda,0,18860,0,165,0.8748674443266171
2023-06-04,BM,Bermuda,0,18860,0,165,0.8748674443266171
2023-06-11,BM,Bermuda,0,18860,0,165,0.8748674443266171
2023-06-18,BM,Bermuda,0,18860,0,165,0.8748674443266171
2023-06-25,BM,Bermuda,0,18860,0,165,0.8748674443266171
2023-07-02,BM,Bermuda,0,18860,0,165,0.8748674443266171
2023-07-09,BM,Bermuda,0,18860,0,165,0.8748674443266171
2023-07-16,BM,Bermuda,0,18860,0,165,0.8748674443266171
2023-07-23,BM,Bermuda,0,18860,0,165,0.8748674443266171
2023-07-30,BM,Bermuda,0,18860,0,165,0.8748674443266171
2023-08-06,BM,Bermuda,0,18860,0,165,0.8748674443266171
2023-08-13,BM,Bermuda,0,18860,0,165,0.8748674443266171
2023-08-20,BM,Bermuda,0,18860,0,165,0.8748674443266171
2023-08-27,BM,Bermuda,0,18860,0,165,0.8748674443266171
2023-09-03,BM,Bermuda,0,18860,0,165,0.8748674443266171
2023-09-10,BM,Bermuda,0,18860,0,165,0.8748674443266171
2023-09-17,BM,Bermuda,0,18860,0,165,0.8748674443266171
2023-09-24,BM,Bermuda,0,18860,0,165,0.8748674443266171
2023-10-01,BM,Bermuda,0,18860,0,165,0.8748674443266171
2023-10-08,BM,Bermuda,0,18860,0,165,0.8748674443266171
2023-10-15,BM,Bermuda,0,18860,0,165,0.8748674443266171
2023-10-22,BM,Bermuda,0,18860,0,165,0.8748674443266171
2023-10-29,BM,Bermuda,0,18860,0,165,0.8748674443266171
2023-11-05,BM,Bermuda,0,18860,0,165,0.8748674443266171
2023-11-12,BM,Bermuda,0,18860,0,165,0.8748674443266171
2023-11-19,BM,Bermuda,0,18860,0,165,0.8748674443266171
2023-11-26,BM,Bermuda,0,18860,0,165,0.8748674443266171
2023-12-03,BM,Bermuda,0,18860,0,165,0.8748674443266171
2023-12-10,BM,Bermuda,0,18860,0,165,0.8748674443266171
2023-12-17,BM,Bermuda,0,18860,0,165,0.8748674443266171
2023-12-24,BM,Bermuda,0,18860,0,165,0.8748674443266171
2023-12-31,BM,Bermuda,0,18860,0,165,0.8748674443266171
2024-01-07,BM,Bermuda,0,18860,0,165,0.8748674443266171
2024-01-14,BM,Bermuda,0,18860,0,165,0.8748674443266171
2021-01-10,BT,Bhutan,97,813,1,1,0.12300123001230012
2021-01-17,BT,Bhutan,29,842,0,1,0.11876484560570072
2021-01-24,BT,Bhutan,13,855,0,1,0.11695906432748539
2021-01-31,BT,Bhutan,4,859,0,1,0.11641443538998836
2021-02-07,BT,Bhutan,2,861,0,1,0.11614401858304298
2021-02-14,BT,Bhutan,3,864,0,1,0.11574074074074073
2021-02-21,BT,Bhutan,2,866,0,1,0.11547344110854503
2021-02-28,BT,Bhutan,1,867,0,1,0.11534025374855825
2021-03-07,BT,Bhutan,1,868,0,1,0.1152073732718894
2021-03-14,BT,Bhutan,0,868,0,1,0.1152073732718894
2021-03-21,BT,Bhutan,1,869,0,1,0.11507479861910241
2021-03-28,BT,Bhutan,3,872,0,1,0.11467889908256881
2021-04-04,BT,Bhutan,19,891,0,1,0.11223344556677892
2021-04-11,BT,Bhutan,27,918,0,1,0.10893246187363835
2021-04-18,BT,Bhutan,39,957,0,1,0.10449320794148381
2021-04-25,BT,Bhutan,65,1022,0,1,0.09784735812133072
2021-05-02,BT,Bhutan,89,1111,0,1,0.09000900090009001
2021-05-09,BT,Bhutan,110,1221,0,1,0.08190008190008191
2021-05-16,BT,Bhutan,65,1286,0,1,0.07776049766718507
2021-05-23,BT,Bhutan,108,1394,0,1,0.07173601147776185
2021-05-30,BT,Bhutan,218,1612,0,1,0.062034739454094295
2021-06-06,BT,Bhutan,75,1687,0,1,0.05927682276229994
2021-06-13,BT,Bhutan,126,1813,0,1,0.05515719801434087
2021-06-20,BT,Bhutan,111,1924,0,1,0.05197505197505198
2021-06-27,BT,Bhutan,128,2052,0,1,0.04873294346978557
2021-07-04,BT,Bhutan,107,2159,0,1,0.04631773969430292
2021-07-11,BT,Bhutan,116,2275,0,1,0.04395604395604395
2021-07-18,BT,Bhutan,146,2421,1,2,0.08261049153242463
2021-07-25,BT,Bhutan,65,2486,0,2,0.08045052292839903
2021-08-01,BT,Bhutan,32,2518,0,2,0.07942811755361398
2021-08-08,BT,Bhutan,26,2544,0,2,0.07861635220125787
2021-08-15,BT,Bhutan,27,2571,1,3,0.11668611435239205
2021-08-22,BT,Bhutan,14,2585,0,3,0.11605415860735009
2021-08-29,BT,Bhutan,9,2594,0,3,0.1156515034695451
2021-09-05,BT,Bhutan,2,2596,0,3,0.11556240369799693
2021-09-12,BT,Bhutan,0,2596,0,3,0.11556240369799693
2021-09-19,BT,Bhutan,1,2597,0,3,0.11551790527531768
2021-09-26,BT,Bhutan,2,2599,0,3,0.11542901115813775
2021-10-03,BT,Bhutan,9,2608,0,3,0.11503067484662577
2021-10-10,BT,Bhutan,5,2613,0,3,0.1148105625717566
2021-10-17,BT,Bhutan,4,2617,0,3,0.11463507833397019
2021-10-24,BT,Bhutan,0,2617,0,3,0.11463507833397019
2021-10-31,BT,Bhutan,4,2621,0,3,0.11446012972148034
2021-11-07,BT,Bhutan,2,2623,0,3,0.1143728555089592
2021-11-14,BT,Bhutan,2,2625,0,3,0.1142857142857143
2021-11-21,BT,Bhutan,7,2632,0,3,0.11398176291793312
2021-11-28,BT,Bhutan,8,2640,0,3,0.11363636363636363
2021-12-05,BT,Bhutan,1,2641,0,3,0.1135933358576297
2021-12-12,BT,Bhutan,8,2649,0,3,0.11325028312570783
2021-12-19,BT,Bhutan,8,2657,0,3,0.11290929619872037
2021-12-26,BT,Bhutan,3,2660,0,3,0.11278195488721805
2022-01-02,BT,Bhutan,0,2660,0,3,0.11278195488721805
2022-01-09,BT,Bhutan,121,2781,0,3,0.10787486515641855
2022-01-16,BT,Bhutan,147,2928,0,3,0.10245901639344263
2022-01-23,BT,Bhutan,721,3649,0,3,0.0822143052891203
2022-01-30,BT,Bhutan,1036,4685,1,4,0.08537886872998933
2022-02-06,BT,Bhutan,1407,6092,0,4,0.06565988181221273
2022-02-13,BT,Bhutan,1337,7429,1,5,0.06730380939561179
2022-02-20,BT,Bhutan,2649,10078,1,6,0.05953562214725144
2022-02-27,BT,Bhutan,2116,12194,0,6,0.049204526816467115
2022-03-06,BT,Bhutan,2604,14798,1,7,0.04730368968779565
2022-03-13,BT,Bhutan,2822,17620,0,7,0.039727582292849034
2022-03-20,BT,Bhutan,4384,22004,2,9,0.040901654244682784
2022-03-27,BT,Bhutan,3076,25080,0,9,0.03588516746411483
2022-04-03,BT,Bhutan,6357,31437,3,12,0.038171581257753606
2022-04-10,BT,Bhutan,10785,42222,2,14,0.03315806925299607
2022-04-17,BT,Bhutan,10574,52796,4,18,0.034093491931206914
2022-04-24,BT,Bhutan,4975,57771,2,20,0.03461944574267366
2022-05-01,BT,Bhutan,1448,59219,1,21,0.03546159171887401
2022-05-08,BT,Bhutan,278,59497,0,21,0.035295897272131366
2022-05-15,BT,Bhutan,73,59570,0,21,0.03525264394829612
2022-05-22,BT,Bhutan,42,59612,0,21,0.03522780648191639
2022-05-29,BT,Bhutan,13,59625,0,21,0.03522012578616352
2022-06-05,BT,Bhutan,11,59636,0,21,0.03521362935139848
2022-06-12,BT,Bhutan,7,59643,0,21,0.03520949650419999
2022-06-19,BT,Bhutan,18,59661,0,21,0.03519887363604365
2022-06-26,BT,Bhutan,48,59709,0,21,0.03517057729990454
2022-07-03,BT,Bhutan,103,59812,0,21,0.035110011368956064
2022-07-10,BT,Bhutan,128,59940,0,21,0.03503503503503503
2022-07-17,BT,Bhutan,167,60107,0,21,0.03493769444490658
2022-07-24,BT,Bhutan,261,60368,0,21,0.03478664192949907
2022-07-31,BT,Bhutan,162,60530,0,21,0.03469354039319346
2022-08-07,BT,Bhutan,133,60663,0,21,0.034617476880470795
2022-08-14,BT,Bhutan,116,60779,0,21,0.03455140755853173
2022-08-21,BT,Bhutan,119,60898,0,21,0.034483891096587733
2022-08-28,BT,Bhutan,178,61076,0,21,0.03438339118475342
2022-09-04,BT,Bhutan,157,61233,0,21,0.034295232962618195
2022-09-11,BT,Bhutan,186,61419,0,21,0.03419137400478679
2022-09-18,BT,Bhutan,311,61730,0,21,0.034019115502996924
2022-09-25,BT,Bhutan,239,61969,0,21,0.03388791169778437
2022-10-02,BT,Bhutan,126,62095,0,21,0.033819148079555515
2022-10-09,BT,Bhutan,105,62200,0,21,0.03376205787781351
2022-10-16,BT,Bhutan,48,62248,0,21,0.033736023647346104
2022-10-23,BT,Bhutan,83,62331,0,21,0.0336911007363912
2022-10-30,BT,Bhutan,49,62380,0,21,0.033664636101314524
2022-11-06,BT,Bhutan,50,62430,0,21,0.03363767419509851
2022-11-13,BT,Bhutan,30,62460,0,21,0.03362151777137368
2022-11-20,BT,Bhutan,28,62488,0,21,0.03360645243886826
2022-11-27,BT,Bhutan,15,62503,0,21,0.033598387277410685
2022-12-04,BT,Bhutan,9,62512,0,21,0.03359355003839263
2022-12-11,BT,Bhutan,9,62521,0,21,0.03358871419203148
2022-12-18,BT,Bhutan,3,62524,0,21,0.03358710255261979
2022-12-25,BT,Bhutan,7,62531,0,21,0.03358334266203963
2023-01-01,BT,Bhutan,7,62538,0,21,0.0335795836131632
2023-01-08,BT,Bhutan,13,62551,0,21,0.03357260475452031
2023-01-15,BT,Bhutan,26,62577,0,21,0.033558655736133085
2023-01-22,BT,Bhutan,21,62598,0,21,0.033547397680437074
2023-01-29,BT,Bhutan,7,62605,0,21,0.03354364667358837
2023-02-05,BT,Bhutan,3,62608,0,21,0.03354203935599284
2023-02-12,BT,Bhutan,3,62611,0,21,0.03354043219242625
2023-02-19,BT,Bhutan,4,62615,0,21,0.03353828954723309
2023-02-26,BT,Bhutan,5,62620,0,21,0.033535611625678696
2023-03-05,BT,Bhutan,7,62627,0,21,0.033531863253868144
2023-03-12,BT,Bhutan,10,62637,0,21,0.03352650989032042
2023-03-19,BT,Bhutan,10,62647,0,21,0.03352115823582933
2023-03-26,BT,Bhutan,1,62648,0,21,0.03352062316434683
2023-04-02,BT,Bhutan,1,62649,0,21,0.03352008810994589
2023-04-09,BT,Bhutan,1,62650,0,21,0.0335195530726257
2023-04-16,BT,Bhutan,4,62654,0,21,0.03351741309413605
2023-04-23,BT,Bhutan,9,62663,0,21,0.03351259914143913
2023-04-30,BT,Bhutan,3,62666,0,21,0.033510994797816995
2023-05-07,BT,Bhutan,2,62668,0,21,0.033509925320737856
2023-05-14,BT,Bhutan,0,62668,0,21,0.033509925320737856
2023-05-21,BT,Bhutan,2,62670,0,21,0.03350885591191958
2023-05-28,BT,Bhutan,1,62671,0,21,0.03350832123310622
2023-06-04,BT,Bhutan,1,62672,0,21,0.033507786571355634
2023-06-11,BT,Bhutan,0,62672,0,21,0.033507786571355634
2023-06-18,BT,Bhutan,0,62672,0,21,0.033507786571355634
2023-06-25,BT,Bhutan,1,62673,0,21,0.03350725192666699
2023-07-02,BT,Bhutan,0,62673,0,21,0.03350725192666699
2023-07-09,BT,Bhutan,10,62683,0,21,0.03350190641800807
2023-07-16,BT,Bhutan,7,62690,0,21,0.03349816557664699
2023-07-23,BT,Bhutan,0,62690,0,21,0.03349816557664699
2023-07-30,BT,Bhutan,1,62691,0,21,0.03349763123893382
2023-08-06,BT,Bhutan,0,62691,0,21,0.03349763123893382
2023-08-13,BT,Bhutan,3,62694,0,21,0.03349602832806967
2023-08-20,BT,Bhutan,0,62694,0,21,0.03349602832806967
2023-08-27,BT,Bhutan,3,62697,0,21,0.03349442557060146
2023-09-03,BT,Bhutan,0,62697,0,21,0.03349442557060146
2023-09-10,BT,Bhutan,0,62697,0,21,0.03349442557060146
2023-09-17,BT,Bhutan,0,62697,0,21,0.03349442557060146
2023-09-24,BT,Bhutan,0,62697,0,21,0.03349442557060146
2023-10-01,BT,Bhutan,0,62697,0,21,0.03349442557060146
2023-10-08,BT,Bhutan,0,62697,0,21,0.03349442557060146
2023-10-15,BT,Bhutan,0,62697,0,21,0.03349442557060146
2023-10-22,BT,Bhutan,0,62697,0,21,0.03349442557060146
2023-10-29,BT,Bhutan,0,62697,0,21,0.03349442557060146
2023-11-05,BT,Bhutan,0,62697,0,21,0.03349442557060146
2023-11-12,BT,Bhutan,0,62697,0,21,0.03349442557060146
2023-11-19,BT,Bhutan,0,62697,0,21,0.03349442557060146
2023-11-26,BT,Bhutan,0,62697,0,21,0.03349442557060146
2023-12-03,BT,Bhutan,0,62697,0,21,0.03349442557060146
2023-12-10,BT,Bhutan,0,62697,0,21,0.03349442557060146
2023-12-17,BT,Bhutan,0,62697,0,21,0.03349442557060146
2023-12-24,BT,Bhutan,0,62697,0,21,0.03349442557060146
2023-12-31,BT,Bhutan,0,62697,0,21,0.03349442557060146
2024-01-07,BT,Bhutan,0,62697,0,21,0.03349442557060146
2024-01-14,BT,Bhutan,0,62697,0,21,0.03349442557060146
2020-10-04,BQ,"Bonaire, Saint Eustatius and Saba",36,121,0,1,0.8264462809917356
2021-01-17,BQ,"Bonaire, Saint Eustatius and Saba",75,353,0,3,0.84985835694051
2021-01-24,BQ,"Bonaire, Saint Eustatius and Saba",23,376,0,3,0.7978723404255319
2021-01-31,BQ,"Bonaire, Saint Eustatius and Saba",12,388,0,3,0.7731958762886598
2021-02-07,BQ,"Bonaire, Saint Eustatius and Saba",4,392,0,3,0.7653061224489796
2021-02-21,BQ,"Bonaire, Saint Eustatius and Saba",15,413,0,4,0.9685230024213075
2021-02-28,BQ,"Bonaire, Saint Eustatius and Saba",19,432,0,4,0.9259259259259258
2021-03-14,BQ,"Bonaire, Saint Eustatius and Saba",178,659,1,6,0.9104704097116844
2021-03-21,BQ,"Bonaire, Saint Eustatius and Saba",286,945,0,6,0.6349206349206349
2021-03-28,BQ,"Bonaire, Saint Eustatius and Saba",302,1247,4,10,0.8019246190858059
2021-04-04,BQ,"Bonaire, Saint Eustatius and Saba",164,1411,1,11,0.7795889440113395
2021-04-11,BQ,"Bonaire, Saint Eustatius and Saba",90,1501,3,14,0.9327115256495668
2021-04-18,BQ,"Bonaire, Saint Eustatius and Saba",36,1537,0,14,0.9108653220559532
2021-04-25,BQ,"Bonaire, Saint Eustatius and Saba",16,1553,1,15,0.9658725048293626
2021-08-15,BQ,"Bonaire, Saint Eustatius and Saba",23,1738,0,17,0.9781357882623706
2021-08-22,BQ,"Bonaire, Saint Eustatius and Saba",29,1767,0,17,0.9620826259196379
2021-08-29,BQ,"Bonaire, Saint Eustatius and Saba",16,1783,0,17,0.9534492428491307
2021-09-05,BQ,"Bonaire, Saint Eustatius and Saba",18,1801,0,17,0.9439200444197668
2021-09-12,BQ,"Bonaire, Saint Eustatius and Saba",94,1895,0,17,0.8970976253298154
2021-09-19,BQ,"Bonaire, Saint Eustatius and Saba",61,1956,0,17,0.869120654396728
2021-09-26,BQ,"Bonaire, Saint Eustatius and Saba",42,1998,1,18,0.9009009009009009
2021-10-03,BQ,"Bonaire, Saint Eustatius and Saba",101,2099,2,20,0.9528346831824679
2021-10-10,BQ,"Bonaire, Saint Eustatius and Saba",105,2204,0,20,0.9074410163339384
2021-10-17,BQ,"Bonaire, Saint Eustatius and Saba",102,2306,-1,19,0.823937554206418
2021-10-24,BQ,"Bonaire, Saint Eustatius and Saba",67,2373,0,19,0.8006742520016856
2021-10-31,BQ,"Bonaire, Saint Eustatius and Saba",38,2411,0,19,0.7880547490667772
2021-11-07,BQ,"Bonaire, Saint Eustatius and Saba",64,2475,0,19,0.7676767676767676
2021-11-14,BQ,"Bonaire, Saint Eustatius and Saba",109,2584,2,21,0.8126934984520124
2021-11-21,BQ,"Bonaire, Saint Eustatius and Saba",86,2670,0,21,0.7865168539325843
2021-11-28,BQ,"Bonaire, Saint Eustatius and Saba",156,2826,1,22,0.778485491861288
2021-12-05,BQ,"Bonaire, Saint Eustatius and Saba",172,2998,0,22,0.733822548365577
2021-12-12,BQ,"Bonaire, Saint Eustatius and Saba",112,3110,0,22,0.707395498392283
2021-12-19,BQ,"Bonaire, Saint Eustatius and Saba",67,3177,0,22,0.6924771797293043
2021-12-26,BQ,"Bonaire, Saint Eustatius and Saba",62,3239,0,22,0.6792219820932387
2022-01-02,BQ,"Bonaire, Saint Eustatius and Saba",186,3425,1,23,0.6715328467153284
2022-01-09,BQ,"Bonaire, Saint Eustatius and Saba",687,4112,0,23,0.5593385214007782
2022-01-16,BQ,"Bonaire, Saint Eustatius and Saba",1041,5153,2,25,0.4851542790607413
2022-01-23,BQ,"Bonaire, Saint Eustatius and Saba",919,6072,2,27,0.4446640316205534
2022-01-30,BQ,"Bonaire, Saint Eustatius and Saba",778,6850,0,27,0.3941605839416058
2022-02-06,BQ,"Bonaire, Saint Eustatius and Saba",296,7146,2,29,0.40582143856703046
2022-02-13,BQ,"Bonaire, Saint Eustatius and Saba",228,7374,2,31,0.4203959858963927
2022-02-20,BQ,"Bonaire, Saint Eustatius and Saba",124,7498,0,31,0.4134435849559883
2022-02-27,BQ,"Bonaire, Saint Eustatius and Saba",84,7582,0,31,0.40886309680823
2022-03-06,BQ,"Bonaire, Saint Eustatius and Saba",40,7622,0,31,0.4067173970086591
2022-03-13,BQ,"Bonaire, Saint Eustatius and Saba",11,7633,0,31,0.40613127210795236
2022-03-20,BQ,"Bonaire, Saint Eustatius and Saba",20,7653,0,31,0.4050699072259245
2022-03-27,BQ,"Bonaire, Saint Eustatius and Saba",386,8039,0,31,0.38562010200273666
2022-04-03,BQ,"Bonaire, Saint Eustatius and Saba",150,8189,0,31,0.3785566003174991
2022-04-10,BQ,"Bonaire, Saint Eustatius and Saba",694,8883,2,33,0.37149611617696726
2022-04-17,BQ,"Bonaire, Saint Eustatius and Saba",161,9044,0,33,0.3648827952233525
2022-04-24,BQ,"Bonaire, Saint Eustatius and Saba",547,9591,1,34,0.35449900948806173
2022-05-01,BQ,"Bonaire, Saint Eustatius and Saba",154,9745,0,34,0.34889687018984095
2022-05-08,BQ,"Bonaire, Saint Eustatius and Saba",89,9834,0,34,0.3457392719137686
2022-05-15,BQ,"Bonaire, Saint Eustatius and Saba",109,9943,1,35,0.352006436689128
2022-05-22,BQ,"Bonaire, Saint Eustatius and Saba",75,10018,0,35,0.34937113196246755
2022-05-29,BQ,"Bonaire, Saint Eustatius and Saba",58,10076,0,35,0.3473600635172688
2022-06-05,BQ,"Bonaire, Saint Eustatius and Saba",47,10123,0,35,0.345747308110244
2022-06-12,BQ,"Bonaire, Saint Eustatius and Saba",71,10194,1,36,0.35314891112419067
2022-06-19,BQ,"Bonaire, Saint Eustatius and Saba",55,10249,0,36,0.3512537808566689
2022-06-26,BQ,"Bonaire, Saint Eustatius and Saba",71,10320,1,37,0.3585271317829457
2022-07-03,BQ,"Bonaire, Saint Eustatius and Saba",85,10405,0,37,0.35559827006246997
2022-07-10,BQ,"Bonaire, Saint Eustatius and Saba",27,10432,0,37,0.3546779141104294
2022-07-17,BQ,"Bonaire, Saint Eustatius and Saba",123,10555,0,37,0.3505447655139744
2022-07-24,BQ,"Bonaire, Saint Eustatius and Saba",183,10738,0,37,0.3445706835537344
2022-07-31,BQ,"Bonaire, Saint Eustatius and Saba",96,10834,0,37,0.3415174450803028
2022-08-07,BQ,"Bonaire, Saint Eustatius and Saba",63,10897,0,37,0.3395429934844452
2022-08-14,BQ,"Bonaire, Saint Eustatius and Saba",102,10999,0,37,0.3363942176561505
2022-08-21,BQ,"Bonaire, Saint Eustatius and Saba",92,11091,0,37,0.33360382291948426
2022-08-28,BQ,"Bonaire, Saint Eustatius and Saba",82,11173,1,38,0.34010561174259374
2022-09-04,BQ,"Bonaire, Saint Eustatius and Saba",57,11230,0,38,0.3383793410507569
2022-09-11,BQ,"Bonaire, Saint Eustatius and Saba",49,11279,0,38,0.3369093004698998
2022-09-18,BQ,"Bonaire, Saint Eustatius and Saba",27,11306,0,38,0.33610472315584644
2022-09-25,BQ,"Bonaire, Saint Eustatius and Saba",17,11323,0,38,0.3356001059789808
2022-10-02,BQ,"Bonaire, Saint Eustatius and Saba",22,11345,0,38,0.33494931687968266
2022-10-09,BQ,"Bonaire, Saint Eustatius and Saba",21,11366,0,38,0.33433045926447297
2022-10-16,BQ,"Bonaire, Saint Eustatius and Saba",29,11395,0,38,0.3334795963141729
2022-10-23,BQ,"Bonaire, Saint Eustatius and Saba",32,11427,0,38,0.33254572503719265
2022-10-30,BQ,"Bonaire, Saint Eustatius and Saba",23,11450,0,38,0.3318777292576419
2022-11-06,BQ,"Bonaire, Saint Eustatius and Saba",17,11467,0,38,0.33138571553152524
2022-11-13,BQ,"Bonaire, Saint Eustatius and Saba",23,11490,0,38,0.3307223672758921
2022-11-20,BQ,"Bonaire, Saint Eustatius and Saba",26,11516,0,38,0.32997568600208405
2022-11-27,BQ,"Bonaire, Saint Eustatius and Saba",28,11544,0,38,0.32917532917532916
2022-12-04,BQ,"Bonaire, Saint Eustatius and Saba",11,11555,0,38,0.32886196451752486
2022-12-11,BQ,"Bonaire, Saint Eustatius and Saba",41,11596,0,38,0.3276992066229734
2022-12-18,BQ,"Bonaire, Saint Eustatius and Saba",65,11661,0,38,0.3258725666752422
2022-12-25,BQ,"Bonaire, Saint Eustatius and Saba",55,11716,1,39,0.3328781153977467
2023-01-01,BQ,"Bonaire, Saint Eustatius and Saba",0,11716,1,40,0.3414134516899966
2023-01-08,BQ,"Bonaire, Saint Eustatius and Saba",48,11764,1,41,0.34852091125467527
2023-01-15,BQ,"Bonaire, Saint Eustatius and Saba",12,11776,0,41,0.3481657608695652
2023-01-22,BQ,"Bonaire, Saint Eustatius and Saba",3,11779,0,41,0.34807708634009676
2023-01-29,BQ,"Bonaire, Saint Eustatius and Saba",4,11783,0,41,0.3479589238733769
2023-02-05,BQ,"Bonaire, Saint Eustatius and Saba",11,11794,0,41,0.3476343903679837
2023-02-12,BQ,"Bonaire, Saint Eustatius and Saba",3,11797,0,41,0.3475459862676952
2023-02-19,BQ,"Bonaire, Saint Eustatius and Saba",2,11799,0,41,0.34748707517586236
2023-02-26,BQ,"Bonaire, Saint Eustatius and Saba",5,11804,0,41,0.3473398847848187
2023-03-05,BQ,"Bonaire, Saint Eustatius and Saba",7,11811,0,41,0.3471340276013885
2023-03-12,BQ,"Bonaire, Saint Eustatius and Saba",0,11811,0,41,0.3471340276013885
2023-03-19,BQ,"Bonaire, Saint Eustatius and Saba",1,11812,0,41,0.3471046393498137
2023-03-26,BQ,"Bonaire, Saint Eustatius and Saba",35,11847,0,41,0.3460791761627416
2023-04-02,BQ,"Bonaire, Saint Eustatius and Saba",38,11885,0,41,0.34497265460664706
2023-04-09,BQ,"Bonaire, Saint Eustatius and Saba",0,11885,0,41,0.34497265460664706
2023-04-16,BQ,"Bonaire, Saint Eustatius and Saba",0,11885,0,41,0.34497265460664706
2023-04-23,BQ,"Bonaire, Saint Eustatius and Saba",0,11885,0,41,0.34497265460664706
2023-04-30,BQ,"Bonaire, Saint Eustatius and Saba",0,11885,0,41,0.34497265460664706
2023-05-07,BQ,"Bonaire, Saint Eustatius and Saba",24,11909,0,41,0.3442774372323453
2023-05-14,BQ,"Bonaire, Saint Eustatius and Saba",0,11909,0,41,0.3442774372323453
2023-05-21,BQ,"Bonaire, Saint Eustatius and Saba",0,11909,0,41,0.3442774372323453
2023-05-28,BQ,"Bonaire, Saint Eustatius and Saba",0,11909,0,41,0.3442774372323453
2023-06-04,BQ,"Bonaire, Saint Eustatius and Saba",12,11921,0,41,0.34393087828202334
2023-06-11,BQ,"Bonaire, Saint Eustatius and Saba",0,11921,0,41,0.34393087828202334
2023-06-18,BQ,"Bonaire, Saint Eustatius and Saba",0,11921,0,41,0.34393087828202334
2023-06-25,BQ,"Bonaire, Saint Eustatius and Saba",0,11921,0,41,0.34393087828202334
2023-07-02,BQ,"Bonaire, Saint Eustatius and Saba",0,11921,0,41,0.34393087828202334
2023-07-09,BQ,"Bonaire, Saint Eustatius and Saba",1,11922,0,41,0.3439020298607616
2023-07-16,BQ,"Bonaire, Saint Eustatius and Saba",0,11922,0,41,0.3439020298607616
2023-07-23,BQ,"Bonaire, Saint Eustatius and Saba",0,11922,0,41,0.3439020298607616
2023-07-30,BQ,"Bonaire, Saint Eustatius and Saba",0,11922,0,41,0.3439020298607616
2023-08-06,BQ,"Bonaire, Saint Eustatius and Saba",0,11922,0,41,0.3439020298607616
2023-08-13,BQ,"Bonaire, Saint Eustatius and Saba",0,11922,0,41,0.3439020298607616
2023-08-20,BQ,"Bonaire, Saint Eustatius and Saba",0,11922,0,41,0.3439020298607616
2023-08-27,BQ,"Bonaire, Saint Eustatius and Saba",0,11922,0,41,0.3439020298607616
2023-09-03,BQ,"Bonaire, Saint Eustatius and Saba",0,11922,0,41,0.3439020298607616
2023-09-10,BQ,"Bonaire, Saint Eustatius and Saba",0,11922,0,41,0.3439020298607616
2023-09-17,BQ,"Bonaire, Saint Eustatius and Saba",0,11922,0,41,0.3439020298607616
2023-09-24,BQ,"Bonaire, Saint Eustatius and Saba",0,11922,0,41,0.3439020298607616
2023-10-01,BQ,"Bonaire, Saint Eustatius and Saba",0,11922,0,41,0.3439020298607616
2023-10-08,BQ,"Bonaire, Saint Eustatius and Saba",0,11922,0,41,0.3439020298607616
2023-10-15,BQ,"Bonaire, Saint Eustatius and Saba",0,11922,0,41,0.3439020298607616
2023-10-22,BQ,"Bonaire, Saint Eustatius and Saba",0,11922,0,41,0.3439020298607616
2023-10-29,BQ,"Bonaire, Saint Eustatius and Saba",0,11922,0,41,0.3439020298607616
2023-11-05,BQ,"Bonaire, Saint Eustatius and Saba",0,11922,0,41,0.3439020298607616
2023-11-12,BQ,"Bonaire, Saint Eustatius and Saba",0,11922,0,41,0.3439020298607616
2023-11-19,BQ,"Bonaire, Saint Eustatius and Saba",0,11922,0,41,0.3439020298607616
2023-11-26,BQ,"Bonaire, Saint Eustatius and Saba",0,11922,0,41,0.3439020298607616
2023-12-03,BQ,"Bonaire, Saint Eustatius and Saba",0,11922,0,41,0.3439020298607616
2023-12-10,BQ,"Bonaire, Saint Eustatius and Saba",0,11922,0,41,0.3439020298607616
2023-12-17,BQ,"Bonaire, Saint Eustatius and Saba",0,11922,0,41,0.3439020298607616
2023-12-24,BQ,"Bonaire, Saint Eustatius and Saba",0,11922,0,41,0.3439020298607616
2023-12-31,BQ,"Bonaire, Saint Eustatius and Saba",0,11922,0,41,0.3439020298607616
2024-01-07,BQ,"Bonaire, Saint Eustatius and Saba",0,11922,0,41,0.3439020298607616
2024-01-14,BQ,"Bonaire, Saint Eustatius and Saba",0,11922,0,41,0.3439020298607616
2020-03-22,BA,Bosnia and Herzegovina,112,125,1,1,0.8
2020-06-28,BW,Botswana,36,125,0,1,0.8
2020-07-05,BW,Botswana,150,275,0,1,0.36363636363636365
2020-07-12,BW,Botswana,39,314,0,1,0.3184713375796179
2020-07-19,BW,Botswana,208,522,0,1,0.19157088122605362
2020-07-26,BW,Botswana,164,686,0,1,0.1457725947521866
2020-08-02,BW,Botswana,208,894,1,2,0.22371364653243847
2020-08-09,BW,Botswana,172,1066,0,2,0.18761726078799248
2020-08-16,BW,Botswana,148,1214,1,3,0.2471169686985173
2020-08-23,BW,Botswana,94,1308,0,3,0.22935779816513763
2020-08-30,BW,Botswana,325,1633,3,6,0.3674219228413962
2020-09-06,BW,Botswana,369,2002,2,8,0.3996003996003996
2020-09-13,BW,Botswana,461,2463,3,11,0.4466098254161592
2020-09-20,BW,Botswana,104,2567,2,13,0.506427736657577
2020-09-27,BW,Botswana,354,2921,0,13,0.4450530640191715
2020-10-04,BW,Botswana,251,3172,3,16,0.5044136191677175
2020-10-11,BW,Botswana,47,3219,2,18,0.5591798695246971
2020-10-18,BW,Botswana,2023,5242,3,21,0.4006104540251812
2020-10-25,BW,Botswana,681,5923,4,25,0.4220834036805673
2020-11-01,BW,Botswana,719,6642,0,25,0.37639265281541706
2020-11-08,BW,Botswana,1193,7835,3,28,0.3573707721761328
2020-11-15,BW,Botswana,390,8225,0,28,0.3404255319148936
2020-11-22,BW,Botswana,1369,9594,4,32,0.3335417969564311
2020-11-29,BW,Botswana,819,10413,1,33,0.31691155286660905
2020-12-06,BW,Botswana,1132,11545,3,36,0.3118233001299264
2020-12-13,BW,Botswana,956,12501,2,38,0.3039756819454444
2020-12-20,BW,Botswana,712,13213,0,38,0.2875955498372815
2020-12-27,BW,Botswana,677,13890,1,39,0.28077753779697623
2021-01-03,BW,Botswana,1332,15222,5,44,0.28905531467612666
2021-01-10,BW,Botswana,829,16051,4,48,0.2990467883620958
2021-01-17,BW,Botswana,1899,17950,23,71,0.3955431754874652
2021-01-24,BW,Botswana,2046,19996,43,114,0.5701140228045609
2021-01-31,BW,Botswana,1627,21623,25,139,0.6428340193312676
2021-02-07,BW,Botswana,2198,23821,30,169,0.70945804122413
2021-02-14,BW,Botswana,1381,25202,46,215,0.8531068962780731
2022-02-27,BW,Botswana,41830,304482,51,2665,0.8752569938452849
2022-03-06,BW,Botswana,431,304913,10,2675,0.8772994263937582
2022-03-13,BW,Botswana,333,305246,4,2679,0.8776527784147867
2022-03-20,BW,Botswana,269,305515,5,2684,0.8785166031127768
2022-03-27,BW,Botswana,162,305677,2,2686,0.8787053000389299
2022-04-03,BW,Botswana,93,305770,1,2687,0.8787650848677111
2022-04-10,BW,Botswana,74,305844,0,2687,0.8785524646551838
2022-04-17,BW,Botswana,140,305984,1,2688,0.8784773060029283
2022-04-24,BW,Botswana,90,306074,1,2689,0.8785457111678875
2022-05-01,BW,Botswana,126,306200,1,2690,0.8785107772697583
2022-05-08,BW,Botswana,0,306200,0,2690,0.8785107772697583
2022-05-15,BW,Botswana,414,306614,2,2692,0.8779768699407072
2022-05-22,BW,Botswana,0,306614,0,2692,0.8779768699407072
2022-05-29,BW,Botswana,0,306614,0,2692,0.8779768699407072
2022-06-05,BW,Botswana,3795,310409,9,2701,0.8701422961318777
2022-06-12,BW,Botswana,3084,313493,4,2705,0.8628581818413809
2022-06-19,BW,Botswana,6634,320127,33,2738,0.8552855585439528
2022-06-26,BW,Botswana,2642,322769,12,2750,0.8520025157310646
2022-07-03,BW,Botswana,558,323327,2,2752,0.8511506926424331
2022-07-10,BW,Botswana,1514,324841,8,2760,0.8496464424133652
2022-07-17,BW,Botswana,0,324841,0,2760,0.8496464424133652
2022-07-24,BW,Botswana,629,325470,10,2770,0.8510769041693551
2022-07-31,BW,Botswana,254,325724,2,2772,0.8510272500644718
2022-08-07,BW,Botswana,100,325824,2,2774,0.8513798860734629
2022-08-14,BW,Botswana,26,325850,3,2777,0.8522326223722572
2022-08-21,BW,Botswana,14,325864,1,2778,0.8525028846389905
2022-08-28,BW,Botswana,47,325911,0,2778,0.8523799442179001
2022-09-04,BW,Botswana,354,326265,1,2779,0.8517616048304293
2022-09-11,BW,Botswana,21,326286,1,2780,0.8520132644367212
2022-09-18,BW,Botswana,17,326303,1,2781,0.8522753391786162
2022-09-25,BW,Botswana,21,326324,0,2781,0.8522204925166399
2022-10-02,BW,Botswana,8,326332,1,2782,0.8525060367968817
2022-10-09,BW,Botswana,17,326349,0,2782,0.8524616285020026
2022-10-16,BW,Botswana,4,326353,0,2782,0.8524511801638104
2022-10-23,BW,Botswana,0,326353,0,2782,0.8524511801638104
2022-10-30,BW,Botswana,0,326353,0,2782,0.8524511801638104
2022-11-06,BW,Botswana,0,326353,0,2782,0.8524511801638104
2022-11-13,BW,Botswana,126,326479,0,2782,0.8521221885634298
2022-11-20,BW,Botswana,133,326612,0,2782,0.8517751950326381
2022-11-27,BW,Botswana,155,326767,3,2785,0.8522892458540795
2022-12-04,BW,Botswana,292,327059,0,2785,0.851528317520692
2022-12-11,BW,Botswana,412,327471,1,2786,0.8507623575828089
2022-12-18,BW,Botswana,349,327820,0,2786,0.849856628637667
2022-12-25,BW,Botswana,211,328031,0,2786,0.8493099737524807
2023-01-01,BW,Botswana,218,328249,1,2787,0.8490505683185631
2023-01-08,BW,Botswana,300,328549,1,2788,0.848579663916189
2023-01-15,BW,Botswana,349,328898,2,2790,0.8482873109596288
2023-01-22,BW,Botswana,316,329214,2,2792,0.848080579805233
2023-01-29,BW,Botswana,240,329454,1,2793,0.8477663042488481
2023-02-05,BW,Botswana,141,329595,1,2794,0.8477070343906916
2023-02-12,BW,Botswana,80,329675,1,2795,0.8478046561007053
2023-02-19,BW,Botswana,52,329727,0,2795,0.8476709520300126
2023-02-26,BW,Botswana,31,329758,0,2795,0.8475912638965544
2023-03-05,BW,Botswana,11,329769,0,2795,0.8475629910634414
2023-03-12,BW,Botswana,16,329785,0,2795,0.847521870309444
2023-03-19,BW,Botswana,27,329812,0,2795,0.8474524880841207
2023-03-26,BW,Botswana,18,329830,0,2795,0.8474062395779645
2023-04-02,BW,Botswana,7,329837,0,2795,0.847388255411006
2023-04-09,BW,Botswana,4,329841,1,2796,0.8476811554658154
2023-04-16,BW,Botswana,6,329847,0,2796,0.8476657359321139
2023-04-23,BW,Botswana,5,329852,0,2796,0.8476528867492087
2023-04-30,BW,Botswana,4,329856,0,2796,0.8476426076833528
2023-05-07,BW,Botswana,6,329862,1,2797,0.8479303466298028
2023-05-14,BW,Botswana,0,329862,0,2797,0.8479303466298028
2023-05-21,BW,Botswana,43,329905,0,2797,0.8478198269198709
2023-05-28,BW,Botswana,36,329941,0,2797,0.8477273209452599
2023-06-04,BW,Botswana,21,329962,0,2797,0.8476733684484881
2023-06-11,BW,Botswana,23,329985,0,2797,0.8476142854978257
2023-06-18,BW,Botswana,31,330016,0,2797,0.8475346649859401
2023-06-25,BW,Botswana,61,330077,0,2797,0.8473780360340163
2023-07-02,BW,Botswana,36,330113,0,2797,0.8472856264370079
2023-07-09,BW,Botswana,35,330148,0,2797,0.8471958030943697
2023-07-16,BW,Botswana,7,330155,1,2798,0.8474807287486181
2023-07-23,BW,Botswana,21,330176,1,2799,0.8477296956774568
2023-07-30,BW,Botswana,22,330198,1,2800,0.8479760628471402
2023-08-06,BW,Botswana,17,330215,0,2800,0.8479324076737883
2023-08-13,BW,Botswana,15,330230,0,2800,0.847893892135784
2023-08-20,BW,Botswana,10,330240,0,2800,0.8478682170542635
2023-08-27,BW,Botswana,11,330251,0,2800,0.8478399762604807
2023-09-03,BW,Botswana,5,330256,0,2800,0.8478271401579381
2023-09-10,BW,Botswana,0,330256,0,2800,0.8478271401579381
2023-09-17,BW,Botswana,16,330272,0,2800,0.8477860672415464
2023-09-24,BW,Botswana,3,330275,0,2800,0.8477783665127546
2023-10-01,BW,Botswana,9,330284,0,2800,0.8477552651657361
2023-10-08,BW,Botswana,16,330300,0,2800,0.8477141992128367
2023-10-15,BW,Botswana,21,330321,0,2800,0.8476603061870122
2023-10-22,BW,Botswana,24,330345,0,2800,0.8475987225476396
2023-10-29,BW,Botswana,10,330355,0,2800,0.8475730653388022
2023-11-05,BW,Botswana,14,330369,0,2800,0.8475371478558823
2023-11-12,BW,Botswana,19,330388,0,2800,0.8474884075692822
2023-11-19,BW,Botswana,9,330397,0,2800,0.847465322021689
2023-11-26,BW,Botswana,7,330404,0,2800,0.8474473674652849
2023-12-03,BW,Botswana,5,330409,0,2800,0.8474345432479139
2023-12-10,BW,Botswana,4,330413,0,2800,0.8474242841534686
2023-12-17,BW,Botswana,4,330417,0,2800,0.8474140253074146
2023-12-24,BW,Botswana,0,330417,0,2800,0.8474140253074146
2023-12-31,BW,Botswana,25,330442,0,2800,0.8473499131466339
2024-01-07,BW,Botswana,0,330442,0,2800,0.8473499131466339
2024-01-14,BW,Botswana,0,330442,0,2800,0.8473499131466339
2021-01-10,VG,British Virgin Islands,21,114,0,1,0.8771929824561403
2021-01-17,VG,British Virgin Islands,7,121,0,1,0.8264462809917356
2021-01-24,VG,British Virgin Islands,16,137,0,1,0.7299270072992701
2021-01-31,VG,British Virgin Islands,4,141,0,1,0.7092198581560284
2021-02-07,VG,British Virgin Islands,0,141,0,1,0.7092198581560284
2021-02-14,VG,British Virgin Islands,10,151,0,1,0.6622516556291391
2021-02-21,VG,British Virgin Islands,2,153,0,1,0.6535947712418301
2021-02-28,VG,British Virgin Islands,0,153,0,1,0.6535947712418301
2021-03-07,VG,British Virgin Islands,1,154,0,1,0.6493506493506493
2021-03-14,VG,British Virgin Islands,0,154,0,1,0.6493506493506493
2021-03-21,VG,British Virgin Islands,0,154,0,1,0.6493506493506493
2021-03-28,VG,British Virgin Islands,0,154,0,1,0.6493506493506493
2021-04-04,VG,British Virgin Islands,0,154,0,1,0.6493506493506493
2021-04-11,VG,British Virgin Islands,24,178,0,1,0.5617977528089888
2021-04-18,VG,British Virgin Islands,9,187,0,1,0.53475935828877
2021-04-25,VG,British Virgin Islands,7,194,0,1,0.5154639175257731
2021-05-02,VG,British Virgin Islands,0,194,0,1,0.5154639175257731
2021-05-09,VG,British Virgin Islands,25,219,0,1,0.45662100456621
2021-05-16,VG,British Virgin Islands,29,248,0,1,0.4032258064516129
2021-05-23,VG,British Virgin Islands,0,248,0,1,0.4032258064516129
2021-05-30,VG,British Virgin Islands,41,289,0,1,0.34602076124567477
2021-06-06,VG,British Virgin Islands,0,289,0,1,0.34602076124567477
2021-06-13,VG,British Virgin Islands,6,295,0,1,0.3389830508474576
2021-06-20,VG,British Virgin Islands,0,295,0,1,0.3389830508474576
2021-06-27,VG,British Virgin Islands,3,298,0,1,0.33557046979865773
2021-07-04,VG,British Virgin Islands,158,456,0,1,0.21929824561403508
2021-07-11,VG,British Virgin Islands,691,1147,2,3,0.26155187445510025
2021-07-18,VG,British Virgin Islands,877,2024,9,12,0.592885375494071
2022-01-09,VG,British Virgin Islands,715,4207,1,40,0.9507962918944617
2022-01-16,VG,British Virgin Islands,1048,5255,2,42,0.7992388201712655
2022-01-23,VG,British Virgin Islands,394,5649,5,47,0.8320056647194194
2022-01-30,VG,British Virgin Islands,226,5875,2,49,0.8340425531914895
2022-02-06,VG,British Virgin Islands,53,5928,2,51,0.8603238866396761
2022-04-24,VG,British Virgin Islands,134,6296,0,62,0.9847522236340533
2022-05-01,VG,British Virgin Islands,59,6355,0,62,0.975609756097561
2022-05-08,VG,British Virgin Islands,0,6355,0,62,0.975609756097561
2022-05-15,VG,British Virgin Islands,218,6573,0,62,0.9432527004411988
2022-05-22,VG,British Virgin Islands,117,6690,0,62,0.9267563527653214
2022-05-29,VG,British Virgin Islands,0,6690,0,62,0.9267563527653214
2022-06-05,VG,British Virgin Islands,75,6765,0,62,0.9164818920916482
2022-06-12,VG,British Virgin Islands,137,6902,1,63,0.9127789046653144
2022-06-19,VG,British Virgin Islands,0,6902,0,63,0.9127789046653144
2022-06-26,VG,British Virgin Islands,39,6941,0,63,0.9076501944964702
2022-07-03,VG,British Virgin Islands,0,6941,0,63,0.9076501944964702
2022-07-10,VG,British Virgin Islands,0,6941,0,63,0.9076501944964702
2022-07-17,VG,British Virgin Islands,190,7131,0,63,0.8834665544804375
2022-07-24,VG,British Virgin Islands,0,7131,0,63,0.8834665544804375
2022-07-31,VG,British Virgin Islands,0,7131,0,63,0.8834665544804375
2022-08-07,VG,British Virgin Islands,0,7131,0,63,0.8834665544804375
2022-08-14,VG,British Virgin Islands,0,7131,0,63,0.8834665544804375
2022-08-21,VG,British Virgin Islands,0,7131,0,63,0.8834665544804375
2022-08-28,VG,British Virgin Islands,0,7131,0,63,0.8834665544804375
2022-09-04,VG,British Virgin Islands,160,7291,1,64,0.8777945412151967
2022-09-11,VG,British Virgin Islands,14,7305,0,64,0.8761122518822724
2022-09-18,VG,British Virgin Islands,0,7305,0,64,0.8761122518822724
2022-09-25,VG,British Virgin Islands,0,7305,0,64,0.8761122518822724
2022-10-02,VG,British Virgin Islands,0,7305,0,64,0.8761122518822724
2022-10-09,VG,British Virgin Islands,0,7305,0,64,0.8761122518822724
2022-10-16,VG,British Virgin Islands,0,7305,0,64,0.8761122518822724
2022-10-23,VG,British Virgin Islands,0,7305,0,64,0.8761122518822724
2022-10-30,VG,British Virgin Islands,0,7305,0,64,0.8761122518822724
2022-11-06,VG,British Virgin Islands,0,7305,0,64,0.8761122518822724
2022-11-13,VG,British Virgin Islands,0,7305,0,64,0.8761122518822724
2022-11-20,VG,British Virgin Islands,0,7305,0,64,0.8761122518822724
2022-11-27,VG,British Virgin Islands,0,7305,0,64,0.8761122518822724
2022-12-04,VG,British Virgin Islands,0,7305,0,64,0.8761122518822724
2022-12-11,VG,British Virgin Islands,0,7305,0,64,0.8761122518822724
2022-12-18,VG,British Virgin Islands,0,7305,0,64,0.8761122518822724
2022-12-25,VG,British Virgin Islands,0,7305,0,64,0.8761122518822724
2023-01-01,VG,British Virgin Islands,0,7305,0,64,0.8761122518822724
2023-01-08,VG,British Virgin Islands,0,7305,0,64,0.8761122518822724
2023-01-15,VG,British Virgin Islands,0,7305,0,64,0.8761122518822724
2023-01-22,VG,British Virgin Islands,0,7305,0,64,0.8761122518822724
2023-01-29,VG,British Virgin Islands,0,7305,0,64,0.8761122518822724
2023-02-05,VG,British Virgin Islands,0,7305,0,64,0.8761122518822724
2023-02-12,VG,British Virgin Islands,0,7305,0,64,0.8761122518822724
2023-02-19,VG,British Virgin Islands,0,7305,0,64,0.8761122518822724
2023-02-26,VG,British Virgin Islands,0,7305,0,64,0.8761122518822724
2023-03-05,VG,British Virgin Islands,0,7305,0,64,0.8761122518822724
2023-03-12,VG,British Virgin Islands,0,7305,0,64,0.8761122518822724
2023-03-19,VG,British Virgin Islands,0,7305,0,64,0.8761122518822724
2023-03-26,VG,British Virgin Islands,0,7305,0,64,0.8761122518822724
2023-04-02,VG,British Virgin Islands,0,7305,0,64,0.8761122518822724
2023-04-09,VG,British Virgin Islands,0,7305,0,64,0.8761122518822724
2023-04-16,VG,British Virgin Islands,0,7305,0,64,0.8761122518822724
2023-04-23,VG,British Virgin Islands,0,7305,0,64,0.8761122518822724
2023-04-30,VG,British Virgin Islands,0,7305,0,64,0.8761122518822724
2023-05-07,VG,British Virgin Islands,0,7305,0,64,0.8761122518822724
2023-05-14,VG,British Virgin Islands,0,7305,0,64,0.8761122518822724
2023-05-21,VG,British Virgin Islands,1,7306,0,64,0.8759923350670681
2023-05-28,VG,British Virgin Islands,0,7306,0,64,0.8759923350670681
2023-06-04,VG,British Virgin Islands,0,7306,0,64,0.8759923350670681
2023-06-11,VG,British Virgin Islands,13,7319,0,64,0.874436398415084
2023-06-18,VG,British Virgin Islands,4,7323,0,64,0.8739587600710091
2023-06-25,VG,British Virgin Islands,7,7330,0,64,0.8731241473396999
2023-07-02,VG,British Virgin Islands,2,7332,0,64,0.872885979268958
2023-07-09,VG,British Virgin Islands,0,7332,0,64,0.872885979268958
2023-07-16,VG,British Virgin Islands,8,7340,0,64,0.8719346049046321
2023-07-23,VG,British Virgin Islands,5,7345,0,64,0.8713410483321988
2023-07-30,VG,British Virgin Islands,2,7347,0,64,0.8711038519123452
2023-08-06,VG,British Virgin Islands,3,7350,0,64,0.8707482993197279
2023-08-13,VG,British Virgin Islands,0,7350,0,64,0.8707482993197279
2023-08-20,VG,British Virgin Islands,12,7362,0,64,0.8693289866883999
2023-08-27,VG,British Virgin Islands,1,7363,0,64,0.8692109194621758
2023-09-03,VG,British Virgin Islands,9,7372,0,64,0.8681497558328812
2023-09-10,VG,British Virgin Islands,1,7373,0,64,0.86803200868032
2023-09-17,VG,British Virgin Islands,8,7381,0,64,0.8670911800569029
2023-09-24,VG,British Virgin Islands,6,7387,0,64,0.8663868958981996
2023-10-01,VG,British Virgin Islands,3,7390,0,64,0.8660351826792965
2023-10-08,VG,British Virgin Islands,1,7391,0,64,0.8659180083885807
2023-10-15,VG,British Virgin Islands,1,7392,0,64,0.8658008658008658
2023-10-22,VG,British Virgin Islands,0,7392,0,64,0.8658008658008658
2023-10-29,VG,British Virgin Islands,0,7392,0,64,0.8658008658008658
2023-11-05,VG,British Virgin Islands,0,7392,0,64,0.8658008658008658
2023-11-12,VG,British Virgin Islands,0,7392,0,64,0.8658008658008658
2023-11-19,VG,British Virgin Islands,0,7392,0,64,0.8658008658008658
2023-11-26,VG,British Virgin Islands,0,7392,0,64,0.8658008658008658
2023-12-03,VG,British Virgin Islands,0,7392,0,64,0.8658008658008658
2023-12-10,VG,British Virgin Islands,0,7392,0,64,0.8658008658008658
2023-12-17,VG,British Virgin Islands,0,7392,0,64,0.8658008658008658
2023-12-24,VG,British Virgin Islands,0,7392,0,64,0.8658008658008658
2023-12-31,VG,British Virgin Islands,0,7392,0,64,0.8658008658008658
2024-01-07,VG,British Virgin Islands,0,7392,0,64,0.8658008658008658
2024-01-14,VG,British Virgin Islands,0,7392,0,64,0.8658008658008658
2020-03-29,BN,Brunei Darussalam,37,120,1,1,0.8333333333333334
2020-04-05,BN,Brunei Darussalam,15,135,0,1,0.7407407407407408
2020-04-12,BN,Brunei Darussalam,1,136,0,1,0.7352941176470588
2020-04-19,BN,Brunei Darussalam,1,137,0,1,0.7299270072992701
2020-04-26,BN,Brunei Darussalam,1,138,0,1,0.7246376811594203
2020-05-03,BN,Brunei Darussalam,0,138,0,1,0.7246376811594203
2020-05-10,BN,Brunei Darussalam,3,141,0,1,0.7092198581560284
2020-05-17,BN,Brunei Darussalam,0,141,0,1,0.7092198581560284
2020-05-24,BN,Brunei Darussalam,0,141,0,1,0.7092198581560284
2021-07-25,BN,Brunei Darussalam,30,321,0,3,0.9345794392523363
2021-08-01,BN,Brunei Darussalam,17,338,0,3,0.8875739644970414
2021-08-08,BN,Brunei Darussalam,26,364,0,3,0.8241758241758242
2021-08-15,BN,Brunei Darussalam,359,723,1,4,0.5532503457814661
2021-08-22,BN,Brunei Darussalam,1046,1769,7,11,0.6218202374222724
2021-08-29,BN,Brunei Darussalam,796,2565,5,16,0.6237816764132553
2021-09-05,BN,Brunei Darussalam,764,3329,4,20,0.6007810153199159
2021-09-12,BN,Brunei Darussalam,834,4163,5,25,0.6005284650492433
2021-09-19,BN,Brunei Darussalam,884,5047,7,32,0.6340400237765008
2021-09-26,BN,Brunei Darussalam,1493,6540,6,38,0.581039755351682
2021-10-03,BN,Brunei Darussalam,1176,7716,6,44,0.5702436495593572
2021-10-10,BN,Brunei Darussalam,1264,8980,5,49,0.5456570155902005
2021-10-17,BN,Brunei Darussalam,1880,10860,7,56,0.5156537753222836
2021-10-24,BN,Brunei Darussalam,1253,12113,1,57,0.47056881036902504
2021-10-31,BN,Brunei Darussalam,1017,13130,1,58,0.44173648134044174
2021-11-07,BN,Brunei Darussalam,652,13782,3,61,0.44260629806994634
2021-11-14,BN,Brunei Darussalam,433,14215,0,61,0.4291241646148435
2021-11-21,BN,Brunei Darussalam,376,14591,0,61,0.4180659310533891
2021-11-28,BN,Brunei Darussalam,445,15036,0,61,0.4056930034583666
2021-12-05,BN,Brunei Darussalam,150,15186,0,61,0.40168576320295013
2021-12-12,BN,Brunei Darussalam,162,15348,0,61,0.39744592129267664
2021-12-19,BN,Brunei Darussalam,54,15402,0,61,0.39605246071938704
2021-12-26,BN,Brunei Darussalam,45,15447,0,61,0.39489868582896354
2022-01-02,BN,Brunei Darussalam,52,15499,1,62,0.4000258081166527
2022-01-09,BN,Brunei Darussalam,135,15634,0,62,0.3965715747729308
2022-01-16,BN,Brunei Darussalam,247,15881,0,62,0.39040362697563125
2022-01-23,BN,Brunei Darussalam,251,16132,0,62,0.38432928341185224
2022-01-30,BN,Brunei Darussalam,281,16413,0,62,0.3777493450313776
2022-02-06,BN,Brunei Darussalam,1371,17784,0,62,0.3486279802069276
2022-02-13,BN,Brunei Darussalam,4731,22515,2,64,0.2842549411503442
2022-02-20,BN,Brunei Darussalam,12464,34979,3,67,0.19154349752708769
2022-02-27,BN,Brunei Darussalam,24468,59447,6,73,0.12279845913166351
2022-03-06,BN,Brunei Darussalam,29402,88849,11,84,0.09454242591362874
2022-03-13,BN,Brunei Darussalam,23244,112093,8,92,0.08207470582462777
2022-03-20,BN,Brunei Darussalam,12623,124716,2,94,0.07537124346515282
2022-03-27,BN,Brunei Darussalam,6687,131403,6,100,0.07610176327785514
2022-04-03,BN,Brunei Darussalam,4571,135974,0,100,0.07354347154603086
2022-04-10,BN,Brunei Darussalam,2556,138530,1,101,0.07290839529343825
2022-04-17,BN,Brunei Darussalam,1493,140023,0,101,0.07213100704884197
2022-04-24,BN,Brunei Darussalam,1096,141119,0,101,0.0715708019472927
2022-05-01,BN,Brunei Darussalam,792,141911,0,101,0.07117136797006574
2022-05-08,BN,Brunei Darussalam,947,142858,0,101,0.07069957580254518
2022-05-15,BN,Brunei Darussalam,1801,144659,0,101,0.06981936830753703
2022-05-22,BN,Brunei Darussalam,1827,146486,0,101,0.0689485684638805
2022-05-29,BN,Brunei Darussalam,1603,148089,0,101,0.06820222974022379
2022-06-05,BN,Brunei Darussalam,2313,150402,0,101,0.06715336232230953
2022-06-12,BN,Brunei Darussalam,2691,153093,0,101,0.06597297067795392
2022-06-19,BN,Brunei Darussalam,3930,157023,0,101,0.06432178725409653
2022-06-26,BN,Brunei Darussalam,0,157023,1,102,0.06495863663284997
2022-07-03,BN,Brunei Darussalam,6504,163527,5,107,0.06543261968971484
2022-07-10,BN,Brunei Darussalam,9610,173137,10,117,0.06757654343092463
2022-07-17,BN,Brunei Darussalam,11858,184995,4,121,0.06540717316684234
2022-07-24,BN,Brunei Darussalam,12420,197415,1,122,0.061798748828609786
2022-07-31,BN,Brunei Darussalam,8745,206160,0,122,0.05917733798991075
2022-08-07,BN,Brunei Darussalam,9123,215283,6,128,0.05945662221355147
2022-08-14,BN,Brunei Darussalam,2976,218259,0,128,0.058645920672228874
2022-08-21,BN,Brunei Darussalam,1986,220245,0,128,0.058117096869395445
2022-08-28,BN,Brunei Darussalam,1454,221699,1,129,0.05818700129454801
2022-09-04,BN,Brunei Darussalam,1360,223059,1,130,0.058280544609273774
2022-09-11,BN,Brunei Darussalam,1551,224610,1,131,0.05832331596990339
2022-09-18,BN,Brunei Darussalam,1627,226237,0,131,0.05790387955993051
2022-09-25,BN,Brunei Darussalam,1519,227756,0,131,0.057517694374681676
2022-10-02,BN,Brunei Darussalam,1909,229665,2,133,0.05791043476367753
2022-10-09,BN,Brunei Darussalam,2168,231833,1,134,0.057800226887457784
2022-10-16,BN,Brunei Darussalam,2749,234582,1,135,0.057549172570785484
2022-10-23,BN,Brunei Darussalam,3074,237656,1,136,0.05722556973103982
2022-10-30,BN,Brunei Darussalam,3388,241044,0,136,0.05642123429747266
2022-11-06,BN,Brunei Darussalam,3555,244599,1,137,0.05601004092412479
2022-11-13,BN,Brunei Darussalam,4262,248861,0,137,0.05505081149718116
2022-11-20,BN,Brunei Darussalam,4545,253406,6,143,0.05643118158212512
2022-11-27,BN,Brunei Darussalam,4515,257921,1,144,0.05583104904214856
2022-12-04,BN,Brunei Darussalam,3519,261440,1,145,0.05546205630354958
2022-12-11,BN,Brunei Darussalam,3050,264490,1,146,0.05520057469091459
2022-12-18,BN,Brunei Darussalam,2329,266819,1,147,0.05509352782223155
2022-12-25,BN,Brunei Darussalam,1796,268615,1,148,0.055097444297600655
2023-01-01,BN,Brunei Darussalam,1584,270199,0,148,0.05477444402088831
2023-01-08,BN,Brunei Darussalam,2447,272646,0,148,0.054282842953866914
2023-01-15,BN,Brunei Darussalam,0,272646,0,148,0.054282842953866914
2023-01-22,BN,Brunei Darussalam,1571,274217,0,148,0.053971854407276
2023-01-29,BN,Brunei Darussalam,1003,275220,0,148,0.05377516168883075
2023-02-05,BN,Brunei Darussalam,847,276067,0,148,0.05361017434173588
2023-02-12,BN,Brunei Darussalam,758,276825,1,149,0.0538246184412535
2023-02-19,BN,Brunei Darussalam,616,277441,1,150,0.054065549071694516
2023-02-26,BN,Brunei Darussalam,551,277992,0,150,0.05395838729172062
2023-03-05,BN,Brunei Darussalam,706,278698,0,150,0.05382169947398259
2023-03-12,BN,Brunei Darussalam,963,279661,0,150,0.05363636688705253
2023-03-19,BN,Brunei Darussalam,1129,280790,1,151,0.05377684390469747
2023-03-26,BN,Brunei Darussalam,1166,281956,2,153,0.05426378583892522
2023-04-02,BN,Brunei Darussalam,1389,283345,0,153,0.05399777656214156
2023-04-09,BN,Brunei Darussalam,1287,284632,0,153,0.05375361870766463
2023-04-16,BN,Brunei Darussalam,1108,285740,2,155,0.05424511793938546
2023-04-23,BN,Brunei Darussalam,1070,286810,0,155,0.05404274606882606
2023-04-30,BN,Brunei Darussalam,1241,288051,2,157,0.05450423709690298
2023-05-07,BN,Brunei Darussalam,4593,292644,3,160,0.05467393830046063
2023-05-14,BN,Brunei Darussalam,6861,299505,0,160,0.05342147877330929
2023-05-21,BN,Brunei Darussalam,4214,303719,1,161,0.05300952525195987
2023-05-28,BN,Brunei Darussalam,2614,306333,0,161,0.05255718450183297
2023-06-04,BN,Brunei Darussalam,1353,307686,0,161,0.052326072684490035
2023-06-11,BN,Brunei Darussalam,1091,308777,0,161,0.05214118927251706
2023-06-18,BN,Brunei Darussalam,338,309115,0,161,0.05208417579218091
2023-06-25,BN,Brunei Darussalam,275,309390,0,161,0.052037880991628684
2023-07-02,BN,Brunei Darussalam,171,309561,1,162,0.05233217362652272
2023-07-09,BN,Brunei Darussalam,252,309813,0,162,0.05228960695645438
2023-07-16,BN,Brunei Darussalam,117,309930,0,162,0.052269867389410515
2023-07-23,BN,Brunei Darussalam,89,310019,1,163,0.05257742267409417
2023-07-30,BN,Brunei Darussalam,87,310106,0,163,0.05256267211856591
2023-08-06,BN,Brunei Darussalam,119,310225,0,163,0.05254250946893384
2023-08-13,BN,Brunei Darussalam,154,310379,0,163,0.05251643957870861
2023-08-20,BN,Brunei Darussalam,0,310379,0,163,0.05251643957870861
2023-08-27,BN,Brunei Darussalam,173,310552,0,163,0.05248718411087354
2023-09-03,BN,Brunei Darussalam,78,310630,0,163,0.05247400444258443
2023-09-10,BN,Brunei Darussalam,146,310776,0,163,0.05244935258835946
2023-09-17,BN,Brunei Darussalam,244,311020,0,163,0.05240820526011189
2023-09-24,BN,Brunei Darussalam,216,311236,0,163,0.05237183359251501
2023-10-01,BN,Brunei Darussalam,213,311449,0,163,0.05233601649066139
2023-10-08,BN,Brunei Darussalam,165,311614,0,163,0.05230830450493239
2023-10-15,BN,Brunei Darussalam,291,311905,0,163,0.052259502091983136
2023-10-22,BN,Brunei Darussalam,289,312194,0,163,0.05221112513373095
2023-10-29,BN,Brunei Darussalam,330,312524,0,163,0.05215599441962857
2023-11-05,BN,Brunei Darussalam,368,312892,0,163,0.052094652467944216
2023-11-12,BN,Brunei Darussalam,488,313380,0,163,0.05201352989980216
2023-11-19,BN,Brunei Darussalam,539,313919,0,163,0.051924222490515065
2023-11-26,BN,Brunei Darussalam,691,314610,0,163,0.0518101776803026
2023-12-03,BN,Brunei Darussalam,1123,315733,1,164,0.0519426224056402
2023-12-10,BN,Brunei Darussalam,1854,317587,2,166,0.05226914199888534
2023-12-17,BN,Brunei Darussalam,3648,321235,2,168,0.05229816178187308
2023-12-24,BN,Brunei Darussalam,5040,326275,2,170,0.05210328710443644
2023-12-31,BN,Brunei Darussalam,4501,330776,1,171,0.05169661644133795
2024-01-07,BN,Brunei Darussalam,3459,334235,5,176,0.05265756129669245
2024-01-14,BN,Brunei Darussalam,4334,338569,1,177,0.05227885600867179
2020-06-21,BI,Burundi,50,144,0,1,0.6944444444444444
2020-06-28,BI,Burundi,26,170,0,1,0.5882352941176471
2020-07-05,BI,Burundi,21,191,0,1,0.5235602094240838
2020-07-12,BI,Burundi,66,257,0,1,0.38910505836575876
2020-07-19,BI,Burundi,65,322,0,1,0.3105590062111801
2020-07-26,BI,Burundi,23,345,0,1,0.2898550724637681
2020-08-02,BI,Burundi,42,387,0,1,0.2583979328165375
2020-08-09,BI,Burundi,18,405,0,1,0.24691358024691357
2020-08-16,BI,Burundi,8,413,0,1,0.24213075060532688
2020-08-23,BI,Burundi,17,430,0,1,0.23255813953488372
2020-08-30,BI,Burundi,15,445,0,1,0.22471910112359553
2020-09-06,BI,Burundi,17,462,0,1,0.21645021645021645
2020-09-13,BI,Burundi,10,472,0,1,0.211864406779661
2020-09-20,BI,Burundi,1,473,0,1,0.21141649048625794
2020-09-27,BI,Burundi,11,484,0,1,0.2066115702479339
2020-10-04,BI,Burundi,29,513,0,1,0.1949317738791423
2020-10-11,BI,Burundi,12,525,0,1,0.19047619047619047
2020-10-18,BI,Burundi,17,542,0,1,0.18450184501845018
2020-10-25,BI,Burundi,14,556,0,1,0.1798561151079137
2020-11-01,BI,Burundi,33,589,0,1,0.1697792869269949
2020-11-08,BI,Burundi,25,614,0,1,0.16286644951140067
2020-11-15,BI,Burundi,14,628,0,1,0.15923566878980894
2020-11-22,BI,Burundi,34,662,0,1,0.1510574018126888
2020-11-29,BI,Burundi,26,688,0,1,0.14534883720930233
2020-12-06,BI,Burundi,6,694,0,1,0.1440922190201729
2020-12-13,BI,Burundi,35,729,0,1,0.1371742112482853
2020-12-20,BI,Burundi,32,761,1,2,0.2628120893561104
2020-12-27,BI,Burundi,48,809,0,2,0.2472187886279357
2021-01-03,BI,Burundi,24,833,0,2,0.24009603841536614
2021-01-10,BI,Burundi,153,986,0,2,0.2028397565922921
2021-01-17,BI,Burundi,250,1236,0,2,0.16181229773462785
2021-01-24,BI,Burundi,236,1472,0,2,0.1358695652173913
2021-01-31,BI,Burundi,163,1635,0,2,0.12232415902140673
2021-02-07,BI,Burundi,93,1728,1,3,0.1736111111111111
2021-02-14,BI,Burundi,121,1849,0,3,0.16224986479177933
2021-02-21,BI,Burundi,185,2034,0,3,0.14749262536873156
2021-02-28,BI,Burundi,183,2217,0,3,0.13531799729364005
2021-03-07,BI,Burundi,117,2334,0,3,0.12853470437017994
2021-03-14,BI,Burundi,147,2481,0,3,0.12091898428053204
2021-03-21,BI,Burundi,137,2618,3,6,0.2291825821237586
2021-03-28,BI,Burundi,149,2767,0,6,0.21684134441633537
2021-04-04,BI,Burundi,197,2964,0,6,0.20242914979757085
2021-04-11,BI,Burundi,223,3187,0,6,0.1882648258550361
2021-04-18,BI,Burundi,444,3631,0,6,0.16524373450839988
2021-04-25,BI,Burundi,243,3874,0,6,0.15487867836861124
2021-05-02,BI,Burundi,172,4046,0,6,0.14829461196243204
2021-05-09,BI,Burundi,154,4200,0,6,0.14285714285714285
2021-05-16,BI,Burundi,147,4347,0,6,0.13802622498274672
2021-05-23,BI,Burundi,199,4546,0,6,0.13198416190057194
2021-05-30,BI,Burundi,244,4790,0,6,0.12526096033402923
2021-06-06,BI,Burundi,135,4925,2,8,0.16243654822335024
2021-06-13,BI,Burundi,101,5026,0,8,0.15917230401910068
2021-06-20,BI,Burundi,216,5242,0,8,0.15261350629530715
2021-06-27,BI,Burundi,181,5423,0,8,0.14751982297621244
2021-07-04,BI,Burundi,98,5521,0,8,0.14490128599891325
2021-07-11,BI,Burundi,165,5686,0,8,0.14069644741470277
2021-07-18,BI,Burundi,208,5894,0,8,0.1357312521208008
2021-07-25,BI,Burundi,679,6573,0,8,0.12171002586338049
2021-08-01,BI,Burundi,932,7505,1,9,0.11992005329780146
2021-08-08,BI,Burundi,1295,8800,1,10,0.11363636363636363
2021-08-15,BI,Burundi,1303,10103,0,10,0.09898050084133425
2021-08-22,BI,Burundi,1230,11333,0,10,0.08823788934968677
2021-08-29,BI,Burundi,1196,12529,0,10,0.07981482959533881
2021-09-05,BI,Burundi,1047,13576,2,12,0.0883912787271656
2021-09-12,BI,Burundi,1801,15377,0,12,0.0780386291214151
2021-09-19,BI,Burundi,1355,16732,2,14,0.08367200573750896
2021-09-26,BI,Burundi,773,17505,0,14,0.07997714938588975
2021-10-03,BI,Burundi,1095,18600,0,14,0.07526881720430108
2021-10-10,BI,Burundi,657,19257,0,14,0.07270083605961468
2021-10-17,BI,Burundi,473,19730,0,14,0.07095793208312215
2021-10-24,BI,Burundi,215,19945,0,14,0.0701930308347957
2021-10-31,BI,Burundi,142,20087,0,14,0.06969681883805447
2021-11-07,BI,Burundi,78,20165,0,14,0.06942722539052815
2021-11-14,BI,Burundi,111,20276,0,14,0.06904714933912014
2021-11-21,BI,Burundi,62,20338,0,14,0.06883666043858787
2021-11-28,BI,Burundi,64,20402,0,14,0.06862072345848445
2021-12-05,BI,Burundi,89,20491,0,14,0.06832267824898736
2021-12-12,BI,Burundi,355,20846,0,14,0.0671591672263264
2021-12-19,BI,Burundi,1793,22639,0,14,0.06184018728742435
2021-12-26,BI,Burundi,4360,26999,0,14,0.051853772361939325
2022-01-02,BI,Burundi,5077,32076,0,14,0.04364633994263624
2022-01-09,BI,Burundi,3424,35500,0,14,0.039436619718309855
2022-01-16,BI,Burundi,1236,36736,0,14,0.038109756097560975
2022-01-23,BI,Burundi,306,37042,0,14,0.03779493547864586
2022-01-30,BI,Burundi,337,37379,0,14,0.03745418550523021
2022-02-06,BI,Burundi,377,37756,1,15,0.03972878482890137
2022-02-13,BI,Burundi,146,37902,0,15,0.03957574798163686
2022-02-20,BI,Burundi,109,38011,0,15,0.03946226092446923
2022-02-27,BI,Burundi,91,38102,0,15,0.03936801217783843
2022-03-06,BI,Burundi,107,38209,0,15,0.03925776649480489
2022-03-13,BI,Burundi,65,38274,0,15,0.039191095783038095
2022-03-20,BI,Burundi,98,38372,0,15,0.03909100385697905
2022-03-27,BI,Burundi,91,38463,0,15,0.03899851805631386
2022-04-03,BI,Burundi,125,38588,0,15,0.03887218824505028
2022-04-10,BI,Burundi,110,38698,0,15,0.03876169311075508
2022-04-17,BI,Burundi,103,38801,0,15,0.03865879745367387
2022-04-24,BI,Burundi,343,39144,0,15,0.03832004904966278
2022-05-01,BI,Burundi,1253,40397,0,15,0.03713147015867515
2022-05-08,BI,Burundi,676,41073,0,15,0.03652034183039953
2022-05-15,BI,Burundi,268,41341,0,15,0.03628359255944462
2022-05-22,BI,Burundi,509,41850,0,15,0.035842293906810034
2022-05-29,BI,Burundi,184,42034,0,15,0.035685397535328546
2022-06-05,BI,Burundi,171,42205,0,15,0.035540812699917074
2022-06-12,BI,Burundi,125,42330,0,15,0.03543586109142452
2022-06-19,BI,Burundi,142,42472,0,15,0.035317385571670745
2022-06-26,BI,Burundi,121,42593,0,15,0.03521705444556617
2022-07-03,BI,Burundi,201,42794,0,15,0.035051642753657054
2022-07-10,BI,Burundi,169,42963,0,15,0.03491376300537672
2022-07-17,BI,Burundi,451,43414,0,15,0.0345510664762519
2022-07-24,BI,Burundi,1023,44437,0,15,0.033755654072057065
2022-07-31,BI,Burundi,1714,46151,0,15,0.03250200429026456
2022-08-07,BI,Burundi,1096,47247,0,15,0.031748047495079056
2022-08-14,BI,Burundi,755,48002,0,15,0.03124869797091788
2022-08-21,BI,Burundi,973,48975,0,15,0.030627871362940276
2022-08-28,BI,Burundi,283,49258,0,15,0.030451906289333714
2022-09-04,BI,Burundi,112,49370,0,15,0.030382823577071096
2022-09-11,BI,Burundi,229,49599,0,15,0.030242545212605096
2022-09-18,BI,Burundi,427,50026,0,15,0.029984408107783956
2022-09-25,BI,Burundi,103,50129,0,15,0.02992279917812045
2022-10-02,BI,Burundi,96,50225,0,15,0.029865604778496768
2022-10-09,BI,Burundi,0,50225,0,15,0.029865604778496768
2022-10-16,BI,Burundi,147,50372,0,15,0.02977844834431827
2022-10-23,BI,Burundi,80,50452,0,15,0.029731229683659717
2022-10-30,BI,Burundi,18,50470,0,15,0.029720626114523477
2022-11-06,BI,Burundi,47,50517,0,15,0.029692974642199655
2022-11-13,BI,Burundi,122,50639,0,15,0.029621438022077846
2022-11-20,BI,Burundi,139,50778,0,15,0.02954035212099728
2022-11-27,BI,Burundi,240,51018,0,15,0.029401387745501585
2022-12-04,BI,Burundi,258,51276,0,15,0.029253451907325062
2022-12-11,BI,Burundi,205,51481,0,15,0.02913696315145393
2022-12-18,BI,Burundi,241,51722,0,15,0.0290011987162136
2022-12-25,BI,Burundi,329,52051,0,15,0.028817890146202764
2023-01-01,BI,Burundi,111,52162,0,15,0.028756566082588857
2023-01-08,BI,Burundi,218,52380,0,15,0.028636884306987402
2023-01-15,BI,Burundi,49,52429,0,15,0.02861012035323962
2023-01-22,BI,Burundi,0,52429,0,15,0.02861012035323962
2023-01-29,BI,Burundi,1063,53492,0,15,0.02804157631047633
2023-02-05,BI,Burundi,82,53574,0,15,0.027998656064508902
2023-02-12,BI,Burundi,35,53609,0,15,0.027980376429330895
2023-02-19,BI,Burundi,0,53609,0,15,0.027980376429330895
2023-02-26,BI,Burundi,37,53646,0,15,0.02796107817917459
2023-03-05,BI,Burundi,15,53661,0,15,0.027953262145692406
2023-03-12,BI,Burundi,0,53661,0,15,0.027953262145692406
2023-03-19,BI,Burundi,13,53674,0,15,0.027946491783731417
2023-03-26,BI,Burundi,12,53686,0,15,0.027940245129083933
2023-04-02,BI,Burundi,20,53706,0,15,0.02792984024131382
2023-04-09,BI,Burundi,13,53719,0,15,0.02792308121893557
2023-04-16,BI,Burundi,7,53726,0,15,0.02791944310017496
2023-04-23,BI,Burundi,0,53726,0,15,0.02791944310017496
2023-04-30,BI,Burundi,5,53731,0,15,0.027916845024287654
2023-05-07,BI,Burundi,9,53740,0,15,0.02791216970599181
2023-05-14,BI,Burundi,9,53749,0,15,0.02790749595341309
2023-05-21,BI,Burundi,13,53762,0,15,0.027900747740039436
2023-05-28,BI,Burundi,0,53762,0,15,0.027900747740039436
2023-06-04,BI,Burundi,74,53836,0,15,0.027862396909131434
2023-06-11,BI,Burundi,118,53954,0,15,0.02780146050339178
2023-06-18,BI,Burundi,82,54036,0,15,0.027759271596713302
2023-06-25,BI,Burundi,106,54142,0,15,0.027704924088508
2023-07-02,BI,Burundi,16,54158,0,15,0.027696739170574986
2023-07-09,BI,Burundi,163,54321,0,15,0.027613630087811345
2023-07-16,BI,Burundi,-105,54216,0,15,0.02766710934041611
2023-07-23,BI,Burundi,13,54229,0,15,0.02766047686662118
2023-07-30,BI,Burundi,5,54234,0,15,0.027657926761809934
2023-08-06,BI,Burundi,4,54238,0,15,0.027655887016482906
2023-08-13,BI,Burundi,1,54239,0,15,0.027655377127159424
2023-08-20,BI,Burundi,0,54239,0,15,0.027655377127159424
2023-08-27,BI,Burundi,0,54239,0,15,0.027655377127159424
2023-09-03,BI,Burundi,2,54241,0,15,0.027654357404915102
2023-09-10,BI,Burundi,125,54366,0,15,0.027590773645293016
2023-09-17,BI,Burundi,0,54366,0,15,0.027590773645293016
2023-09-24,BI,Burundi,0,54366,0,15,0.027590773645293016
2023-10-01,BI,Burundi,0,54366,0,15,0.027590773645293016
2023-10-08,BI,Burundi,0,54366,0,15,0.027590773645293016
2023-10-15,BI,Burundi,0,54366,0,15,0.027590773645293016
2023-10-22,BI,Burundi,0,54366,0,15,0.027590773645293016
2023-10-29,BI,Burundi,0,54366,0,15,0.027590773645293016
2023-11-05,BI,Burundi,1,54367,0,15,0.027590266154100835
2023-11-12,BI,Burundi,1,54368,0,15,0.027589758681577398
2023-11-19,BI,Burundi,0,54368,0,15,0.027589758681577398
2023-11-26,BI,Burundi,14,54382,0,15,0.027582656025890922
2023-12-03,BI,Burundi,12,54394,0,15,0.02757657094532485
2023-12-10,BI,Burundi,25,54419,0,15,0.0275639023135302
2023-12-17,BI,Burundi,32,54451,0,15,0.027547703439789902
2023-12-24,BI,Burundi,4,54455,0,15,0.027545679919199338
2023-12-31,BI,Burundi,6,54461,0,15,0.027542645195644592
2024-01-07,BI,Burundi,0,54461,0,15,0.027542645195644592
2024-01-14,BI,Burundi,0,54461,0,15,0.027542645195644592
2020-05-10,CV,Cabo Verde,84,236,0,2,0.847457627118644
2020-05-17,CV,Cabo Verde,92,328,1,3,0.9146341463414633
2020-05-24,CV,Cabo Verde,43,371,0,3,0.8086253369272237
2020-05-31,CV,Cabo Verde,50,421,1,4,0.9501187648456058
2020-06-07,CV,Cabo Verde,121,542,1,5,0.9225092250922509
2020-06-14,CV,Cabo Verde,184,726,1,6,0.8264462809917356
2020-06-21,CV,Cabo Verde,137,863,2,8,0.9269988412514484
2020-07-26,CV,Cabo Verde,244,2258,1,22,0.9743135518157661
2020-08-02,CV,Cabo Verde,222,2480,2,24,0.967741935483871
2020-09-06,CV,Cabo Verde,497,4275,3,42,0.9824561403508772
2020-09-13,CV,Cabo Verde,436,4711,2,44,0.9339842920823604
2020-09-20,CV,Cabo Verde,475,5186,6,50,0.9641342074816814
2020-09-27,CV,Cabo Verde,515,5701,6,56,0.9822838098579197
2020-10-04,CV,Cabo Verde,595,6296,6,62,0.9847522236340533
2020-11-29,CV,Cabo Verde,466,10700,0,104,0.9719626168224299
2020-12-06,CV,Cabo Verde,336,11036,1,105,0.9514316781442551
2020-12-13,CV,Cabo Verde,266,11302,5,110,0.973279065652097
2020-12-20,CV,Cabo Verde,265,11567,1,111,0.9596265237313045
2020-12-27,CV,Cabo Verde,131,11698,1,112,0.9574286202769703
2021-01-03,CV,Cabo Verde,185,11883,1,113,0.9509383152402592
2021-01-10,CV,Cabo Verde,433,12316,1,114,0.9256252029879831
2021-01-17,CV,Cabo Verde,585,12901,5,119,0.9224091155724362
2021-01-24,CV,Cabo Verde,513,13414,5,124,0.924407335619502
2021-01-31,CV,Cabo Verde,567,13981,9,133,0.9512910378370647
2021-02-07,CV,Cabo Verde,399,14380,2,135,0.9388038942976357
2021-02-14,CV,Cabo Verde,320,14700,4,139,0.945578231292517
2021-02-21,CV,Cabo Verde,299,14999,4,143,0.9533968931262083
2021-02-28,CV,Cabo Verde,325,15324,4,147,0.9592795614722005
2021-03-07,CV,Cabo Verde,400,15724,5,152,0.9666751462732129
2021-03-14,CV,Cabo Verde,311,16035,4,156,0.9728718428437793
2021-03-21,CV,Cabo Verde,405,16440,3,159,0.9671532846715328
2021-03-28,CV,Cabo Verde,578,17018,6,165,0.9695616406158186
2021-04-04,CV,Cabo Verde,803,17821,6,171,0.9595421132371921
2021-04-11,CV,Cabo Verde,1015,18836,10,181,0.9609258866001275
2021-04-18,CV,Cabo Verde,1418,20254,9,190,0.9380863039399625
2021-04-25,CV,Cabo Verde,1840,22094,11,201,0.9097492531909116
2021-05-02,CV,Cabo Verde,2033,24127,19,220,0.9118415053674308
2021-05-09,CV,Cabo Verde,1984,26111,12,232,0.8885144192102946
2021-05-16,CV,Cabo Verde,1840,27951,14,246,0.8801116239132769
2021-05-23,CV,Cabo Verde,1247,29198,10,256,0.8767723816699774
2021-05-30,CV,Cabo Verde,1075,30273,7,263,0.8687609420936148
2021-06-06,CV,Cabo Verde,730,31003,4,267,0.8612069799696803
2021-06-13,CV,Cabo Verde,568,31571,6,273,0.8647176206011846
2021-06-20,CV,Cabo Verde,393,31964,8,281,0.8791140032536603
2021-06-27,CV,Cabo Verde,380,32344,5,286,0.8842443729903537
2021-07-04,CV,Cabo Verde,361,32705,1,287,0.8775416602965908
2021-07-11,CV,Cabo Verde,264,32969,2,289,0.8765810306651702
2021-07-18,CV,Cabo Verde,301,33270,6,295,0.8866847009317703
2021-07-25,CV,Cabo Verde,271,33541,2,297,0.8854834381801377
2021-08-01,CV,Cabo Verde,250,33791,1,298,0.8818916279482703
2021-08-08,CV,Cabo Verde,219,34010,0,298,0.876212878565128
2021-08-15,CV,Cabo Verde,334,34344,1,299,0.8706033077102259
2021-08-22,CV,Cabo Verde,342,34686,3,302,0.8706682811508967
2021-08-29,CV,Cabo Verde,461,35147,6,308,0.876319458275244
2021-09-05,CV,Cabo Verde,709,35856,7,315,0.8785140562248996
2021-09-12,CV,Cabo Verde,663,36519,5,320,0.8762561954051316
2021-09-19,CV,Cabo Verde,533,37052,9,329,0.8879412717262227
2021-09-26,CV,Cabo Verde,348,37400,5,334,0.893048128342246
2021-10-03,CV,Cabo Verde,235,37635,6,340,0.9034143749169656
2021-10-10,CV,Cabo Verde,235,37870,6,346,0.9136519672564035
2021-10-17,CV,Cabo Verde,165,38035,1,347,0.9123176022084922
2021-10-24,CV,Cabo Verde,95,38130,2,349,0.9152897980592709
2021-10-31,CV,Cabo Verde,77,38207,0,349,0.9134451802025807
2021-11-07,CV,Cabo Verde,46,38253,0,349,0.9123467440462185
2021-11-14,CV,Cabo Verde,40,38293,0,349,0.9113937273130859
2021-11-21,CV,Cabo Verde,31,38324,0,349,0.910656507671433
2021-11-28,CV,Cabo Verde,34,38358,0,349,0.9098493143542417
2021-12-05,CV,Cabo Verde,81,38439,2,351,0.9131350971669397
2021-12-12,CV,Cabo Verde,57,38496,0,351,0.9117830423940149
2021-12-19,CV,Cabo Verde,77,38573,1,352,0.9125554144090426
2021-12-26,CV,Cabo Verde,440,39013,0,352,0.902263348114731
2022-01-02,CV,Cabo Verde,3450,42463,1,353,0.8313119657113252
2022-01-09,CV,Cabo Verde,7387,49850,10,363,0.728184553660983
2022-01-16,CV,Cabo Verde,4137,53987,13,376,0.6964639635467798
2022-01-23,CV,Cabo Verde,1269,55256,11,387,0.7003764297089909
2022-01-30,CV,Cabo Verde,402,55658,8,395,0.7096913291889755
2022-02-06,CV,Cabo Verde,114,55772,1,396,0.7100337086710177
2022-02-13,CV,Cabo Verde,70,55842,4,400,0.716306722538591
2022-02-20,CV,Cabo Verde,18,55860,0,400,0.7160759040458289
2022-02-27,CV,Cabo Verde,22,55882,1,401,0.7175834794746072
2022-03-06,CV,Cabo Verde,13,55895,0,401,0.7174165846676804
2022-03-13,CV,Cabo Verde,11,55906,0,401,0.7172754266089507
2022-03-20,CV,Cabo Verde,19,55925,0,401,0.7170317389360751
2022-03-27,CV,Cabo Verde,23,55948,0,401,0.7167369700436119
2022-04-03,CV,Cabo Verde,12,55960,0,401,0.7165832737669764
2022-04-10,CV,Cabo Verde,12,55972,0,401,0.7164296433931252
2022-04-17,CV,Cabo Verde,18,55990,0,401,0.7161993213073763
2022-04-24,CV,Cabo Verde,14,56004,0,401,0.7160202842654095
2022-05-01,CV,Cabo Verde,21,56025,0,401,0.715751896474788
2022-05-08,CV,Cabo Verde,40,56065,0,401,0.7152412378489253
2022-05-15,CV,Cabo Verde,50,56115,0,401,0.7146039383409071
2022-05-22,CV,Cabo Verde,57,56172,0,401,0.7138788008260343
2022-05-29,CV,Cabo Verde,118,56290,0,401,0.7123823059157932
2022-06-05,CV,Cabo Verde,266,56556,1,402,0.7107999151283684
2022-06-12,CV,Cabo Verde,540,57096,0,402,0.7040773434216058
2022-06-19,CV,Cabo Verde,1080,58176,0,402,0.691006600660066
2022-06-26,CV,Cabo Verde,1357,59533,1,403,0.6769354811617087
2022-07-03,CV,Cabo Verde,1469,61002,2,405,0.6639126586013573
2022-07-10,CV,Cabo Verde,621,61623,4,409,0.6637132239585869
2022-07-17,CV,Cabo Verde,299,61922,0,409,0.660508381512225
2022-07-24,CV,Cabo Verde,150,62072,0,409,0.6589122309575977
2022-07-31,CV,Cabo Verde,87,62159,1,410,0.6595987708939977
2022-08-07,CV,Cabo Verde,48,62207,0,410,0.6590898130435482
2022-08-14,CV,Cabo Verde,46,62253,0,410,0.6586027982587185
2022-08-21,CV,Cabo Verde,35,62288,0,410,0.6582327254045723
2022-08-28,CV,Cabo Verde,22,62310,0,410,0.6580003209757663
2022-09-04,CV,Cabo Verde,18,62328,0,410,0.6578102939288923
2022-09-11,CV,Cabo Verde,13,62341,0,410,0.6576731204183442
2022-09-18,CV,Cabo Verde,11,62352,0,410,0.657557095201437
2022-09-25,CV,Cabo Verde,7,62359,0,410,0.6574832822848345
2022-10-02,CV,Cabo Verde,17,62376,0,410,0.6573040913171733
2022-10-09,CV,Cabo Verde,13,62389,0,410,0.6571671288207858
2022-10-16,CV,Cabo Verde,8,62397,0,410,0.6570828725740019
2022-10-23,CV,Cabo Verde,0,62397,0,410,0.6570828725740019
2022-10-30,CV,Cabo Verde,0,62397,0,410,0.6570828725740019
2022-11-06,CV,Cabo Verde,164,62561,0,410,0.6553603682805582
2022-11-13,CV,Cabo Verde,119,62680,0,410,0.6541161455009573
2022-11-20,CV,Cabo Verde,139,62819,1,411,0.6542606536239036
2022-11-27,CV,Cabo Verde,150,62969,1,412,0.654290206291985
2022-12-04,CV,Cabo Verde,111,63080,0,412,0.653138871274572
2022-12-11,CV,Cabo Verde,49,63129,0,412,0.6526319124332716
2022-12-18,CV,Cabo Verde,35,63164,0,412,0.6522702805395478
2022-12-25,CV,Cabo Verde,26,63190,0,412,0.6520018990346573
2023-01-01,CV,Cabo Verde,10,63200,0,412,0.6518987341772152
2023-01-08,CV,Cabo Verde,7,63207,0,412,0.6518265381998829
2023-01-15,CV,Cabo Verde,14,63221,0,412,0.6516821942076209
2023-01-22,CV,Cabo Verde,3,63224,0,412,0.6516512716689865
2023-01-29,CV,Cabo Verde,3,63227,1,413,0.6532019548610561
2023-02-05,CV,Cabo Verde,2,63229,0,413,0.6531812933938541
2023-02-12,CV,Cabo Verde,6,63235,0,413,0.6531193168340318
2023-02-19,CV,Cabo Verde,4,63239,0,413,0.6530780056610637
2023-02-26,CV,Cabo Verde,2,63241,0,413,0.6530573520342815
2023-03-05,CV,Cabo Verde,4,63245,0,413,0.6530160486995019
2023-03-12,CV,Cabo Verde,0,63245,0,413,0.6530160486995019
2023-03-19,CV,Cabo Verde,7,63252,0,413,0.6529437804338203
2023-03-26,CV,Cabo Verde,5,63257,0,413,0.6528921700365178
2023-04-02,CV,Cabo Verde,3,63260,0,413,0.6528612077141954
2023-04-09,CV,Cabo Verde,18,63278,0,413,0.6526754954328519
2023-04-16,CV,Cabo Verde,3,63281,0,413,0.652644553657496
2023-04-23,CV,Cabo Verde,72,63353,0,413,0.6519028301737881
2023-04-30,CV,Cabo Verde,114,63467,0,413,0.6507318764082121
2023-05-07,CV,Cabo Verde,146,63613,0,413,0.6492383632276422
2023-05-14,CV,Cabo Verde,128,63741,1,414,0.6495034593119029
2023-05-21,CV,Cabo Verde,106,63847,0,414,0.6484251413535483
2023-05-28,CV,Cabo Verde,64,63911,0,414,0.6477758132402872
2023-06-04,CV,Cabo Verde,43,63954,0,414,0.647340275823248
2023-06-11,CV,Cabo Verde,24,63978,0,414,0.6470974397449123
2023-06-18,CV,Cabo Verde,7,63985,0,414,0.6470266468703603
2023-06-25,CV,Cabo Verde,45,64030,0,414,0.6465719194127753
2023-07-02,CV,Cabo Verde,50,64080,0,414,0.646067415730337
2023-07-09,CV,Cabo Verde,45,64125,0,414,0.6456140350877193
2023-07-16,CV,Cabo Verde,36,64161,0,414,0.645251788469631
2023-07-23,CV,Cabo Verde,11,64172,0,414,0.6451411830704981
2023-07-30,CV,Cabo Verde,10,64182,0,414,0.6450406656071795
2023-08-06,CV,Cabo Verde,7,64189,0,414,0.6449703220177911
2023-08-13,CV,Cabo Verde,37,64226,0,414,0.6445987606265375
2023-08-20,CV,Cabo Verde,12,64238,1,415,0.6460350571312931
2023-08-27,CV,Cabo Verde,34,64272,0,415,0.6456933034602937
2023-09-03,CV,Cabo Verde,34,64306,0,415,0.645351911174696
2023-09-10,CV,Cabo Verde,49,64355,0,415,0.6448605391966437
2023-09-17,CV,Cabo Verde,49,64404,0,415,0.6443699149121173
2023-09-24,CV,Cabo Verde,26,64430,0,415,0.6441098866987428
2023-10-01,CV,Cabo Verde,21,64451,2,417,0.6470031496796016
2023-10-08,CV,Cabo Verde,5,64456,0,417,0.646952960158868
2023-10-15,CV,Cabo Verde,14,64470,0,417,0.6468124709167055
2023-10-22,CV,Cabo Verde,1,64471,0,417,0.6468024383055947
2023-10-29,CV,Cabo Verde,3,64474,0,417,0.6467723423395477
2023-11-05,CV,Cabo Verde,0,64474,0,417,0.6467723423395477
2023-11-12,CV,Cabo Verde,0,64474,0,417,0.6467723423395477
2023-11-19,CV,Cabo Verde,0,64474,0,417,0.6467723423395477
2023-11-26,CV,Cabo Verde,0,64474,0,417,0.6467723423395477
2023-12-03,CV,Cabo Verde,0,64474,0,417,0.6467723423395477
2023-12-10,CV,Cabo Verde,0,64474,0,417,0.6467723423395477
2023-12-17,CV,Cabo Verde,0,64474,0,417,0.6467723423395477
2023-12-24,CV,Cabo Verde,0,64474,0,417,0.6467723423395477
2023-12-31,CV,Cabo Verde,0,64474,0,417,0.6467723423395477
2024-01-07,CV,Cabo Verde,0,64474,0,417,0.6467723423395477
2024-01-14,CV,Cabo Verde,0,64474,0,417,0.6467723423395477
2021-03-14,KH,Cambodia,314,1325,1,1,0.07547169811320754
2021-03-21,KH,Cambodia,428,1753,2,3,0.17113519680547634
2021-03-28,KH,Cambodia,520,2273,7,10,0.43994720633523976
2021-04-04,KH,Cambodia,479,2752,9,19,0.690406976744186
2021-04-11,KH,Cambodia,1763,4515,10,29,0.6423034330011074
2021-04-18,KH,Cambodia,2498,7013,14,43,0.6131470126907173
2021-04-25,KH,Cambodia,3542,10555,31,74,0.7010895310279488
2021-05-02,KH,Cambodia,4806,15361,32,106,0.690059240934835
2021-05-09,KH,Cambodia,4382,19743,20,126,0.6382008813250265
2021-05-16,KH,Cambodia,2801,22544,28,154,0.6831085876508162
2021-05-23,KH,Cambodia,3217,25761,25,179,0.6948488024533209
2021-05-30,KH,Cambodia,4333,30094,35,214,0.7111052036950888
2021-06-06,KH,Cambodia,4150,34244,49,263,0.7680177549351711
2021-06-13,KH,Cambodia,4183,38427,72,335,0.8717828610091862
2020-03-15,CA,Canada,125,176,1,1,0.5681818181818182
2020-03-29,CA,Canada,3704,4675,24,35,0.7486631016042781
2020-05-24,KY,Cayman Islands,35,129,0,1,0.7751937984496124
2020-05-31,KY,Cayman Islands,12,141,0,1,0.7092198581560284
2020-06-07,KY,Cayman Islands,23,164,0,1,0.6097560975609756
2020-06-14,KY,Cayman Islands,23,187,0,1,0.53475935828877
2020-06-21,KY,Cayman Islands,8,195,0,1,0.5128205128205128
2020-06-28,KY,Cayman Islands,1,196,0,1,0.5102040816326531
2020-07-05,KY,Cayman Islands,5,201,0,1,0.4975124378109453
2020-07-12,KY,Cayman Islands,0,201,0,1,0.4975124378109453
2020-07-19,KY,Cayman Islands,2,203,0,1,0.49261083743842365
2020-07-26,KY,Cayman Islands,0,203,0,1,0.49261083743842365
2020-08-02,KY,Cayman Islands,0,203,0,1,0.49261083743842365
2020-08-09,KY,Cayman Islands,0,203,0,1,0.49261083743842365
2020-08-16,KY,Cayman Islands,0,203,0,1,0.49261083743842365
2020-08-23,KY,Cayman Islands,2,205,0,1,0.4878048780487805
2020-08-30,KY,Cayman Islands,0,205,0,1,0.4878048780487805
2020-09-06,KY,Cayman Islands,0,205,0,1,0.4878048780487805
2020-09-13,KY,Cayman Islands,3,208,0,1,0.4807692307692308
2020-09-20,KY,Cayman Islands,0,208,0,1,0.4807692307692308
2020-09-27,KY,Cayman Islands,2,210,0,1,0.4761904761904762
2020-10-04,KY,Cayman Islands,3,213,0,1,0.4694835680751174
2020-10-11,KY,Cayman Islands,7,220,0,1,0.45454545454545453
2020-10-18,KY,Cayman Islands,13,233,0,1,0.4291845493562232
2020-10-25,KY,Cayman Islands,6,239,0,1,0.41841004184100417
2020-11-01,KY,Cayman Islands,1,240,0,1,0.4166666666666667
2020-11-08,KY,Cayman Islands,10,250,0,1,0.4
2020-11-15,KY,Cayman Islands,4,254,0,1,0.39370078740157477
2020-11-22,KY,Cayman Islands,7,261,1,2,0.7662835249042145
2020-11-29,KY,Cayman Islands,13,274,0,2,0.7299270072992701
2020-12-06,KY,Cayman Islands,14,288,0,2,0.6944444444444444
2020-12-13,KY,Cayman Islands,10,298,0,2,0.6711409395973155
2020-12-20,KY,Cayman Islands,13,311,0,2,0.6430868167202572
2020-12-27,KY,Cayman Islands,7,318,0,2,0.628930817610063
2021-01-03,KY,Cayman Islands,20,338,0,2,0.591715976331361
2021-01-10,KY,Cayman Islands,21,359,0,2,0.5571030640668524
2021-01-17,KY,Cayman Islands,15,374,0,2,0.53475935828877
2021-01-24,KY,Cayman Islands,9,383,0,2,0.5221932114882507
2021-01-31,KY,Cayman Islands,7,390,0,2,0.5128205128205128
2021-02-07,KY,Cayman Islands,15,405,0,2,0.49382716049382713
2021-02-14,KY,Cayman Islands,11,416,0,2,0.4807692307692308
2021-02-21,KY,Cayman Islands,12,428,0,2,0.46728971962616817
2021-02-28,KY,Cayman Islands,10,438,0,2,0.45662100456621
2021-03-07,KY,Cayman Islands,13,451,0,2,0.4434589800443459
2021-03-14,KY,Cayman Islands,17,468,0,2,0.4273504273504274
2021-03-21,KY,Cayman Islands,7,475,0,2,0.42105263157894735
2021-03-28,KY,Cayman Islands,12,487,0,2,0.41067761806981523
2021-04-04,KY,Cayman Islands,14,501,0,2,0.39920159680638717
2021-04-11,KY,Cayman Islands,15,516,0,2,0.3875968992248062
2021-04-18,KY,Cayman Islands,9,525,0,2,0.38095238095238093
2021-04-25,KY,Cayman Islands,9,534,0,2,0.37453183520599254
2021-05-02,KY,Cayman Islands,9,543,0,2,0.3683241252302026
2021-05-09,KY,Cayman Islands,5,548,0,2,0.36496350364963503
2021-05-16,KY,Cayman Islands,17,565,0,2,0.35398230088495575
2021-05-23,KY,Cayman Islands,9,574,0,2,0.34843205574912894
2021-05-30,KY,Cayman Islands,7,581,0,2,0.34423407917383825
2021-06-06,KY,Cayman Islands,6,587,0,2,0.34071550255536626
2021-06-13,KY,Cayman Islands,5,592,0,2,0.33783783783783783
2021-06-20,KY,Cayman Islands,16,608,0,2,0.3289473684210526
2021-06-27,KY,Cayman Islands,1,609,0,2,0.3284072249589491
2021-07-04,KY,Cayman Islands,5,614,0,2,0.32573289902280134
2021-07-11,KY,Cayman Islands,2,616,0,2,0.3246753246753247
2021-07-18,KY,Cayman Islands,6,622,0,2,0.3215434083601286
2021-07-25,KY,Cayman Islands,14,636,0,2,0.3144654088050315
2021-08-01,KY,Cayman Islands,7,643,0,2,0.3110419906687403
2021-08-08,KY,Cayman Islands,3,646,0,2,0.30959752321981426
2021-08-15,KY,Cayman Islands,5,651,0,2,0.30721966205837176
2021-08-22,KY,Cayman Islands,12,663,0,2,0.301659125188537
2021-08-29,KY,Cayman Islands,17,680,0,2,0.29411764705882354
2021-09-05,KY,Cayman Islands,11,691,0,2,0.2894356005788712
2021-09-12,KY,Cayman Islands,38,729,0,2,0.2743484224965706
2021-09-19,KY,Cayman Islands,45,774,0,2,0.2583979328165375
2021-09-26,KY,Cayman Islands,21,795,0,2,0.25157232704402516
2021-10-03,KY,Cayman Islands,58,853,0,2,0.23446658851113714
2021-10-10,KY,Cayman Islands,86,939,0,2,0.21299254526091588
2021-10-17,KY,Cayman Islands,72,1011,0,2,0.19782393669634024
2021-10-24,KY,Cayman Islands,185,1196,0,2,0.16722408026755853
2021-10-31,KY,Cayman Islands,454,1650,0,2,0.12121212121212122
2021-11-07,KY,Cayman Islands,1026,2676,0,2,0.07473841554559044
2021-11-14,KY,Cayman Islands,751,3427,0,2,0.05836008170411438
2021-11-21,KY,Cayman Islands,2105,5532,2,4,0.07230657989877079
2021-11-28,KY,Cayman Islands,1206,6738,0,4,0.05936479667557139
2021-12-05,KY,Cayman Islands,791,7529,3,7,0.09297383450657458
2021-12-12,KY,Cayman Islands,342,7871,2,9,0.11434379367297676
2021-12-19,KY,Cayman Islands,226,8097,0,9,0.11115227862171174
2021-12-26,KY,Cayman Islands,289,8386,2,11,0.13117099928452183
2022-01-02,KY,Cayman Islands,694,9080,1,12,0.13215859030837004
2022-01-09,KY,Cayman Islands,1538,10618,0,12,0.1130156338293464
2022-01-16,KY,Cayman Islands,1405,12023,2,14,0.1164434833236297
2022-01-23,KY,Cayman Islands,1711,13734,1,15,0.109217999126256
2022-01-30,KY,Cayman Islands,54,13788,0,15,0.10879025239338555
2022-02-06,KY,Cayman Islands,2146,15934,1,16,0.10041420861051839
2022-02-13,KY,Cayman Islands,1753,17687,0,16,0.09046192118505117
2022-02-20,KY,Cayman Islands,1041,18728,1,17,0.09077317385732593
2022-02-27,KY,Cayman Islands,645,19373,0,17,0.08775099365095751
2022-03-06,KY,Cayman Islands,0,19373,0,17,0.08775099365095751
2022-03-13,KY,Cayman Islands,700,20073,4,21,0.10461814377522044
2022-03-20,KY,Cayman Islands,263,20336,2,23,0.11309992132179386
2022-03-27,KY,Cayman Islands,270,20606,1,24,0.11647093079685529
2022-04-03,KY,Cayman Islands,0,20606,1,25,0.12132388624672426
2022-04-10,KY,Cayman Islands,515,21121,0,25,0.11836560768902987
2022-04-17,KY,Cayman Islands,285,21406,2,27,0.12613285994580958
2022-04-24,KY,Cayman Islands,349,21755,0,27,0.12410940013789934
2022-05-01,KY,Cayman Islands,468,22223,0,27,0.1214957476488323
2022-05-08,KY,Cayman Islands,605,22828,1,28,0.12265638689328894
2022-05-15,KY,Cayman Islands,750,23578,0,28,0.11875477139706506
2022-05-22,KY,Cayman Islands,899,24477,0,28,0.11439310373003227
2022-05-29,KY,Cayman Islands,0,24477,0,28,0.11439310373003227
2022-06-05,KY,Cayman Islands,1409,25886,0,28,0.1081665765278529
2022-06-12,KY,Cayman Islands,439,26325,0,28,0.1063627730294397
2022-06-19,KY,Cayman Islands,472,26797,0,28,0.10448930850468335
2022-06-26,KY,Cayman Islands,374,27171,0,28,0.10305104707224616
2022-07-03,KY,Cayman Islands,423,27594,1,29,0.10509531057476262
2022-07-10,KY,Cayman Islands,372,27966,0,29,0.10369734677823071
2022-07-17,KY,Cayman Islands,423,28389,0,29,0.10215224206558879
2022-07-24,KY,Cayman Islands,395,28784,0,29,0.10075041689827684
2022-07-31,KY,Cayman Islands,325,29109,0,29,0.09962554536397678
2022-08-07,KY,Cayman Islands,310,29419,0,29,0.09857575036541011
2022-08-14,KY,Cayman Islands,234,29653,0,29,0.09779786193639765
2022-08-21,KY,Cayman Islands,254,29907,0,29,0.0969672651887518
2022-08-28,KY,Cayman Islands,150,30057,0,29,0.09648334830488738
2022-09-04,KY,Cayman Islands,157,30214,0,29,0.09598199510160853
2022-09-11,KY,Cayman Islands,166,30380,0,29,0.09545753785385122
2022-09-18,KY,Cayman Islands,165,30545,2,31,0.10148960550008185
2022-09-25,KY,Cayman Islands,0,30545,0,31,0.10148960550008185
2022-10-02,KY,Cayman Islands,116,30661,1,32,0.10436711131404715
2022-10-09,KY,Cayman Islands,148,30809,2,34,0.11035736310818269
2022-10-16,KY,Cayman Islands,0,30809,0,34,0.11035736310818269
2022-10-23,KY,Cayman Islands,117,30926,0,34,0.10993985643148159
2022-10-30,KY,Cayman Islands,80,31006,0,34,0.10965619557504998
2022-11-06,KY,Cayman Islands,90,31096,1,35,0.1125546694108567
2022-11-13,KY,Cayman Islands,98,31194,1,36,0.1154068090017311
2022-11-20,KY,Cayman Islands,0,31194,0,36,0.1154068090017311
2022-11-27,KY,Cayman Islands,0,31194,0,36,0.1154068090017311
2022-12-04,KY,Cayman Islands,165,31359,0,36,0.11479957906821009
2022-12-11,KY,Cayman Islands,0,31359,0,36,0.11479957906821009
2022-12-18,KY,Cayman Islands,113,31472,1,37,0.1175648195221149
2022-12-25,KY,Cayman Islands,0,31472,0,37,0.1175648195221149
2023-01-01,KY,Cayman Islands,0,31472,0,37,0.1175648195221149
2023-01-08,KY,Cayman Islands,0,31472,0,37,0.1175648195221149
2023-01-15,KY,Cayman Islands,0,31472,0,37,0.1175648195221149
2023-01-22,KY,Cayman Islands,0,31472,0,37,0.1175648195221149
2023-01-29,KY,Cayman Islands,0,31472,0,37,0.1175648195221149
2023-02-05,KY,Cayman Islands,0,31472,0,37,0.1175648195221149
2023-02-12,KY,Cayman Islands,0,31472,0,37,0.1175648195221149
2023-02-19,KY,Cayman Islands,0,31472,0,37,0.1175648195221149
2023-02-26,KY,Cayman Islands,0,31472,0,37,0.1175648195221149
2023-03-05,KY,Cayman Islands,0,31472,0,37,0.1175648195221149
2023-03-12,KY,Cayman Islands,0,31472,0,37,0.1175648195221149
2023-03-19,KY,Cayman Islands,0,31472,0,37,0.1175648195221149
2023-03-26,KY,Cayman Islands,0,31472,0,37,0.1175648195221149
2023-04-02,KY,Cayman Islands,0,31472,0,37,0.1175648195221149
2023-04-09,KY,Cayman Islands,0,31472,0,37,0.1175648195221149
2023-04-16,KY,Cayman Islands,0,31472,0,37,0.1175648195221149
2023-04-23,KY,Cayman Islands,0,31472,0,37,0.1175648195221149
2023-04-30,KY,Cayman Islands,0,31472,0,37,0.1175648195221149
2023-05-07,KY,Cayman Islands,0,31472,0,37,0.1175648195221149
2023-05-14,KY,Cayman Islands,0,31472,0,37,0.1175648195221149
2023-05-21,KY,Cayman Islands,0,31472,0,37,0.1175648195221149
2023-05-28,KY,Cayman Islands,0,31472,0,37,0.1175648195221149
2023-06-04,KY,Cayman Islands,0,31472,0,37,0.1175648195221149
2023-06-11,KY,Cayman Islands,0,31472,0,37,0.1175648195221149
2023-06-18,KY,Cayman Islands,0,31472,0,37,0.1175648195221149
2023-06-25,KY,Cayman Islands,0,31472,0,37,0.1175648195221149
2023-07-02,KY,Cayman Islands,0,31472,0,37,0.1175648195221149
2023-07-09,KY,Cayman Islands,0,31472,0,37,0.1175648195221149
2023-07-16,KY,Cayman Islands,0,31472,0,37,0.1175648195221149
2023-07-23,KY,Cayman Islands,0,31472,0,37,0.1175648195221149
2023-07-30,KY,Cayman Islands,0,31472,0,37,0.1175648195221149
2023-08-06,KY,Cayman Islands,0,31472,0,37,0.1175648195221149
2023-08-13,KY,Cayman Islands,0,31472,0,37,0.1175648195221149
2023-08-20,KY,Cayman Islands,0,31472,0,37,0.1175648195221149
2023-08-27,KY,Cayman Islands,0,31472,0,37,0.1175648195221149
2023-09-03,KY,Cayman Islands,0,31472,0,37,0.1175648195221149
2023-09-10,KY,Cayman Islands,0,31472,0,37,0.1175648195221149
2023-09-17,KY,Cayman Islands,0,31472,0,37,0.1175648195221149
2023-09-24,KY,Cayman Islands,0,31472,0,37,0.1175648195221149
2023-10-01,KY,Cayman Islands,0,31472,0,37,0.1175648195221149
2023-10-08,KY,Cayman Islands,0,31472,0,37,0.1175648195221149
2023-10-15,KY,Cayman Islands,0,31472,0,37,0.1175648195221149
2023-10-22,KY,Cayman Islands,0,31472,0,37,0.1175648195221149
2023-10-29,KY,Cayman Islands,0,31472,0,37,0.1175648195221149
2023-11-05,KY,Cayman Islands,0,31472,0,37,0.1175648195221149
2023-11-12,KY,Cayman Islands,0,31472,0,37,0.1175648195221149
2023-11-19,KY,Cayman Islands,0,31472,0,37,0.1175648195221149
2023-11-26,KY,Cayman Islands,0,31472,0,37,0.1175648195221149
2023-12-03,KY,Cayman Islands,0,31472,0,37,0.1175648195221149
2023-12-10,KY,Cayman Islands,0,31472,0,37,0.1175648195221149
2023-12-17,KY,Cayman Islands,0,31472,0,37,0.1175648195221149
2023-12-24,KY,Cayman Islands,0,31472,0,37,0.1175648195221149
2023-12-31,KY,Cayman Islands,0,31472,0,37,0.1175648195221149
2024-01-07,KY,Cayman Islands,0,31472,0,37,0.1175648195221149
2024-01-14,KY,Cayman Islands,0,31472,0,37,0.1175648195221149
2020-05-24,CF,Central African Republic,237,604,1,1,0.16556291390728478
2020-05-31,CF,Central African Republic,448,1052,1,2,0.19011406844106463
2020-06-07,CF,Central African Republic,690,1742,3,5,0.28702640642939153
2020-06-14,CF,Central African Republic,715,2457,2,7,0.2849002849002849
2020-06-21,CF,Central African Republic,707,3164,16,23,0.7269279393173199
2021-04-18,CF,Central African Republic,1227,8294,4,79,0.9524957800819869
2021-04-25,CF,Central African Republic,874,9168,8,87,0.9489528795811518
2021-05-02,CF,Central African Republic,702,9870,4,91,0.9219858156028369
2021-05-09,CF,Central African Republic,511,10381,4,95,0.915133416819189
2021-05-16,CF,Central African Republic,335,10716,1,96,0.8958566629339306
2021-05-23,CF,Central African Republic,164,10880,1,97,0.8915441176470588
2021-05-30,CF,Central African Republic,46,10926,1,98,0.8969430715723962
2021-06-06,CF,Central African Republic,58,10984,0,98,0.8922068463219228
2021-06-13,CF,Central African Republic,44,11028,0,98,0.8886470801595938
2021-06-20,CF,Central African Republic,14,11042,0,98,0.8875203767433436
2021-06-27,CF,Central African Republic,16,11058,0,98,0.8862362090793996
2021-07-04,CF,Central African Republic,7,11065,0,98,0.8856755535472209
2021-07-11,CF,Central African Republic,10,11075,0,98,0.8848758465011286
2021-07-18,CF,Central African Republic,27,11102,0,98,0.8827238335435058
2021-07-25,CF,Central African Republic,43,11145,0,98,0.879318079856438
2021-08-01,CF,Central African Republic,28,11173,0,98,0.8771144723887945
2021-08-08,CF,Central African Republic,53,11226,1,99,0.8818813468733298
2021-08-15,CF,Central African Republic,36,11262,0,99,0.8790623335109218
2021-08-22,CF,Central African Republic,9,11271,0,99,0.8783603939313283
2021-08-29,CF,Central African Republic,35,11306,1,100,0.8844861135680169
2021-09-05,CF,Central African Republic,3,11309,0,100,0.8842514811212309
2021-09-12,CF,Central African Republic,22,11331,0,100,0.8825346394845998
2021-09-19,CF,Central African Republic,28,11359,0,100,0.8803591865481117
2021-09-26,CF,Central African Republic,16,11375,0,100,0.8791208791208791
2021-10-03,CF,Central African Republic,26,11401,0,100,0.8771160424524164
2021-10-10,CF,Central African Republic,67,11468,0,100,0.8719916288803629
2021-10-17,CF,Central African Republic,20,11488,0,100,0.8704735376044569
2021-10-24,CF,Central African Republic,49,11537,0,100,0.8667764583513913
2021-10-31,CF,Central African Republic,55,11592,0,100,0.862663906142167
2021-11-07,CF,Central African Republic,31,11623,0,100,0.8603630732168975
2021-11-14,CF,Central African Republic,43,11666,1,101,0.8657637579290245
2021-11-21,CF,Central African Republic,42,11708,0,101,0.8626580116159891
2021-11-28,CF,Central African Republic,34,11742,0,101,0.8601601090103901
2021-12-05,CF,Central African Republic,129,11871,0,101,0.8508129053997137
2021-12-12,CF,Central African Republic,90,11961,0,101,0.8444110024245465
2021-12-19,CF,Central African Republic,202,12163,0,101,0.830387239990134
2021-12-26,CF,Central African Republic,105,12268,0,101,0.8232800782523638
2022-01-02,CF,Central African Republic,248,12516,5,106,0.8469159475870884
2022-01-09,CF,Central African Republic,803,13319,2,108,0.8108716870635934
2022-01-16,CF,Central African Republic,435,13754,1,109,0.7924967282245164
2022-01-23,CF,Central African Republic,144,13898,1,110,0.7914807886026767
2022-01-30,CF,Central African Republic,125,14023,0,110,0.7844255865364044
2022-02-06,CF,Central African Republic,131,14154,1,111,0.7842306061890632
2022-02-13,CF,Central African Republic,53,14207,2,113,0.7953825578939959
2022-02-20,CF,Central African Republic,18,14225,0,113,0.7943760984182776
2022-02-27,CF,Central African Republic,95,14320,0,113,0.7891061452513967
2022-03-06,CF,Central African Republic,6,14326,0,113,0.7887756526595003
2022-03-13,CF,Central African Republic,8,14334,0,113,0.7883354262592438
2022-03-20,CF,Central African Republic,5,14339,0,113,0.7880605342074064
2022-03-27,CF,Central African Republic,12,14351,0,113,0.7874015748031495
2022-04-03,CF,Central African Republic,1,14352,0,113,0.7873467112597548
2022-04-10,CF,Central African Republic,2,14354,0,113,0.7872370071060332
2022-04-17,CF,Central African Republic,0,14354,0,113,0.7872370071060332
2022-04-24,CF,Central African Republic,0,14354,0,113,0.7872370071060332
2022-05-01,CF,Central African Republic,4,14358,0,113,0.7870176904861401
2022-05-08,CF,Central African Republic,0,14358,0,113,0.7870176904861401
2022-05-15,CF,Central African Republic,11,14369,0,113,0.7864151993875705
2022-05-22,CF,Central African Republic,2,14371,0,113,0.7863057546447708
2022-05-29,CF,Central African Republic,0,14371,0,113,0.7863057546447708
2022-06-05,CF,Central African Republic,0,14371,0,113,0.7863057546447708
2022-06-12,CF,Central African Republic,0,14371,0,113,0.7863057546447708
2022-06-19,CF,Central African Republic,215,14586,0,113,0.7747154805978336
2022-06-26,CF,Central African Republic,76,14662,0,113,0.7706997681080343
2022-07-03,CF,Central African Republic,38,14700,0,113,0.7687074829931972
2022-07-10,CF,Central African Republic,33,14733,0,113,0.7669856784090138
2022-07-17,CF,Central African Republic,16,14749,0,113,0.7661536375347482
2022-07-24,CF,Central African Republic,21,14770,0,113,0.7650643195666892
2022-07-31,CF,Central African Republic,11,14781,0,113,0.7644949597456194
2022-08-07,CF,Central African Republic,21,14802,0,113,0.7634103499527092
2022-08-14,CF,Central African Republic,33,14835,0,113,0.7617121671722279
2022-08-21,CF,Central African Republic,35,14870,0,113,0.7599193006052454
2022-08-28,CF,Central African Republic,12,14882,0,113,0.7593065448192448
2022-09-04,CF,Central African Republic,6,14888,0,113,0.7590005373455132
2022-09-11,CF,Central African Republic,21,14909,0,113,0.7579314508015292
2022-09-18,CF,Central African Republic,3,14912,0,113,0.7577789699570815
2022-09-25,CF,Central African Republic,23,14935,0,113,0.7566119852695011
2022-10-02,CF,Central African Republic,21,14956,0,113,0.7555496121957742
2022-10-09,CF,Central African Republic,124,15080,0,113,0.7493368700265253
2022-10-16,CF,Central African Republic,96,15176,0,113,0.7445967316816026
2022-10-23,CF,Central African Republic,83,15259,0,113,0.7405465626843175
2022-10-30,CF,Central African Republic,32,15291,0,113,0.7389967955006213
2022-11-06,CF,Central African Republic,5,15296,0,113,0.738755230125523
2022-11-13,CF,Central African Republic,22,15318,0,113,0.7376942159550856
2022-11-20,CF,Central African Republic,6,15324,0,113,0.7374053771861132
2022-11-27,CF,Central African Republic,4,15328,0,113,0.7372129436325678
2022-12-04,CF,Central African Republic,2,15330,0,113,0.7371167645140249
2022-12-11,CF,Central African Republic,15,15345,0,113,0.736396220267188
2022-12-18,CF,Central African Republic,11,15356,0,113,0.7358687158114092
2022-12-25,CF,Central African Republic,4,15360,0,113,0.7356770833333334
2023-01-01,CF,Central African Republic,0,15360,0,113,0.7356770833333334
2023-01-08,CF,Central African Republic,4,15364,0,113,0.7354855506378547
2023-01-15,CF,Central African Republic,2,15366,0,113,0.7353898216842379
2023-01-22,CF,Central African Republic,1,15367,0,113,0.7353419665517017
2023-01-29,CF,Central African Republic,0,15367,0,113,0.7353419665517017
2023-02-05,CF,Central African Republic,0,15367,0,113,0.7353419665517017
2023-02-12,CF,Central African Republic,0,15367,0,113,0.7353419665517017
2023-02-19,CF,Central African Republic,0,15367,0,113,0.7353419665517017
2023-02-26,CF,Central African Republic,0,15367,0,113,0.7353419665517017
2023-03-05,CF,Central African Republic,0,15367,0,113,0.7353419665517017
2023-03-12,CF,Central African Republic,0,15367,0,113,0.7353419665517017
2023-03-19,CF,Central African Republic,0,15367,0,113,0.7353419665517017
2023-03-26,CF,Central African Republic,0,15367,0,113,0.7353419665517017
2023-04-02,CF,Central African Republic,0,15367,0,113,0.7353419665517017
2023-04-09,CF,Central African Republic,0,15367,0,113,0.7353419665517017
2023-04-16,CF,Central African Republic,0,15367,0,113,0.7353419665517017
2023-04-23,CF,Central African Republic,0,15367,0,113,0.7353419665517017
2023-04-30,CF,Central African Republic,0,15367,0,113,0.7353419665517017
2023-05-07,CF,Central African Republic,0,15367,0,113,0.7353419665517017
2023-05-14,CF,Central African Republic,0,15367,0,113,0.7353419665517017
2023-05-21,CF,Central African Republic,0,15367,0,113,0.7353419665517017
2023-05-28,CF,Central African Republic,0,15367,0,113,0.7353419665517017
2023-06-04,CF,Central African Republic,0,15367,0,113,0.7353419665517017
2023-06-11,CF,Central African Republic,0,15367,0,113,0.7353419665517017
2023-06-18,CF,Central African Republic,0,15367,0,113,0.7353419665517017
2023-06-25,CF,Central African Republic,0,15367,0,113,0.7353419665517017
2023-07-02,CF,Central African Republic,0,15367,0,113,0.7353419665517017
2023-07-09,CF,Central African Republic,0,15367,0,113,0.7353419665517017
2023-07-16,CF,Central African Republic,0,15367,0,113,0.7353419665517017
2023-07-23,CF,Central African Republic,0,15367,0,113,0.7353419665517017
2023-07-30,CF,Central African Republic,0,15367,0,113,0.7353419665517017
2023-08-06,CF,Central African Republic,0,15367,0,113,0.7353419665517017
2023-08-13,CF,Central African Republic,0,15367,0,113,0.7353419665517017
2023-08-20,CF,Central African Republic,0,15367,0,113,0.7353419665517017
2023-08-27,CF,Central African Republic,0,15367,0,113,0.7353419665517017
2023-09-03,CF,Central African Republic,0,15367,0,113,0.7353419665517017
2023-09-10,CF,Central African Republic,0,15367,0,113,0.7353419665517017
2023-09-17,CF,Central African Republic,0,15367,0,113,0.7353419665517017
2023-09-24,CF,Central African Republic,0,15367,0,113,0.7353419665517017
2023-10-01,CF,Central African Republic,0,15367,0,113,0.7353419665517017
2023-10-08,CF,Central African Republic,0,15367,0,113,0.7353419665517017
2023-10-15,CF,Central African Republic,0,15367,0,113,0.7353419665517017
2023-10-22,CF,Central African Republic,0,15367,0,113,0.7353419665517017
2023-10-29,CF,Central African Republic,0,15367,0,113,0.7353419665517017
2023-11-05,CF,Central African Republic,0,15367,0,113,0.7353419665517017
2023-11-12,CF,Central African Republic,0,15367,0,113,0.7353419665517017
2023-11-19,CF,Central African Republic,0,15367,0,113,0.7353419665517017
2023-11-26,CF,Central African Republic,43,15410,0,113,0.7332900713822194
2023-12-03,CF,Central African Republic,30,15440,0,113,0.7318652849740932
2023-12-10,CF,Central African Republic,0,15440,0,113,0.7318652849740932
2023-12-17,CF,Central African Republic,0,15440,0,113,0.7318652849740932
2023-12-24,CF,Central African Republic,0,15440,0,113,0.7318652849740932
2023-12-31,CF,Central African Republic,0,15440,0,113,0.7318652849740932
2024-01-07,CF,Central African Republic,0,15440,0,113,0.7318652849740932
2024-01-14,CF,Central African Republic,0,15440,0,113,0.7318652849740932
2020-03-29,CL,Chile,1372,1909,6,6,0.3143006809848088
2020-04-05,CL,Chile,2252,4161,21,27,0.6488824801730353
2022-05-15,CN,China,414077,1750942,192,15642,0.8933476951263949
2022-05-22,CN,China,554051,2304993,347,15989,0.693668050184968
2022-05-29,CN,China,573340,2878333,669,16658,0.5787377624479169
2022-06-05,CN,China,513969,3392302,1044,17702,0.5218285400297497
2022-06-12,CN,China,489982,3882284,1194,18896,0.48672379454980624
2022-06-19,CN,China,406469,4288753,1091,19987,0.46603290047246837
2022-06-26,CN,China,323183,4611936,982,20969,0.45466806130874327
2022-07-03,CN,China,230021,4841957,689,21658,0.44729847869363565
2022-07-10,CN,China,223915,5065872,709,22367,0.44152319679612906
2022-07-17,CN,China,197555,5263427,528,22895,0.43498275933151537
2022-07-24,CN,China,180690,5444117,458,23353,0.42895845184811426
2022-07-31,CN,China,172003,5616120,351,23704,0.42207075347392864
2022-08-07,CN,China,163340,5779460,330,24034,0.4158520000138421
2022-08-14,CN,China,166696,5946156,224,24258,0.40796104239444775
2022-08-21,CN,China,172424,6118580,241,24499,0.4004033615642845
2022-08-28,CN,China,194464,6313044,267,24766,0.3922988656502315
2022-09-04,CN,China,238044,6551088,292,25058,0.38250134939417696
2022-09-11,CN,China,263288,6814376,296,25354,0.372066349141873
2022-09-18,CN,China,297693,7112069,358,25712,0.3615263012774482
2022-09-25,CN,China,292476,7404545,532,26244,0.35443096098409826
2022-10-02,CN,China,303092,7707637,365,26609,0.34522902414838685
2022-10-09,CN,China,333830,8041467,435,27044,0.3363067957625145
2022-10-16,CN,China,328910,8370377,427,27471,0.3281931028913035
2022-10-23,CN,China,285348,8655725,479,27950,0.3229076709345549
2022-10-30,CN,China,257994,8913719,510,28460,0.3192831185277436
2022-11-06,CN,China,219102,9132821,479,28939,0.3168681396471036
2022-11-13,CN,China,171745,9304566,431,29370,0.3156514769200412
2022-11-20,CN,China,158813,9463379,468,29838,0.31529964085766826
2022-11-27,CN,China,144205,9607584,354,30192,0.31425174112451165
2022-12-04,CN,China,146141,9753725,375,30567,0.3133879620350174
2022-12-11,CN,China,1117898,10871623,871,31438,0.2891748545732316
2022-12-18,CN,China,11098550,21970173,1708,33146,0.15086817932658064
2022-12-25,CN,China,40475477,62445650,5849,38995,0.062446303305354334
2023-01-01,CN,China,24644876,87090526,17893,56888,0.06532053785046608
2023-01-08,CN,China,8061762,95152288,12991,69879,0.07343911688177167
2023-01-15,CN,China,2361571,97513859,0,69879,0.07166058313823884
2023-01-22,CN,China,755183,98269042,0,69879,0.07110988219463868
2023-01-29,CN,China,175542,98444584,0,69879,0.0709830822181137
2023-02-05,CN,China,192969,98637553,47687,117566,0.11918989920603566
2023-02-12,CN,China,148174,98785727,1360,118926,0.1203878369999747
2023-02-19,CN,China,118748,98904475,537,119463,0.12078624349403806
2023-02-26,CN,China,77670,98982145,358,119821,0.12105314549406866
2023-03-05,CN,China,84790,99066935,360,120181,0.12131292847608538
2023-03-12,CN,China,92268,99159203,329,120510,0.12153183603139689
2023-03-19,CN,China,65301,99224504,265,120775,0.12171892539770217
2023-03-26,CN,China,13602,99238106,119,120894,0.12182215569491019
2023-04-02,CN,China,1060,99239166,3,120897,0.12182387747998608
2023-04-09,CN,China,1228,99240394,8,120905,0.12183043126572028
2023-04-16,CN,China,1699,99242093,7,120912,0.12183539901763256
2023-04-23,CN,China,2206,99244299,11,120923,0.12184377462326576
2023-04-30,CN,China,3082,99247381,38,120961,0.12187827908526877
2023-05-07,CN,China,3736,99251117,54,121015,0.12192809880416762
2023-05-14,CN,China,4440,99255557,58,121073,0.12198107960846968
2023-05-21,CN,China,4437,99259994,71,121144,0.12204715627929616
2023-05-28,CN,China,6466,99266460,91,121235,0.12213087884870681
2023-06-04,CN,China,5030,99271490,1,121236,0.12212569792193106
2023-06-11,CN,China,6956,99278446,154,121390,0.12227226038570346
2023-06-18,CN,China,4555,99283001,0,121390,0.12226665066258423
2023-06-25,CN,China,2437,99285438,75,121465,0.12233918935826218
2023-07-02,CN,China,3878,99289316,25,121490,0.12235959002880029
2023-07-09,CN,China,2733,99292049,25,121515,0.12238140034757465
2023-07-16,CN,China,2666,99294715,21,121536,0.12239926364661
2023-07-23,CN,China,2445,99297160,0,121536,0.12239624980210914
2023-07-30,CN,China,2541,99299701,27,121563,0.12242030819408006
2023-08-06,CN,China,1954,99301655,84,121647,0.12250249001388748
2023-08-13,CN,China,964,99302619,24,121671,0.12252546934336142
2023-08-20,CN,China,1463,99304082,0,121671,0.12252366423366162
2023-08-27,CN,China,1587,99305669,0,121671,0.12252170618779075
2023-09-03,CN,China,1647,99307316,8,121679,0.12252772998114257
2023-09-10,CN,China,1527,99308843,23,121702,0.12254900603363188
2023-09-17,CN,China,1025,99309868,12,121714,0.12255982456849102
2023-09-24,CN,China,1152,99311020,8,121722,0.12256645838498084
2023-10-01,CN,China,2551,99313571,0,121722,0.12256331010391319
2023-10-08,CN,China,1555,99315126,75,121797,0.12263690829934605
2023-10-15,CN,China,1372,99316498,12,121809,0.12264729672606862
2023-10-22,CN,China,1070,99317568,14,121823,0.12266007157968266
2023-10-29,CN,China,805,99318373,12,121835,0.12267115974604215
2023-11-05,CN,China,636,99319009,32,121867,0.12270259361931411
2023-11-12,CN,China,559,99319568,6,121873,0.1227079441183232
2023-11-19,CN,China,467,99320035,1,121874,0.12270837399523671
2023-11-26,CN,China,390,99320425,3,121877,0.12271091268487827
2023-12-03,CN,China,420,99320845,9,121886,0.12271945531675651
2023-12-10,CN,China,397,99321242,2,121888,0.12272097845896852
2023-12-17,CN,China,395,99321637,0,121888,0.12272049040029415
2023-12-24,CN,China,505,99322142,1,121889,0.12272087325704273
2023-12-31,CN,China,585,99322727,4,121893,0.12272417772017073
2024-01-07,CN,China,1029,99323756,15,121908,0.1227380084176438
2024-01-14,CN,China,1352,99325108,0,121908,0.12273633772439492
2020-03-29,CO,Colombia,527,723,6,6,0.8298755186721992
2022-04-24,CK,Cook Islands,1039,4727,1,1,0.02115506663845991
2022-05-01,CK,Cook Islands,343,5070,0,1,0.01972386587771203
2022-05-08,CK,Cook Islands,197,5267,0,1,0.018986140117714066
2022-05-15,CK,Cook Islands,148,5415,0,1,0.018467220683287162
2022-05-22,CK,Cook Islands,128,5543,0,1,0.018040772145047807
2022-05-29,CK,Cook Islands,93,5636,0,1,0.017743080198722498
2022-06-05,CK,Cook Islands,61,5697,0,1,0.017553098121818503
2022-06-12,CK,Cook Islands,20,5717,0,1,0.01749169144656288
2022-06-19,CK,Cook Islands,10,5727,0,1,0.01746114894360049
2022-06-26,CK,Cook Islands,41,5768,0,1,0.017337031900138695
2022-07-03,CK,Cook Islands,6,5774,0,1,0.017319016279875303
2022-07-10,CK,Cook Islands,20,5794,0,1,0.01725923369002416
2022-07-17,CK,Cook Islands,20,5814,0,1,0.01719986240110079
2022-07-24,CK,Cook Islands,33,5847,0,1,0.017102787754403968
2022-07-31,CK,Cook Islands,195,6042,0,1,0.0165508109897385
2022-08-07,CK,Cook Islands,87,6129,0,1,0.01631587534671235
2022-08-14,CK,Cook Islands,80,6209,0,1,0.016105653084232566
2022-08-21,CK,Cook Islands,56,6265,0,1,0.01596169193934557
2022-08-28,CK,Cook Islands,0,6265,0,1,0.01596169193934557
2022-09-04,CK,Cook Islands,108,6373,0,1,0.01569119723834929
2022-09-11,CK,Cook Islands,13,6386,0,1,0.015659254619480114
2022-09-18,CK,Cook Islands,3,6389,0,1,0.015651901706057285
2022-09-25,CK,Cook Islands,0,6389,0,1,0.015651901706057285
2022-10-02,CK,Cook Islands,0,6389,0,1,0.015651901706057285
2022-10-09,CK,Cook Islands,0,6389,0,1,0.015651901706057285
2022-10-16,CK,Cook Islands,0,6389,0,1,0.015651901706057285
2022-10-23,CK,Cook Islands,0,6389,0,1,0.015651901706057285
2022-10-30,CK,Cook Islands,0,6389,0,1,0.015651901706057285
2022-11-06,CK,Cook Islands,0,6389,0,1,0.015651901706057285
2022-11-13,CK,Cook Islands,0,6389,0,1,0.015651901706057285
2022-11-20,CK,Cook Islands,0,6389,0,1,0.015651901706057285
2022-11-27,CK,Cook Islands,0,6389,0,1,0.015651901706057285
2022-12-04,CK,Cook Islands,0,6389,0,1,0.015651901706057285
2022-12-11,CK,Cook Islands,0,6389,0,1,0.015651901706057285
2022-12-18,CK,Cook Islands,0,6389,0,1,0.015651901706057285
2022-12-25,CK,Cook Islands,236,6625,0,1,0.01509433962264151
2023-01-01,CK,Cook Islands,85,6710,0,1,0.014903129657228018
2023-01-08,CK,Cook Islands,134,6844,0,1,0.014611338398597311
2023-01-15,CK,Cook Islands,108,6952,0,1,0.014384349827387802
2023-01-22,CK,Cook Islands,36,6988,0,1,0.014310246136233542
2023-01-29,CK,Cook Islands,11,6999,0,1,0.014287755393627661
2023-02-05,CK,Cook Islands,20,7019,1,2,0.028494087476848555
2023-02-12,CK,Cook Islands,3,7022,0,2,0.02848191398461977
2023-02-19,CK,Cook Islands,4,7026,0,2,0.02846569883290635
2023-02-26,CK,Cook Islands,2,7028,0,2,0.028457598178713718
2023-03-05,CK,Cook Islands,1,7029,0,2,0.028453549580310142
2023-03-12,CK,Cook Islands,3,7032,0,2,0.02844141069397042
2023-03-19,CK,Cook Islands,1,7033,0,2,0.028437366699843595
2023-03-26,CK,Cook Islands,4,7037,0,2,0.028421202216853774
2023-04-02,CK,Cook Islands,5,7042,0,2,0.028401022436807723
2023-04-09,CK,Cook Islands,8,7050,0,2,0.028368794326241134
2023-04-16,CK,Cook Islands,5,7055,0,2,0.028348688873139617
2023-04-23,CK,Cook Islands,4,7059,0,2,0.02833262501770789
2023-04-30,CK,Cook Islands,3,7062,0,2,0.02832058906825262
2023-05-07,CK,Cook Islands,5,7067,0,2,0.02830055186076129
2023-05-14,CK,Cook Islands,12,7079,0,2,0.028252578047746855
2023-05-21,CK,Cook Islands,27,7106,0,2,0.028145229383619477
2023-05-28,CK,Cook Islands,14,7120,0,2,0.02808988764044944
2023-06-04,CK,Cook Islands,8,7128,0,2,0.02805836139169473
2023-06-11,CK,Cook Islands,9,7137,0,2,0.028022978842650974
2023-06-18,CK,Cook Islands,5,7142,0,2,0.02800336040324839
2023-06-25,CK,Cook Islands,1,7143,0,2,0.027999440011199778
2023-07-02,CK,Cook Islands,1,7144,0,2,0.027995520716685332
2023-07-09,CK,Cook Islands,0,7144,0,2,0.027995520716685332
2023-07-16,CK,Cook Islands,3,7147,0,2,0.02798376941374003
2023-07-23,CK,Cook Islands,2,7149,0,2,0.027975940691005733
2023-07-30,CK,Cook Islands,2,7151,0,2,0.027968116347364007
2023-08-06,CK,Cook Islands,1,7152,0,2,0.02796420581655481
2023-08-13,CK,Cook Islands,0,7152,0,2,0.02796420581655481
2023-08-20,CK,Cook Islands,0,7152,0,2,0.02796420581655481
2023-08-27,CK,Cook Islands,0,7152,0,2,0.02796420581655481
2023-09-03,CK,Cook Islands,0,7152,0,2,0.02796420581655481
2023-09-10,CK,Cook Islands,0,7152,0,2,0.02796420581655481
2023-09-17,CK,Cook Islands,6,7158,0,2,0.02794076557697681
2023-09-24,CK,Cook Islands,0,7158,0,2,0.02794076557697681
2023-10-01,CK,Cook Islands,0,7158,0,2,0.02794076557697681
2023-10-08,CK,Cook Islands,0,7158,0,2,0.02794076557697681
2023-10-15,CK,Cook Islands,10,7168,0,2,0.027901785714285712
2023-10-22,CK,Cook Islands,0,7168,0,2,0.027901785714285712
2023-10-29,CK,Cook Islands,0,7168,0,2,0.027901785714285712
2023-11-05,CK,Cook Islands,0,7168,0,2,0.027901785714285712
2023-11-12,CK,Cook Islands,0,7168,0,2,0.027901785714285712
2023-11-19,CK,Cook Islands,4,7172,0,2,0.027886224205242612
2023-11-26,CK,Cook Islands,2,7174,0,2,0.027878449958182325
2023-12-03,CK,Cook Islands,0,7174,0,2,0.027878449958182325
2023-12-10,CK,Cook Islands,0,7174,0,2,0.027878449958182325
2023-12-17,CK,Cook Islands,0,7174,0,2,0.027878449958182325
2023-12-24,CK,Cook Islands,29,7203,0,2,0.027766208524226017
2023-12-31,CK,Cook Islands,0,7203,0,2,0.027766208524226017
2024-01-07,CK,Cook Islands,0,7203,0,2,0.027766208524226017
2024-01-14,CK,Cook Islands,0,7203,0,2,0.027766208524226017
2020-03-29,CR,Costa Rica,150,263,0,2,0.7604562737642585
2020-04-05,CR,Costa Rica,153,416,0,2,0.4807692307692308
2020-04-12,CR,Costa Rica,142,558,1,3,0.5376344086021506
2020-04-19,CR,Costa Rica,91,649,1,4,0.6163328197226503
2020-04-26,CR,Costa Rica,38,687,2,6,0.8733624454148471
2020-05-03,CR,Costa Rica,38,725,0,6,0.8275862068965517
2020-05-10,CR,Costa Rica,48,773,0,6,0.7761966364812419
2020-05-17,CR,Costa Rica,70,843,2,8,0.9489916963226572
2020-05-31,CR,Costa Rica,111,1022,0,10,0.9784735812133072
2020-06-07,CR,Costa Rica,206,1228,0,10,0.8143322475570033
2020-06-14,CR,Costa Rica,384,1612,2,12,0.7444168734491315
2020-06-21,CR,Costa Rica,446,2058,0,12,0.5830903790087464
2020-06-28,CR,Costa Rica,778,2836,0,12,0.4231311706629055
2020-07-05,CR,Costa Rica,1475,4311,6,18,0.41753653444676403
2020-07-12,CR,Costa Rica,2534,6845,8,26,0.3798392987582177
2020-07-19,CR,Costa Rica,3124,9969,21,47,0.4714615307453105
2020-07-26,CR,Costa Rica,3700,13669,40,87,0.6364766991001536
2020-08-02,CR,Costa Rica,4151,17820,63,150,0.8417508417508417
2020-08-09,CR,Costa Rica,4261,22081,68,218,0.9872741270775779
2022-04-03,CR,Costa Rica,4642,839368,42,8308,0.9897923199359517
2022-04-10,CR,Costa Rica,4116,843484,35,8343,0.989111826661798
2022-04-17,CR,Costa Rica,2658,846142,22,8365,0.9886047495574029
2022-04-24,CR,Costa Rica,1642,847784,18,8383,0.9888131882649355
2022-05-01,CR,Costa Rica,4290,852074,22,8405,0.9864166727303028
2022-05-08,CR,Costa Rica,5216,857290,16,8421,0.9822813750306197
2022-05-15,CR,Costa Rica,8874,866164,23,8444,0.9748731187165479
2022-05-22,CR,Costa Rica,11369,877533,28,8472,0.965433778558755
2022-05-29,CR,Costa Rica,13505,891038,23,8495,0.9533824595584026
2022-06-05,CR,Costa Rica,13896,904934,30,8525,0.9420576528232999
2022-06-12,CR,Costa Rica,14938,919872,8,8533,0.9276290614346344
2022-06-19,CR,Costa Rica,16554,936426,0,8533,0.9112305724104199
2022-06-26,CR,Costa Rica,17324,953750,26,8559,0.8974049803407602
2022-07-03,CR,Costa Rica,18010,971760,38,8597,0.8846834609368569
2022-07-10,CR,Costa Rica,20357,992117,27,8624,0.869252316007084
2022-07-17,CR,Costa Rica,17220,1009337,29,8653,0.857295432546315
2022-07-24,CR,Costa Rica,19038,1028375,37,8690,0.8450224869332685
2022-07-31,CR,Costa Rica,16010,1044385,50,8740,0.8368561402164911
2022-08-07,CR,Costa Rica,13310,1057695,34,8774,0.8295397066262012
2022-08-14,CR,Costa Rica,11467,1069162,26,8800,0.8230745200446705
2022-08-21,CR,Costa Rica,10663,1079825,28,8828,0.817539879147084
2022-08-28,CR,Costa Rica,8891,1088716,28,8856,0.8134352760499524
2022-09-04,CR,Costa Rica,8913,1097629,31,8887,0.8096542638724012
2022-09-11,CR,Costa Rica,8163,1105792,26,8913,0.8060286202106726
2022-09-18,CR,Costa Rica,6177,1111969,20,8933,0.8033497336706328
2022-09-25,CR,Costa Rica,6020,1117989,20,8953,0.8008128881411176
2022-10-02,CR,Costa Rica,5012,1123001,13,8966,0.7983964395401252
2022-10-09,CR,Costa Rica,4601,1127602,8,8974,0.7958481804750258
2022-10-16,CR,Costa Rica,2966,1130568,8,8982,0.7944679134735814
2022-10-23,CR,Costa Rica,2528,1133096,8,8990,0.7934014417136765
2022-10-30,CR,Costa Rica,2617,1135713,9,8999,0.7923656768919614
2022-11-06,CR,Costa Rica,2703,1138416,10,9009,0.7913627355905046
2022-11-13,CR,Costa Rica,2448,1140864,10,9019,0.790541203859531
2022-11-20,CR,Costa Rica,2733,1143597,12,9031,0.7897012671421838
2022-11-27,CR,Costa Rica,2538,1146135,7,9038,0.788563301879796
2022-12-04,CR,Costa Rica,2779,1148914,8,9046,0.787352230018957
2022-12-11,CR,Costa Rica,3552,1152466,5,9051,0.7853593945504682
2022-12-18,CR,Costa Rica,4031,1156497,8,9059,0.7833137483279247
2022-12-25,CR,Costa Rica,5190,1161687,13,9072,0.7809332462186458
2023-01-01,CR,Costa Rica,5155,1166842,13,9085,0.7785972736668718
2023-01-08,CR,Costa Rica,4960,1171802,19,9104,0.776923063794054
2023-01-15,CR,Costa Rica,5712,1177514,19,9123,0.7747678583863971
2023-01-22,CR,Costa Rica,4857,1182371,19,9142,0.7731921706469459
2023-01-29,CR,Costa Rica,3805,1186176,16,9158,0.7720608071652099
2023-02-05,CR,Costa Rica,4201,1190377,23,9181,0.7712682620715958
2023-02-12,CR,Costa Rica,4207,1194584,14,9195,0.7697240210818159
2023-02-19,CR,Costa Rica,4471,1199055,19,9214,0.7684384786352586
2023-02-26,CR,Costa Rica,5109,1204164,16,9230,0.7665068877661182
2023-03-05,CR,Costa Rica,5561,1209725,15,9245,0.7642232738845605
2023-03-12,CR,Costa Rica,4926,1214651,21,9266,0.7628528688487475
2023-03-19,CR,Costa Rica,4423,1219074,25,9291,0.7621358506538569
2023-03-26,CR,Costa Rica,3587,1222661,18,9309,0.7613721219536732
2023-04-02,CR,Costa Rica,3654,1226315,17,9326,0.7604897599719486
2023-04-09,CR,Costa Rica,0,1226315,0,9326,0.7604897599719486
2023-04-16,CR,Costa Rica,0,1226315,0,9326,0.7604897599719486
2023-04-23,CR,Costa Rica,1231,1227546,13,9339,0.7607861538386341
2023-04-30,CR,Costa Rica,1113,1228659,12,9351,0.7610736583543521
2023-05-07,CR,Costa Rica,928,1229587,11,9362,0.7613938663957898
2023-05-14,CR,Costa Rica,965,1230552,4,9366,0.7611218380044078
2023-05-21,CR,Costa Rica,0,1230552,0,9366,0.7611218380044078
2023-05-28,CR,Costa Rica,7,1230559,0,9366,0.761117508384401
2023-06-04,CR,Costa Rica,8,1230567,0,9366,0.7611125603075655
2023-06-11,CR,Costa Rica,10,1230577,0,9366,0.7611063753019924
2023-06-18,CR,Costa Rica,16,1230593,1,9367,0.7611777411378091
2023-06-25,CR,Costa Rica,24,1230617,0,9367,0.7611628963357405
2023-07-02,CR,Costa Rica,12,1230629,0,9367,0.7611554741518362
2023-07-09,CR,Costa Rica,3,1230632,0,9367,0.7611536186284771
2023-07-16,CR,Costa Rica,14,1230646,0,9367,0.7611449596390839
2023-07-23,CR,Costa Rica,2,1230648,1,9368,0.7612249806605951
2023-07-30,CR,Costa Rica,4,1230652,0,9368,0.7612225064437388
2023-08-06,CR,Costa Rica,1,1230653,0,9368,0.7612218878920378
2023-08-13,CR,Costa Rica,0,1230653,0,9368,0.7612218878920378
2023-08-20,CR,Costa Rica,0,1230653,0,9368,0.7612218878920378
2023-08-27,CR,Costa Rica,0,1230653,0,9368,0.7612218878920378
2023-09-03,CR,Costa Rica,0,1230653,0,9368,0.7612218878920378
2023-09-10,CR,Costa Rica,0,1230653,0,9368,0.7612218878920378
2023-09-17,CR,Costa Rica,0,1230653,0,9368,0.7612218878920378
2023-09-24,CR,Costa Rica,0,1230653,0,9368,0.7612218878920378
2023-10-01,CR,Costa Rica,0,1230653,0,9368,0.7612218878920378
2023-10-08,CR,Costa Rica,0,1230653,0,9368,0.7612218878920378
2023-10-15,CR,Costa Rica,0,1230653,0,9368,0.7612218878920378
2023-10-22,CR,Costa Rica,0,1230653,0,9368,0.7612218878920378
2023-10-29,CR,Costa Rica,0,1230653,0,9368,0.7612218878920378
2023-11-05,CR,Costa Rica,0,1230653,0,9368,0.7612218878920378
2023-11-12,CR,Costa Rica,0,1230653,0,9368,0.7612218878920378
2023-11-19,CR,Costa Rica,0,1230653,0,9368,0.7612218878920378
2023-11-26,CR,Costa Rica,0,1230653,0,9368,0.7612218878920378
2023-12-03,CR,Costa Rica,0,1230653,0,9368,0.7612218878920378
2023-12-10,CR,Costa Rica,0,1230653,0,9368,0.7612218878920378
2023-12-17,CR,Costa Rica,0,1230653,0,9368,0.7612218878920378
2023-12-24,CR,Costa Rica,0,1230653,0,9368,0.7612218878920378
2023-12-31,CR,Costa Rica,0,1230653,0,9368,0.7612218878920378
2024-01-07,CR,Costa Rica,0,1230653,0,9368,0.7612218878920378
2024-01-14,CR,Costa Rica,0,1230653,0,9368,0.7612218878920378
2020-04-12,CI,Côte d'Ivoire,290,628,1,5,0.7961783439490446
2020-06-14,CI,Côte d'Ivoire,1291,4848,9,46,0.9488448844884488
2020-06-21,CI,Côte d'Ivoire,2428,7276,7,53,0.7284222100054976
2020-06-28,CI,Côte d'Ivoire,1668,8944,14,67,0.7491055456171735
2020-07-05,CI,Côte d'Ivoire,1300,10244,6,73,0.712612260835611
2020-07-12,CI,Côte d'Ivoire,2199,12443,10,83,0.6670417101985052
2020-07-19,CI,Côte d'Ivoire,1469,13912,9,92,0.6612995974698103
2020-07-26,CI,Côte d'Ivoire,1582,15494,3,95,0.6131405705434362
2020-08-02,CI,Côte d'Ivoire,615,16109,8,103,0.6393941275063629
2020-08-09,CI,Côte d'Ivoire,627,16736,2,105,0.6273900573613767
2020-08-16,CI,Côte d'Ivoire,378,17114,4,109,0.6369054575201589
2020-08-23,CI,Côte d'Ivoire,376,17490,5,114,0.6518010291595198
2020-08-30,CI,Côte d'Ivoire,519,18009,2,116,0.644122383252818
2020-09-06,CI,Côte d'Ivoire,579,18588,4,120,0.6455777921239509
2020-09-13,CI,Côte d'Ivoire,399,18987,1,121,0.6372781376731448
2020-09-20,CI,Côte d'Ivoire,282,19269,0,121,0.6279516321552753
2020-09-27,CI,Côte d'Ivoire,331,19600,0,121,0.6173469387755103
2020-10-04,CI,Côte d'Ivoire,249,19849,0,121,0.6096024988664416
2020-10-11,CI,Côte d'Ivoire,279,20128,0,121,0.6011526232114467
2020-10-18,CI,Côte d'Ivoire,173,20301,1,122,0.6009556179498547
2020-10-25,CI,Côte d'Ivoire,128,20429,0,122,0.597190268735621
2020-11-01,CI,Côte d'Ivoire,287,20716,5,127,0.6130527128789341
2020-11-08,CI,Côte d'Ivoire,141,20857,0,127,0.6089082801936999
2020-11-15,CI,Côte d'Ivoire,132,20989,2,129,0.6146076516270428
2020-11-22,CI,Côte d'Ivoire,181,21170,1,130,0.6140765233821445
2020-11-29,CI,Côte d'Ivoire,135,21305,2,132,0.6195728702182587
2020-12-06,CI,Côte d'Ivoire,180,21485,1,133,0.6190365371189201
2020-12-13,CI,Côte d'Ivoire,154,21639,1,134,0.6192522759831784
2020-12-20,CI,Côte d'Ivoire,133,21772,0,134,0.6154694102516994
2020-12-27,CI,Côte d'Ivoire,309,22081,0,134,0.6068565735247498
2021-01-03,CI,Côte d'Ivoire,169,22250,4,138,0.6202247191011235
2021-01-10,CI,Côte d'Ivoire,1232,23482,2,140,0.5962013457116089
2021-01-17,CI,Côte d'Ivoire,1546,25028,2,142,0.5673645517020937
2021-01-24,CI,Côte d'Ivoire,1584,26612,4,146,0.5486246805952202
2021-01-31,CI,Côte d'Ivoire,1566,28178,7,153,0.5429767904038612
2021-02-07,CI,Côte d'Ivoire,1389,29567,10,163,0.5512902898501708
2021-02-14,CI,Côte d'Ivoire,1317,30884,11,174,0.5633985235073178
2021-02-21,CI,Côte d'Ivoire,1030,31914,11,185,0.5796828977878047
2021-02-28,CI,Côte d'Ivoire,717,32631,7,192,0.5883975360853176
2021-03-07,CI,Côte d'Ivoire,2304,34935,8,200,0.5724917704308
2021-03-14,CI,Côte d'Ivoire,2369,37304,11,211,0.5656229894917435
2021-03-21,CI,Côte d'Ivoire,2609,39913,6,217,0.5436825094580713
2021-03-28,CI,Côte d'Ivoire,2555,42468,12,229,0.5392295375341434
2021-04-04,CI,Côte d'Ivoire,1858,44326,18,247,0.5572350313585707
2021-04-11,CI,Côte d'Ivoire,819,45145,14,261,0.5781371137446008
2021-04-18,CI,Côte d'Ivoire,374,45519,13,274,0.6019464399481536
2021-04-25,CI,Côte d'Ivoire,301,45820,7,281,0.6132693147097338
2021-05-02,CI,Côte d'Ivoire,294,46114,5,286,0.620202107819751
2021-05-09,CI,Côte d'Ivoire,271,46385,5,291,0.6273579821062844
2021-05-16,CI,Côte d'Ivoire,234,46619,6,297,0.6370793024303396
2021-05-23,CI,Côte d'Ivoire,323,46942,1,298,0.6348259554343658
2021-05-30,CI,Côte d'Ivoire,253,47195,3,301,0.6377794257866299
2021-06-06,CI,Côte d'Ivoire,281,47476,5,306,0.6445361867048613
2021-06-13,CI,Côte d'Ivoire,186,47662,0,306,0.64202089715077
2021-06-20,CI,Côte d'Ivoire,369,48031,1,307,0.6391705356956965
2021-06-27,CI,Côte d'Ivoire,145,48176,4,311,0.6455496512786449
2021-07-04,CI,Côte d'Ivoire,337,48513,4,315,0.6493104940943665
2021-07-11,CI,Côte d'Ivoire,263,48776,3,318,0.6519599803181892
2021-07-18,CI,Côte d'Ivoire,349,49125,2,320,0.6513994910941475
2021-07-25,CI,Côte d'Ivoire,429,49554,4,324,0.6538321830730113
2021-08-01,CI,Côte d'Ivoire,581,50135,5,329,0.6562281839034606
2021-08-08,CI,Côte d'Ivoire,1063,51198,12,341,0.6660416422516504
2021-08-15,CI,Côte d'Ivoire,1004,52202,18,359,0.6877131144400597
2021-08-22,CI,Côte d'Ivoire,1254,53456,30,389,0.7277012870398084
2021-08-29,CI,Côte d'Ivoire,1400,54856,35,424,0.7729327694326965
2021-09-05,CI,Côte d'Ivoire,1879,56735,40,464,0.8178373138274434
2021-09-12,CI,Côte d'Ivoire,1049,57784,42,506,0.8756749273155199
2021-09-19,CI,Côte d'Ivoire,1105,58889,55,561,0.9526397120005433
2022-01-09,CI,Côte d'Ivoire,4917,76732,15,733,0.9552728978783297
2022-01-16,CI,Côte d'Ivoire,2356,79088,20,753,0.9521039854339469
2022-01-23,CI,Côte d'Ivoire,1026,80114,25,778,0.9711161594727513
2022-01-30,CI,Côte d'Ivoire,509,80623,6,784,0.9724272230008806
2022-02-06,CI,Côte d'Ivoire,278,80901,2,786,0.9715578299402974
2022-02-13,CI,Côte d'Ivoire,217,81118,3,789,0.9726571167928204
2022-02-20,CI,Côte d'Ivoire,228,81346,2,791,0.9723895458903941
2022-02-27,CI,Côte d'Ivoire,121,81467,1,792,0.9721727816170965
2022-03-06,CI,Côte d'Ivoire,79,81546,3,795,0.9749098668236332
2022-03-13,CI,Côte d'Ivoire,31,81577,0,795,0.9745393922306533
2022-03-20,CI,Côte d'Ivoire,78,81655,1,796,0.9748331394280816
2022-03-27,CI,Côte d'Ivoire,42,81697,0,796,0.9743319828145464
2022-04-03,CI,Côte d'Ivoire,64,81761,0,796,0.9735693056591773
2022-04-10,CI,Côte d'Ivoire,53,81814,0,796,0.9729386168626397
2022-04-17,CI,Côte d'Ivoire,43,81857,1,797,0.9736491686721965
2022-04-24,CI,Côte d'Ivoire,30,81887,2,799,0.9757348541282499
2022-05-01,CI,Côte d'Ivoire,43,81930,0,799,0.9752227511290126
2022-05-08,CI,Côte d'Ivoire,40,81970,0,799,0.9747468586068073
2022-05-15,CI,Côte d'Ivoire,22,81992,0,799,0.9744853156405503
2022-05-22,CI,Côte d'Ivoire,65,82057,0,799,0.9737133943478313
2022-05-29,CI,Côte d'Ivoire,126,82183,0,799,0.9722205322268594
2022-06-05,CI,Côte d'Ivoire,97,82280,0,799,0.9710743801652892
2022-06-12,CI,Côte d'Ivoire,187,82467,0,799,0.968872397443826
2022-06-19,CI,Côte d'Ivoire,192,82659,2,801,0.969041483685987
2022-06-26,CI,Côte d'Ivoire,340,82999,4,805,0.969891203508476
2022-07-03,CI,Côte d'Ivoire,638,83637,0,805,0.9624926766861556
2022-07-10,CI,Côte d'Ivoire,405,84042,0,805,0.9578544061302682
2022-07-17,CI,Côte d'Ivoire,459,84501,1,806,0.9538348658595757
2022-07-24,CI,Côte d'Ivoire,449,84950,3,809,0.9523248969982343
2022-07-31,CI,Côte d'Ivoire,356,85306,2,811,0.950695144538485
2022-08-07,CI,Côte d'Ivoire,406,85712,0,811,0.9461918984506255
2022-08-14,CI,Côte d'Ivoire,380,86092,4,815,0.9466617107280584
2022-08-21,CI,Côte d'Ivoire,348,86440,2,817,0.9451642757982416
2022-08-28,CI,Côte d'Ivoire,166,86606,0,817,0.9433526545504931
2022-09-04,CI,Côte d'Ivoire,202,86808,2,819,0.9434614321260714
2022-09-11,CI,Côte d'Ivoire,111,86919,3,822,0.9457080730335139
2022-09-18,CI,Côte d'Ivoire,100,87019,0,822,0.9446212896034198
2022-09-25,CI,Côte d'Ivoire,110,87129,1,823,0.944576432645847
2022-10-02,CI,Côte d'Ivoire,129,87258,3,826,0.9466180751335121
2022-10-09,CI,Côte d'Ivoire,164,87422,0,826,0.9448422593855094
2022-10-16,CI,Côte d'Ivoire,152,87574,1,827,0.9443442117523466
2022-10-23,CI,Côte d'Ivoire,119,87693,0,827,0.943062730206516
2022-10-30,CI,Côte d'Ivoire,71,87764,0,827,0.9422998040198715
2022-11-06,CI,Côte d'Ivoire,66,87830,2,829,0.9438688375270409
2022-11-13,CI,Côte d'Ivoire,24,87854,0,829,0.9436109909622783
2022-11-20,CI,Côte d'Ivoire,16,87870,1,830,0.9445772163423238
2022-11-27,CI,Côte d'Ivoire,15,87885,0,830,0.9444159981794391
2022-12-04,CI,Côte d'Ivoire,2,87887,0,830,0.9443945065823159
2022-12-11,CI,Côte d'Ivoire,7,87894,0,830,0.9443192936946777
2022-12-18,CI,Côte d'Ivoire,17,87911,0,830,0.9441366836914606
2022-12-25,CI,Côte d'Ivoire,22,87933,0,830,0.9439004696757758
2023-01-01,CI,Côte d'Ivoire,8,87941,1,831,0.9449517290001251
2023-01-08,CI,Côte d'Ivoire,16,87957,2,833,0.9470536739543185
2023-01-15,CI,Côte d'Ivoire,3,87960,0,833,0.9470213733515235
2023-01-22,CI,Côte d'Ivoire,6,87966,0,833,0.9469567787554282
2023-01-29,CI,Côte d'Ivoire,8,87974,0,833,0.9468706663332348
2023-02-05,CI,Côte d'Ivoire,26,88000,0,833,0.946590909090909
2023-02-12,CI,Côte d'Ivoire,58,88058,1,834,0.9471030457198665
2023-02-19,CI,Côte d'Ivoire,51,88109,0,834,0.9465548354878617
2023-02-26,CI,Côte d'Ivoire,73,88182,0,834,0.9457712458324827
2023-03-05,CI,Côte d'Ivoire,58,88240,0,834,0.9451495920217589
2023-03-12,CI,Côte d'Ivoire,28,88268,0,834,0.9448497756831468
2023-03-19,CI,Côte d'Ivoire,25,88293,0,834,0.9445822432129387
2023-03-26,CI,Côte d'Ivoire,4,88297,0,834,0.9445394520765146
2023-04-02,CI,Côte d'Ivoire,4,88301,0,834,0.944496664816933
2023-04-09,CI,Côte d'Ivoire,7,88308,0,834,0.9444217964397336
2023-04-16,CI,Côte d'Ivoire,8,88316,0,834,0.9443362471126409
2023-04-23,CI,Côte d'Ivoire,5,88321,0,834,0.9442827866532308
2023-04-30,CI,Côte d'Ivoire,2,88323,0,834,0.9442614041642607
2023-05-07,CI,Côte d'Ivoire,3,88326,0,834,0.9442293322464506
2023-05-14,CI,Côte d'Ivoire,3,88329,0,834,0.9441972625072172
2023-05-21,CI,Côte d'Ivoire,1,88330,0,834,0.9441865730782293
2023-05-28,CI,Côte d'Ivoire,0,88330,0,834,0.9441865730782293
2023-06-04,CI,Côte d'Ivoire,1,88331,1,835,0.945307989267641
2023-06-11,CI,Côte d'Ivoire,1,88332,0,835,0.9452972875062264
2023-06-18,CI,Côte d'Ivoire,0,88332,0,835,0.9452972875062264
2023-06-25,CI,Côte d'Ivoire,3,88335,0,835,0.9452651836757798
2023-07-02,CI,Côte d'Ivoire,1,88336,0,835,0.9452544828835356
2023-07-09,CI,Côte d'Ivoire,0,88336,0,835,0.9452544828835356
2023-07-16,CI,Côte d'Ivoire,2,88338,0,835,0.9452330820258552
2023-07-23,CI,Côte d'Ivoire,0,88338,0,835,0.9452330820258552
2023-07-30,CI,Côte d'Ivoire,0,88338,0,835,0.9452330820258552
2023-08-06,CI,Côte d'Ivoire,0,88338,0,835,0.9452330820258552
2023-08-13,CI,Côte d'Ivoire,0,88338,0,835,0.9452330820258552
2023-08-20,CI,Côte d'Ivoire,0,88338,0,835,0.9452330820258552
2023-08-27,CI,Côte d'Ivoire,0,88338,0,835,0.9452330820258552
2023-09-03,CI,Côte d'Ivoire,0,88338,0,835,0.9452330820258552
2023-09-10,CI,Côte d'Ivoire,0,88338,0,835,0.9452330820258552
2023-09-17,CI,Côte d'Ivoire,0,88338,0,835,0.9452330820258552
2023-09-24,CI,Côte d'Ivoire,0,88338,0,835,0.9452330820258552
2023-10-01,CI,Côte d'Ivoire,0,88338,0,835,0.9452330820258552
2023-10-08,CI,Côte d'Ivoire,15,88353,0,835,0.945072606476294
2023-10-15,CI,Côte d'Ivoire,0,88353,0,835,0.945072606476294
2023-10-22,CI,Côte d'Ivoire,4,88357,0,835,0.9450298221985808
2023-10-29,CI,Côte d'Ivoire,7,88364,0,835,0.9449549590330903
2023-11-05,CI,Côte d'Ivoire,4,88368,0,835,0.944912185406482
2023-11-12,CI,Côte d'Ivoire,1,88369,0,835,0.9449014926048728
2023-11-19,CI,Côte d'Ivoire,0,88369,0,835,0.9449014926048728
2023-11-26,CI,Côte d'Ivoire,11,88380,0,835,0.9447838877574113
2023-12-03,CI,Côte d'Ivoire,0,88380,0,835,0.9447838877574113
2023-12-10,CI,Côte d'Ivoire,0,88380,0,835,0.9447838877574113
2023-12-17,CI,Côte d'Ivoire,4,88384,0,835,0.9447411296162201
2023-12-24,CI,Côte d'Ivoire,0,88384,0,835,0.9447411296162201
2023-12-31,CI,Côte d'Ivoire,0,88384,0,835,0.9447411296162201
2024-01-07,CI,Côte d'Ivoire,0,88384,0,835,0.9447411296162201
2024-01-14,CI,Côte d'Ivoire,0,88384,0,835,0.9447411296162201
2020-03-22,HR,Croatia,168,206,1,1,0.48543689320388345
2020-03-29,HR,Croatia,451,657,4,5,0.76103500761035
2021-01-17,CU,Cuba,3313,17501,18,166,0.948517227586995
2021-01-24,CU,Cuba,3126,20627,25,191,0.9259708149512774
2021-01-31,CU,Cuba,5047,25674,22,213,0.8296330918438887
2021-02-07,CU,Cuba,6337,32011,20,233,0.7278747930398926
2021-02-14,CU,Cuba,5472,37483,28,261,0.6963156631006057
2021-02-21,CU,Cuba,6001,43484,30,291,0.669211664060344
2021-02-28,CU,Cuba,5677,49161,27,318,0.6468542137059864
2021-03-07,CU,Cuba,5674,54835,26,344,0.6273365551199052
2021-03-14,CU,Cuba,5723,60558,22,366,0.6043792727633013
2021-03-21,CU,Cuba,5404,65962,26,392,0.5942815560474213
2021-03-28,CU,Cuba,5622,71584,22,414,0.5783415288332588
2021-04-04,CU,Cuba,6798,78382,17,431,0.5498711438850756
2021-04-11,CU,Cuba,7190,85572,22,453,0.5293787687561352
2021-04-18,CU,Cuba,6902,92474,59,512,0.5536691394337868
2021-04-25,CU,Cuba,7844,100318,69,581,0.5791582766801571
2021-05-02,CU,Cuba,7304,107622,73,654,0.6076824441099403
2021-05-09,CU,Cuba,7290,114912,68,722,0.6283068783068783
2021-05-16,CU,Cuba,8309,123221,74,796,0.6459937835271585
2021-05-23,CU,Cuba,8611,131832,67,863,0.654621032829662
2021-05-30,CU,Cuba,8255,140087,80,943,0.673153111994689
2021-06-06,CU,Cuba,7744,147831,60,1003,0.678477450602377
2021-06-13,CU,Cuba,8407,156238,54,1057,0.6765319576543478
2021-06-20,CU,Cuba,10130,166368,91,1148,0.6900365454895172
2021-06-27,CU,Cuba,13288,179656,83,1231,0.6851983791245492
2021-07-04,CU,Cuba,21072,200728,106,1337,0.6660754852337492
2021-07-11,CU,Cuba,30840,231568,122,1459,0.6300525115732745
2021-07-18,CU,Cuba,44040,275608,384,1843,0.6687033758091202
2021-07-25,CU,Cuba,48507,324115,428,2271,0.7006772287613965
2021-08-01,CU,Cuba,60481,384596,487,2758,0.7171161426535897
2021-08-08,CU,Cuba,64196,448792,597,3355,0.7475623451398421
2021-08-15,CU,Cuba,60240,509032,570,3925,0.7710713668295903
2021-08-22,CU,Cuba,64719,573751,556,4481,0.7810008174277692
2021-08-29,CU,Cuba,60410,634161,586,5067,0.7990084536892051
2021-09-05,CU,Cuba,46292,680453,550,5617,0.82547949674702
2021-09-12,CU,Cuba,56715,737168,602,6219,0.8436340155839646
2021-09-19,CU,Cuba,55765,792933,514,6733,0.8491259665066279
2021-09-26,CU,Cuba,54561,847494,430,7163,0.845197724113681
2021-10-03,CU,Cuba,39856,887350,371,7534,0.8490449089987039
2021-10-10,CU,Cuba,27429,914779,278,7812,0.8539767528550611
2021-10-17,CU,Cuba,17989,932768,225,8037,0.8616290438780061
2021-10-24,CU,Cuba,11663,944431,130,8167,0.8647534864908077
2021-10-31,CU,Cuba,6894,951325,63,8230,0.8651091898142066
2021-11-07,CU,Cuba,4173,955498,31,8261,0.8645753313978679
2021-11-14,CU,Cuba,2892,958390,18,8279,0.8638445726687465
2021-11-21,CU,Cuba,2082,960472,14,8293,0.8634296470901807
2021-11-28,CU,Cuba,1595,962067,7,8300,0.8627257768949563
2021-12-05,CU,Cuba,935,963002,7,8307,0.8626150309137468
2021-12-12,CU,Cuba,564,963566,6,8313,0.86273280709365
2021-12-19,CU,Cuba,469,964035,1,8314,0.8624168209660438
2021-12-26,CU,Cuba,572,964607,6,8320,0.8625274334521726
2022-01-02,CU,Cuba,1866,966473,3,8323,0.8611725314623379
2022-01-09,CU,Cuba,8214,974687,3,8326,0.8542229454173494
2022-01-16,CU,Cuba,20944,995631,9,8335,0.8371575412979306
2022-01-23,CU,Cuba,22973,1018604,23,8358,0.8205347711181186
2022-01-30,CU,Cuba,21238,1039842,32,8390,0.8068533488741558
2022-02-06,CU,Cuba,12378,1052220,41,8431,0.801258291992169
2022-02-13,CU,Cuba,7614,1059834,36,8467,0.7988986954560808
2022-02-20,CU,Cuba,4923,1064757,19,8486,0.7969893600135993
2022-02-27,CU,Cuba,4000,1068757,8,8494,0.7947550285050765
2022-03-06,CU,Cuba,3717,1072474,5,8499,0.7924667637630376
2022-03-13,CU,Cuba,3755,1076229,4,8503,0.7900734880773517
2022-03-20,CU,Cuba,4457,1080686,3,8506,0.7870926430063867
2022-03-27,CU,Cuba,5675,1086361,3,8509,0.7832571309168868
2022-04-03,CU,Cuba,5491,1091852,3,8512,0.7795928385898455
2022-04-10,CU,Cuba,4382,1096234,5,8517,0.7769326621870878
2022-04-17,CU,Cuba,3210,1099444,3,8520,0.7749371500503891
2022-04-24,CU,Cuba,2042,1101486,3,8523,0.7737728849935451
2022-05-01,CU,Cuba,1455,1102941,3,8526,0.7730241236838598
2022-05-08,CU,Cuba,935,1103876,1,8527,0.7724599502117991
2022-05-15,CU,Cuba,620,1104496,2,8529,0.7722074140603498
2022-05-22,CU,Cuba,439,1104935,0,8529,0.7719006095381177
2022-05-29,CU,Cuba,292,1105227,0,8529,0.7716966740769091
2022-06-05,CU,Cuba,216,1105443,0,8529,0.7715458870335241
2022-06-12,CU,Cuba,149,1105592,0,8529,0.7714419062366588
2022-06-19,CU,Cuba,137,1105729,0,8529,0.7713463244610569
2022-06-26,CU,Cuba,167,1105896,0,8529,0.771229844397665
2022-07-03,CU,Cuba,191,1106087,0,8529,0.771096667802804
2022-07-10,CU,Cuba,278,1106365,0,8529,0.7709029117877012
2022-07-17,CU,Cuba,365,1106730,0,8529,0.7706486676967282
2022-07-24,CU,Cuba,581,1107311,0,8529,0.7702443125734324
2022-07-31,CU,Cuba,674,1107985,0,8529,0.7697757641123301
2022-08-07,CU,Cuba,721,1108706,0,8529,0.7692751730395614
2022-08-14,CU,Cuba,654,1109360,0,8529,0.7688216629407947
2022-08-21,CU,Cuba,551,1109911,0,8529,0.7684399920353974
2022-08-28,CU,Cuba,426,1110337,1,8530,0.7682352294843817
2022-09-04,CU,Cuba,331,1110668,0,8530,0.7680062809048248
2022-09-11,CU,Cuba,190,1110858,0,8530,0.7678749219072104
2022-09-18,CU,Cuba,153,1111011,0,8530,0.7677691760027578
2022-09-25,CU,Cuba,117,1111128,0,8530,0.7676883311373667
2022-10-02,CU,Cuba,66,1111194,0,8530,0.7676427338520546
2022-10-09,CU,Cuba,39,1111233,0,8530,0.7676157925475575
2022-10-16,CU,Cuba,18,1111251,0,8530,0.767603358737135
2022-10-23,CU,Cuba,15,1111266,0,8530,0.7675929975361434
2022-10-30,CU,Cuba,15,1111281,0,8530,0.7675826366148616
2022-11-06,CU,Cuba,10,1111291,0,8530,0.7675757294893957
2022-11-13,CU,Cuba,26,1111317,0,8530,0.7675577715449328
2022-11-20,CU,Cuba,20,1111337,0,8530,0.7675439583132748
2022-11-27,CU,Cuba,31,1111368,0,8530,0.7675225487867204
2022-12-04,CU,Cuba,53,1111421,0,8530,0.7674859481690557
2022-12-11,CU,Cuba,109,1111530,0,8530,0.7674106861713134
2022-12-18,CU,Cuba,117,1111647,0,8530,0.7673299167811365
2022-12-25,CU,Cuba,180,1111827,0,8530,0.7672056893743362
2023-01-01,CU,Cuba,166,1111993,0,8530,0.7670911597465092
2023-01-08,CU,Cuba,141,1112134,0,8530,0.7669939054106789
2023-01-15,CU,Cuba,129,1112263,0,8530,0.7669049496387095
2023-01-22,CU,Cuba,78,1112341,0,8530,0.7668511724372292
2023-01-29,CU,Cuba,53,1112394,0,8530,0.7668146358214805
2023-02-05,CU,Cuba,79,1112473,0,8530,0.7667601820448676
2023-02-12,CU,Cuba,40,1112513,0,8530,0.7667326134615955
2023-02-19,CU,Cuba,30,1112543,0,8530,0.7667119383250804
2023-02-26,CU,Cuba,35,1112578,0,8530,0.7666878187416972
2023-03-05,CU,Cuba,44,1112622,0,8530,0.7666574991326793
2023-03-12,CU,Cuba,15,1112637,0,8530,0.7666471634504336
2023-03-19,CU,Cuba,60,1112697,0,8530,0.7666058235081069
2023-03-26,CU,Cuba,81,1112778,0,8530,0.7665500216575094
2023-04-02,CU,Cuba,47,1112825,0,8530,0.7665176465302271
2023-04-09,CU,Cuba,28,1112853,0,8530,0.7664983605202125
2023-04-16,CU,Cuba,137,1112990,0,8530,0.7664040108177073
2023-04-23,CU,Cuba,98,1113088,0,8530,0.7663365340386384
2023-04-30,CU,Cuba,0,1113088,0,8530,0.7663365340386384
2023-05-07,CU,Cuba,312,1113400,0,8530,0.7661217891144243
2023-05-14,CU,Cuba,194,1113594,0,8530,0.7659883224945536
2023-05-21,CU,Cuba,236,1113830,0,8530,0.7658260237199572
2023-05-28,CU,Cuba,249,1114079,0,8530,0.7656548593053096
2023-06-04,CU,Cuba,215,1114294,0,8530,0.7655071282803282
2023-06-11,CU,Cuba,166,1114460,0,8530,0.7653931051809845
2023-06-18,CU,Cuba,149,1114609,0,8530,0.7652907880700767
2023-06-25,CU,Cuba,106,1114715,0,8530,0.7652180153671566
2023-07-02,CU,Cuba,108,1114823,0,8530,0.7651438838272981
2023-07-09,CU,Cuba,78,1114901,0,8530,0.7650903533138816
2023-07-16,CU,Cuba,48,1114949,0,8530,0.7650574151822191
2023-07-23,CU,Cuba,40,1114989,0,8530,0.7650299689055228
2023-07-30,CU,Cuba,27,1115016,0,8530,0.7650114437819726
2023-08-06,CU,Cuba,12,1115028,0,8530,0.7650032106817048
2023-08-13,CU,Cuba,15,1115043,0,8530,0.7649929195555687
2023-08-20,CU,Cuba,0,1115043,0,8530,0.7649929195555687
2023-08-27,CU,Cuba,0,1115043,0,8530,0.7649929195555687
2023-09-03,CU,Cuba,0,1115043,0,8530,0.7649929195555687
2023-09-10,CU,Cuba,0,1115043,0,8530,0.7649929195555687
2023-09-17,CU,Cuba,0,1115043,0,8530,0.7649929195555687
2023-09-24,CU,Cuba,0,1115043,0,8530,0.7649929195555687
2023-10-01,CU,Cuba,0,1115043,0,8530,0.7649929195555687
2023-10-08,CU,Cuba,0,1115043,0,8530,0.7649929195555687
2023-10-15,CU,Cuba,0,1115043,0,8530,0.7649929195555687
2023-10-22,CU,Cuba,0,1115043,0,8530,0.7649929195555687
2023-10-29,CU,Cuba,0,1115043,0,8530,0.7649929195555687
2023-11-05,CU,Cuba,0,1115043,0,8530,0.7649929195555687
2023-11-12,CU,Cuba,0,1115043,0,8530,0.7649929195555687
2023-11-19,CU,Cuba,0,1115043,0,8530,0.7649929195555687
2023-11-26,CU,Cuba,0,1115043,0,8530,0.7649929195555687
2023-12-03,CU,Cuba,0,1115043,0,8530,0.7649929195555687
2023-12-10,CU,Cuba,0,1115043,0,8530,0.7649929195555687
2023-12-17,CU,Cuba,0,1115043,0,8530,0.7649929195555687
2023-12-24,CU,Cuba,0,1115043,0,8530,0.7649929195555687
2023-12-31,CU,Cuba,0,1115043,0,8530,0.7649929195555687
2024-01-07,CU,Cuba,0,1115043,0,8530,0.7649929195555687
2024-01-14,CU,Cuba,0,1115043,0,8530,0.7649929195555687
2020-09-13,CW,Curaçao,57,135,0,1,0.7407407407407408
2020-09-20,CW,Curaçao,75,210,0,1,0.4761904761904762
2020-09-27,CW,Curaçao,105,315,0,1,0.31746031746031744
2020-10-04,CW,Curaçao,84,399,0,1,0.2506265664160401
2020-10-11,CW,Curaçao,133,532,0,1,0.18796992481203006
2020-10-18,CW,Curaçao,141,673,0,1,0.1485884101040119
2020-10-25,CW,Curaçao,130,803,0,1,0.12453300124533001
2020-11-01,CW,Curaçao,141,944,0,1,0.1059322033898305
2020-11-08,CW,Curaçao,86,1030,1,2,0.1941747572815534
2020-11-15,CW,Curaçao,185,1215,0,2,0.1646090534979424
2020-11-22,CW,Curaçao,346,1561,1,3,0.19218449711723257
2020-11-29,CW,Curaçao,485,2046,0,3,0.1466275659824047
2020-12-06,CW,Curaçao,694,2740,4,7,0.25547445255474455
2020-12-13,CW,Curaçao,664,3404,1,8,0.23501762632197415
2020-12-20,CW,Curaçao,419,3823,3,11,0.28773214752811926
2020-12-27,CW,Curaçao,228,4051,1,12,0.2962231547765984
2021-01-03,CW,Curaçao,179,4230,2,14,0.3309692671394799
2021-01-10,CW,Curaçao,175,4405,4,18,0.40862656072644726
2021-01-17,CW,Curaçao,93,4498,1,19,0.42240995998221437
2021-01-24,CW,Curaçao,39,4537,1,20,0.44081992506061274
2021-01-31,CW,Curaçao,37,4574,0,20,0.4372540445999125
2021-02-07,CW,Curaçao,23,4597,1,21,0.45681966499891236
2021-02-14,CW,Curaçao,36,4633,1,22,0.47485430606518453
2021-02-21,CW,Curaçao,33,4666,0,22,0.47149592798971285
2021-02-28,CW,Curaçao,42,4708,0,22,0.46728971962616817
2021-03-07,CW,Curaçao,43,4751,0,22,0.4630604083350874
2021-03-14,CW,Curaçao,164,4915,0,22,0.4476093591047813
2021-03-21,CW,Curaçao,605,5520,1,23,0.4166666666666667
2021-03-28,CW,Curaçao,1128,6648,4,27,0.4061371841155234
2021-04-04,CW,Curaçao,2186,8834,11,38,0.4301562146253113
2021-04-11,CW,Curaçao,1798,10632,22,60,0.5643340857787811
2021-04-18,CW,Curaçao,1042,11674,20,80,0.6852835360630462
2021-04-25,CW,Curaçao,348,12022,19,99,0.8234902678422892
2021-05-02,CW,Curaçao,159,12181,9,108,0.8866267137345045
2021-05-09,CW,Curaçao,41,12222,5,113,0.9245622647684504
2021-05-16,CW,Curaçao,22,12244,5,118,0.9637373407383208
2021-07-25,CW,Curaçao,501,13038,0,126,0.966405890473999
2021-08-01,CW,Curaçao,455,13493,0,126,0.9338175350181576
2021-08-08,CW,Curaçao,414,13907,4,130,0.9347810455166463
2021-08-15,CW,Curaçao,489,14396,2,132,0.9169213670464018
2021-08-22,CW,Curaçao,406,14802,4,136,0.9187947574652074
2021-08-29,CW,Curaçao,332,15134,6,142,0.9382846570635656
2021-09-05,CW,Curaçao,245,15379,5,147,0.9558488848429678
2021-09-12,CW,Curaçao,217,15596,6,153,0.9810207745575789
2021-09-19,CW,Curaçao,329,15925,2,155,0.9733124018838305
2021-09-26,CW,Curaçao,329,16254,3,158,0.9720684139288791
2021-10-03,CW,Curaçao,246,16500,5,163,0.9878787878787879
2022-01-02,CW,Curaçao,2411,20710,3,189,0.9126026074360213
2022-01-09,CW,Curaçao,5278,25988,2,191,0.7349545944281977
2022-01-16,CW,Curaçao,5941,31929,8,199,0.6232578533621472
2022-01-23,CW,Curaçao,3378,35307,11,210,0.5947829042399524
2022-01-30,CW,Curaçao,1415,36722,15,225,0.6127117259408529
2022-02-06,CW,Curaçao,804,37526,17,242,0.6448862122261898
2022-02-13,CW,Curaçao,646,38172,7,249,0.6523105941527821
2022-02-20,CW,Curaçao,436,38608,11,260,0.6734355573974306
2022-02-27,CW,Curaçao,259,38867,1,261,0.6715208274371576
2022-03-06,CW,Curaçao,216,39083,0,261,0.6678095335567894
2022-03-13,CW,Curaçao,102,39185,3,264,0.6737271915273702
2022-03-20,CW,Curaçao,375,39560,1,265,0.6698685540950455
2022-03-27,CW,Curaçao,293,39853,0,265,0.6649436679798258
2022-04-03,CW,Curaçao,493,40346,2,267,0.6617756407078769
2022-04-10,CW,Curaçao,456,40802,0,267,0.6543796872702319
2022-04-17,CW,Curaçao,504,41306,4,271,0.6560790199970948
2022-04-24,CW,Curaçao,423,41729,0,271,0.6494284550312732
2022-05-01,CW,Curaçao,306,42035,2,273,0.649458784346378
2022-05-08,CW,Curaçao,295,42330,1,274,0.6472950626033546
2022-05-15,CW,Curaçao,344,42674,1,275,0.644420490228242
2022-05-22,CW,Curaçao,475,43149,1,276,0.6396440241952305
2022-05-29,CW,Curaçao,473,43622,1,277,0.6350006877263766
2022-06-05,CW,Curaçao,331,43953,0,277,0.6302186426410029
2022-06-12,CW,Curaçao,174,44127,0,277,0.6277335871461917
2022-06-19,CW,Curaçao,187,44314,1,278,0.6273412465586496
2022-06-26,CW,Curaçao,126,44440,0,278,0.6255625562556256
2022-07-03,CW,Curaçao,105,44545,0,278,0.6240880008979683
2022-07-10,CW,Curaçao,117,44662,0,278,0.6224530921141015
2022-07-17,CW,Curaçao,120,44782,2,280,0.6252512170068331
2022-07-24,CW,Curaçao,150,44932,2,282,0.6276150627615062
2022-07-31,CW,Curaçao,131,45063,0,282,0.6257905598828306
2022-08-07,CW,Curaçao,0,45063,0,282,0.6257905598828306
2022-08-14,CW,Curaçao,146,45209,1,283,0.6259815523457718
2022-08-21,CW,Curaçao,34,45243,2,285,0.6299317021417677
2022-08-28,CW,Curaçao,34,45277,1,286,0.6316672924442873
2022-09-04,CW,Curaçao,25,45302,1,287,0.633526113637367
2022-09-11,CW,Curaçao,16,45318,0,287,0.6333024405313562
2022-09-18,CW,Curaçao,27,45345,0,287,0.6329253500937259
2022-09-25,CW,Curaçao,12,45357,0,287,0.6327578984500738
2022-10-02,CW,Curaçao,11,45368,0,287,0.6326044789278786
2022-10-09,CW,Curaçao,22,45390,0,287,0.6322978629654109
2022-10-16,CW,Curaçao,16,45406,2,289,0.6364797603840902
2022-10-23,CW,Curaçao,28,45434,0,289,0.6360875115552229
2022-10-30,CW,Curaçao,33,45467,1,290,0.6378252358853674
2022-11-06,CW,Curaçao,22,45489,3,293,0.6441117632834311
2022-11-13,CW,Curaçao,18,45507,0,293,0.643856989034654
2022-11-20,CW,Curaçao,29,45536,1,294,0.6456430077301476
2022-11-27,CW,Curaçao,23,45559,1,295,0.6475120173840515
2022-12-04,CW,Curaçao,27,45586,0,295,0.6471285043653754
2022-12-11,CW,Curaçao,44,45630,2,297,0.650887573964497
2022-12-18,CW,Curaçao,39,45669,1,298,0.6525214040158532
2022-12-25,CW,Curaçao,38,45707,1,299,0.6541667578270287
2023-01-01,CW,Curaçao,13,45720,0,299,0.6539807524059493
2023-01-08,CW,Curaçao,14,45734,0,299,0.6537805571347356
2023-01-15,CW,Curaçao,11,45745,0,299,0.6536233468138595
2023-01-22,CW,Curaçao,21,45766,2,301,0.6576934842459468
2023-01-29,CW,Curaçao,7,45773,0,301,0.6575929041137789
2023-02-05,CW,Curaçao,0,45773,0,301,0.6575929041137789
2023-02-12,CW,Curaçao,7,45780,0,301,0.6574923547400612
2023-02-19,CW,Curaçao,1,45781,0,301,0.657477993053887
2023-02-26,CW,Curaçao,5,45786,0,301,0.6574061940331105
2023-03-05,CW,Curaçao,0,45786,0,301,0.6574061940331105
2023-03-12,CW,Curaçao,1,45787,0,301,0.6573918361106865
2023-03-19,CW,Curaçao,2,45789,0,301,0.6573631221472407
2023-03-26,CW,Curaçao,4,45793,0,301,0.6573057017448082
2023-04-02,CW,Curaçao,5,45798,0,301,0.65723394034674
2023-04-09,CW,Curaçao,0,45798,0,301,0.65723394034674
2023-04-16,CW,Curaçao,0,45798,0,301,0.65723394034674
2023-04-23,CW,Curaçao,0,45798,0,301,0.65723394034674
2023-04-30,CW,Curaçao,0,45798,0,301,0.65723394034674
2023-05-07,CW,Curaçao,14,45812,1,302,0.6592159259582642
2023-05-14,CW,Curaçao,0,45812,0,302,0.6592159259582642
2023-05-21,CW,Curaçao,0,45812,0,302,0.6592159259582642
2023-05-28,CW,Curaçao,0,45812,0,302,0.6592159259582642
2023-06-04,CW,Curaçao,5,45817,0,302,0.659143985856778
2023-06-11,CW,Curaçao,0,45817,0,302,0.659143985856778
2023-06-18,CW,Curaçao,0,45817,0,302,0.659143985856778
2023-06-25,CW,Curaçao,0,45817,0,302,0.659143985856778
2023-07-02,CW,Curaçao,66,45883,3,305,0.6647342152867075
2023-07-09,CW,Curaçao,0,45883,0,305,0.6647342152867075
2023-07-16,CW,Curaçao,0,45883,0,305,0.6647342152867075
2023-07-23,CW,Curaçao,0,45883,0,305,0.6647342152867075
2023-07-30,CW,Curaçao,0,45883,0,305,0.6647342152867075
2023-08-06,CW,Curaçao,0,45883,0,305,0.6647342152867075
2023-08-13,CW,Curaçao,0,45883,0,305,0.6647342152867075
2023-08-20,CW,Curaçao,0,45883,0,305,0.6647342152867075
2023-08-27,CW,Curaçao,0,45883,0,305,0.6647342152867075
2023-09-03,CW,Curaçao,0,45883,0,305,0.6647342152867075
2023-09-10,CW,Curaçao,0,45883,0,305,0.6647342152867075
2023-09-17,CW,Curaçao,0,45883,0,305,0.6647342152867075
2023-09-24,CW,Curaçao,0,45883,0,305,0.6647342152867075
2023-10-01,CW,Curaçao,0,45883,0,305,0.6647342152867075
2023-10-08,CW,Curaçao,0,45883,0,305,0.6647342152867075
2023-10-15,CW,Curaçao,0,45883,0,305,0.6647342152867075
2023-10-22,CW,Curaçao,0,45883,0,305,0.6647342152867075
2023-10-29,CW,Curaçao,0,45883,0,305,0.6647342152867075
2023-11-05,CW,Curaçao,0,45883,0,305,0.6647342152867075
2023-11-12,CW,Curaçao,0,45883,0,305,0.6647342152867075
2023-11-19,CW,Curaçao,0,45883,0,305,0.6647342152867075
2023-11-26,CW,Curaçao,0,45883,0,305,0.6647342152867075
2023-12-03,CW,Curaçao,0,45883,0,305,0.6647342152867075
2023-12-10,CW,Curaçao,0,45883,0,305,0.6647342152867075
2023-12-17,CW,Curaçao,0,45883,0,305,0.6647342152867075
2023-12-24,CW,Curaçao,0,45883,0,305,0.6647342152867075
2023-12-31,CW,Curaçao,0,45883,0,305,0.6647342152867075
2024-01-07,CW,Curaçao,0,45883,0,305,0.6647342152867075
2024-01-14,CW,Curaçao,0,45883,0,305,0.6647342152867075
2020-10-25,CY,Cyprus,1065,3444,0,25,0.7259001161440186
2020-11-01,CY,Cyprus,922,4366,1,26,0.5955107650022904
2020-11-08,CY,Cyprus,1505,5871,1,27,0.45988758303525806
2020-11-15,CY,Cyprus,1180,7051,12,39,0.5531130336122536
2020-11-22,CY,Cyprus,1405,8456,4,43,0.5085146641438032
2020-11-29,CY,Cyprus,1775,10231,5,48,0.46916234972143483
2020-12-06,CY,Cyprus,1951,12182,12,60,0.49252996223936957
2020-12-13,CY,Cyprus,2619,14801,19,79,0.5337477197486656
2020-12-20,CY,Cyprus,2676,17477,13,92,0.5264061337758197
2020-12-27,CY,Cyprus,1915,19392,22,114,0.5878712871287128
2021-01-03,CY,Cyprus,4511,23903,18,132,0.5522319374137138
2021-01-10,CY,Cyprus,3566,27469,18,150,0.5460701154028178
2021-01-17,CY,Cyprus,1800,29269,20,170,0.5808192968669924
2021-01-24,CY,Cyprus,1076,30345,16,186,0.6129510627780524
2021-01-31,CY,Cyprus,883,31228,14,200,0.6404508774177021
2021-02-07,CY,Cyprus,928,32156,14,214,0.6655056599079487
2021-02-14,CY,Cyprus,746,32902,11,225,0.6838490061394444
2021-02-21,CY,Cyprus,763,33665,9,234,0.6950839150452992
2021-02-28,CY,Cyprus,1271,34936,2,236,0.6755209525990382
2021-03-07,CY,Cyprus,2315,37251,1,237,0.6362245308850769
2021-03-14,CY,Cyprus,2702,39953,6,243,0.6082146522163543
2021-03-21,CY,Cyprus,2605,42558,4,247,0.5803844165609287
2021-03-28,CY,Cyprus,2423,44981,8,255,0.5669060269891733
2021-04-04,CY,Cyprus,3271,48252,11,266,0.5512724861145653
2021-04-11,CY,Cyprus,3753,52005,11,277,0.5326410922026729
2021-04-18,CY,Cyprus,4372,56377,18,295,0.5232630327970627
2021-04-25,CY,Cyprus,6169,62546,10,305,0.48764109615323126
2021-05-02,CY,Cyprus,4903,67449,15,320,0.47443253421103354
2021-05-09,CY,Cyprus,2791,70240,21,341,0.4854783599088838
2021-05-16,CY,Cyprus,1736,71976,12,353,0.4904412581971768
2021-05-23,CY,Cyprus,937,72913,8,361,0.4951106112764528
2021-05-30,CY,Cyprus,527,73440,7,368,0.5010893246187363
2021-06-06,CY,Cyprus,432,73872,3,371,0.5022200563136235
2021-06-13,CY,Cyprus,407,74279,10,381,0.512930976453641
2021-06-20,CY,Cyprus,425,74704,1,382,0.511351467123581
2021-06-27,CY,Cyprus,987,75691,0,382,0.5046835158737498
2021-07-04,CY,Cyprus,3262,78953,0,382,0.48383215330639745
2021-07-11,CY,Cyprus,5978,84931,6,388,0.4568414359892148
2021-07-18,CY,Cyprus,6915,91846,5,393,0.4278901639701239
2021-07-25,CY,Cyprus,6653,98499,15,408,0.4142174032223677
2021-08-01,CY,Cyprus,5170,103669,24,432,0.4167108778902083
2021-08-08,CY,Cyprus,3647,107316,18,450,0.41932237504193226
2021-08-15,CY,Cyprus,3114,110430,23,473,0.428325636149597
2021-08-22,CY,Cyprus,2433,112863,23,496,0.4394708629045834
2021-08-29,CY,Cyprus,1929,114792,22,518,0.4512509582549306
2021-09-05,CY,Cyprus,1830,116622,18,536,0.45960453430742054
2021-09-12,CY,Cyprus,1210,117832,15,551,0.4676149093624822
2021-09-19,CY,Cyprus,1032,118864,10,561,0.47196796338672775
2021-09-26,CY,Cyprus,826,119690,5,566,0.4728882947614671
2021-10-03,CY,Cyprus,726,120416,3,569,0.47252856763220835
2021-10-10,CY,Cyprus,855,121271,4,573,0.4724954853180067
2021-10-17,CY,Cyprus,993,122264,5,578,0.4727474972191324
2021-10-24,CY,Cyprus,1005,123269,7,585,0.474571871273394
2021-10-31,CY,Cyprus,1064,124333,7,592,0.47614068670425386
2021-11-07,CY,Cyprus,1482,125815,2,594,0.472121766085125
2021-11-14,CY,Cyprus,1663,127478,2,596,0.46753165252043494
2021-11-21,CY,Cyprus,2410,129888,2,598,0.4603966494210397
2021-11-28,CY,Cyprus,3049,132937,2,600,0.45134161294447744
2021-12-05,CY,Cyprus,3588,136525,9,609,0.44607214795824945
2021-12-12,CY,Cyprus,3933,140458,7,616,0.43856526506144183
2021-12-19,CY,Cyprus,4255,144713,11,627,0.43327137161139634
2021-12-26,CY,Cyprus,5135,149848,10,637,0.4250974320644921
2022-01-02,CY,Cyprus,17631,167479,11,648,0.38691418028528946
2022-01-09,CY,Cyprus,25723,193202,16,664,0.34368174242502664
2022-01-16,CY,Cyprus,22407,215609,21,685,0.3177047340324383
2022-01-23,CY,Cyprus,15773,231382,39,724,0.3129024729667822
2022-01-30,CY,Cyprus,16980,248362,24,748,0.3011732873789066
2022-02-06,CY,Cyprus,20295,268657,13,761,0.2832608121135872
2022-02-13,CY,Cyprus,18231,286888,32,793,0.2764144892780458
2022-02-20,CY,Cyprus,16440,303328,43,836,0.2756092414811689
2022-02-27,CY,Cyprus,14348,317676,34,870,0.27386393684131
2022-03-06,CY,Cyprus,13832,331508,20,890,0.2684701425003318
2022-03-13,CY,Cyprus,19180,350688,24,914,0.26063053198284514
2022-03-20,CY,Cyprus,22970,373658,16,930,0.24889069684042625
2022-03-27,CY,Cyprus,31886,405544,16,946,0.23326692048211786
2022-04-03,CY,Cyprus,31405,436949,13,959,0.21947641486763902
2022-04-10,CY,Cyprus,19015,455964,16,975,0.21383267100034214
2022-04-17,CY,Cyprus,8240,464204,13,988,0.21283745939285315
2022-04-24,CY,Cyprus,6115,470319,18,1006,0.21389737603626477
2022-05-01,CY,Cyprus,9901,480220,9,1015,0.2113614593311399
2022-05-08,CY,Cyprus,3444,483664,12,1027,0.21233749048926528
2022-05-15,CY,Cyprus,2422,486086,24,1051,0.21621688343214984
2022-05-22,CY,Cyprus,2103,488189,6,1057,0.21651450565252392
2022-05-29,CY,Cyprus,1774,489963,2,1059,0.216138769662199
2022-06-05,CY,Cyprus,1814,491777,8,1067,0.21696826000402622
2022-06-12,CY,Cyprus,2207,493984,1,1068,0.2162013344561767
2022-06-19,CY,Cyprus,3470,497454,2,1070,0.21509526508983745
2022-06-26,CY,Cyprus,7263,504717,2,1072,0.21239625374219612
2022-07-03,CY,Cyprus,10879,515596,3,1075,0.2084965748376636
2022-07-10,CY,Cyprus,14914,530510,4,1079,0.2033891915326761
2022-07-17,CY,Cyprus,15386,545896,7,1086,0.1989389920424403
2022-07-24,CY,Cyprus,10152,556048,13,1099,0.1976448076425057
2022-07-31,CY,Cyprus,6863,562911,16,1115,0.19807749360023166
2022-08-07,CY,Cyprus,5472,568383,28,1143,0.20109679564659744
2022-08-14,CY,Cyprus,3611,571994,6,1149,0.2008762329674787
2022-08-21,CY,Cyprus,2130,574124,3,1152,0.2006535173586194
2022-08-28,CY,Cyprus,2154,576278,16,1168,0.20267995654874904
2022-09-04,CY,Cyprus,1752,578030,4,1172,0.2027576423369029
2022-09-11,CY,Cyprus,1869,579899,1,1173,0.20227660333954706
2022-09-18,CY,Cyprus,2482,582381,5,1178,0.20227308239794908
2022-09-25,CY,Cyprus,2932,585313,2,1180,0.2016015362720459
2022-10-02,CY,Cyprus,2681,587994,2,1182,0.20102245941285118
2022-10-09,CY,Cyprus,2789,590783,5,1187,0.2009197962703734
2022-10-16,CY,Cyprus,2759,593542,2,1189,0.20032280782151896
2022-10-23,CY,Cyprus,2755,596297,2,1191,0.19973268354528032
2022-10-30,CY,Cyprus,2821,599118,3,1194,0.19929296065215868
2022-11-06,CY,Cyprus,3544,602662,6,1200,0.19911658607975946
2022-11-13,CY,Cyprus,3625,606287,10,1210,0.19957544859117876
2022-11-20,CY,Cyprus,3736,610023,8,1218,0.199664602810058
2022-11-27,CY,Cyprus,4214,614237,8,1226,0.1995972238728699
2022-12-04,CY,Cyprus,4011,618248,11,1237,0.20008152068425616
2022-12-11,CY,Cyprus,3854,622102,5,1242,0.1996457172617995
2022-12-18,CY,Cyprus,3460,625562,8,1250,0.1998203215668471
2022-12-25,CY,Cyprus,2947,628509,5,1255,0.19967892265663656
2023-01-01,CY,Cyprus,2602,631111,3,1258,0.19933102100898256
2023-01-08,CY,Cyprus,3598,634709,4,1262,0.19883127543488432
2023-01-15,CY,Cyprus,3353,638062,8,1270,0.19904021866213628
2023-01-22,CY,Cyprus,2667,640729,10,1280,0.19977244669743371
2023-01-29,CY,Cyprus,1934,642663,7,1287,0.2002604786645567
2023-02-05,CY,Cyprus,1497,644160,4,1291,0.20041604570293095
2023-02-12,CY,Cyprus,1355,645515,2,1293,0.2003051826835937
2023-02-19,CY,Cyprus,1516,647031,4,1297,0.2004540740706396
2023-02-26,CY,Cyprus,2062,649093,8,1305,0.20104977252874395
2023-03-05,CY,Cyprus,1592,650685,25,1330,0.2043999784842128
2023-03-12,CY,Cyprus,1701,652386,5,1335,0.20463345320101903
2023-03-19,CY,Cyprus,1281,653667,6,1341,0.2051503288371602
2023-03-26,CY,Cyprus,1047,654714,4,1345,0.20543321205900592
2023-04-02,CY,Cyprus,950,655664,4,1349,0.20574562580834085
2023-04-09,CY,Cyprus,1240,656904,1,1350,0.2055094808373826
2023-04-16,CY,Cyprus,0,656904,0,1350,0.2055094808373826
2023-04-23,CY,Cyprus,1546,658450,4,1354,0.20563444452881768
2023-04-30,CY,Cyprus,0,658450,0,1354,0.20563444452881768
2023-05-07,CY,Cyprus,2404,660854,10,1364,0.20639959809579728
2023-05-14,CY,Cyprus,0,660854,0,1364,0.20639959809579728
2023-05-21,CY,Cyprus,0,660854,0,1364,0.20639959809579728
2023-05-28,CY,Cyprus,0,660854,0,1364,0.20639959809579728
2023-06-04,CY,Cyprus,0,660854,0,1364,0.20639959809579728
2023-06-11,CY,Cyprus,0,660854,0,1364,0.20639959809579728
2023-06-18,CY,Cyprus,0,660854,0,1364,0.20639959809579728
2023-06-25,CY,Cyprus,0,660854,0,1364,0.20639959809579728
2023-07-02,CY,Cyprus,0,660854,0,1364,0.20639959809579728
2023-07-09,CY,Cyprus,0,660854,0,1364,0.20639959809579728
2023-07-16,CY,Cyprus,0,660854,0,1364,0.20639959809579728
2023-07-23,CY,Cyprus,0,660854,0,1364,0.20639959809579728
2023-07-30,CY,Cyprus,0,660854,0,1364,0.20639959809579728
2023-08-06,CY,Cyprus,0,660854,0,1364,0.20639959809579728
2023-08-13,CY,Cyprus,0,660854,0,1364,0.20639959809579728
2023-08-20,CY,Cyprus,0,660854,0,1364,0.20639959809579728
2023-08-27,CY,Cyprus,0,660854,0,1364,0.20639959809579728
2023-09-03,CY,Cyprus,0,660854,0,1364,0.20639959809579728
2023-09-10,CY,Cyprus,0,660854,0,1364,0.20639959809579728
2023-09-17,CY,Cyprus,0,660854,0,1364,0.20639959809579728
2023-09-24,CY,Cyprus,0,660854,0,1364,0.20639959809579728
2023-10-01,CY,Cyprus,0,660854,0,1364,0.20639959809579728
2023-10-08,CY,Cyprus,0,660854,0,1364,0.20639959809579728
2023-10-15,CY,Cyprus,0,660854,0,1364,0.20639959809579728
2023-10-22,CY,Cyprus,0,660854,0,1364,0.20639959809579728
2023-10-29,CY,Cyprus,0,660854,0,1364,0.20639959809579728
2023-11-05,CY,Cyprus,975,661829,0,1364,0.2060955322296243
2023-11-12,CY,Cyprus,825,662654,0,1364,0.20583894460759308
2023-11-19,CY,Cyprus,308,662962,0,1364,0.20574331560481596
2023-11-26,CY,Cyprus,0,662962,0,1364,0.20574331560481596
2023-12-03,CY,Cyprus,0,662962,0,1364,0.20574331560481596
2023-12-10,CY,Cyprus,0,662962,0,1364,0.20574331560481596
2023-12-17,CY,Cyprus,0,662962,0,1364,0.20574331560481596
2023-12-24,CY,Cyprus,0,662962,0,1364,0.20574331560481596
2023-12-31,CY,Cyprus,0,662962,0,1364,0.20574331560481596
2024-01-07,CY,Cyprus,0,662962,0,1364,0.20574331560481596
2024-01-14,CY,Cyprus,0,662962,0,1364,0.20574331560481596
2020-03-29,CZ,Czechia,1624,2683,17,17,0.6336190831159151
2020-09-27,CZ,Czechia,15008,63478,89,611,0.96253820221179
2020-10-04,CZ,Czechia,17352,80830,127,738,0.9130273413336631
2020-10-11,CZ,Czechia,33458,114288,293,1031,0.9021069578608428
2020-10-18,CZ,Czechia,54911,169199,457,1488,0.8794378217365352
2020-10-25,CZ,Czechia,82219,251418,826,2314,0.9203796068698342
2022-03-27,CZ,Czechia,59392,4043004,194,39684,0.9815473840738224
2022-04-03,CZ,Czechia,50470,4093474,154,39838,0.9732075982405166
2022-04-10,CZ,Czechia,37781,4131255,172,40010,0.9684708399747777
2022-04-17,CZ,Czechia,23016,4154271,92,40102,0.9653197877557819
2022-04-24,CZ,Czechia,16520,4170791,91,40193,0.9636781128567699
2022-05-01,CZ,Czechia,12147,4182938,77,40270,0.9627204610730544
2022-05-08,CZ,Czechia,8010,4190948,57,40327,0.962240524100991
2022-05-15,CZ,Czechia,4219,4195167,25,40352,0.9618687408629978
2022-05-22,CZ,Czechia,2686,4197853,15,40367,0.9616106138066292
2022-05-29,CZ,Czechia,1896,4199749,11,40378,0.9614384097716316
2022-06-05,CZ,Czechia,1706,4201455,7,40385,0.9612146268376075
2022-06-12,CZ,Czechia,2275,4203730,8,40393,0.9608847380778499
2022-06-19,CZ,Czechia,2945,4206675,4,40397,0.9603071309288215
2022-06-26,CZ,Czechia,4645,4211320,3,40400,0.9593191683367684
2022-07-03,CZ,Czechia,8243,4219563,10,40410,0.9576821106830258
2022-07-10,CZ,Czechia,7976,4227539,20,40430,0.9563483624870167
2022-07-17,CZ,Czechia,14675,4242214,22,40452,0.9535586842153649
2022-07-24,CZ,Czechia,21407,4263621,43,40495,0.9497795418495217
2022-07-31,CZ,Czechia,22707,4286328,86,40581,0.9467544247663735
2022-08-07,CZ,Czechia,20552,4306880,102,40683,0.9446049112118284
2022-08-14,CZ,Czechia,17817,4324697,83,40766,0.9426325127517603
2022-08-21,CZ,Czechia,18267,4342964,87,40853,0.9406709334915048
2022-08-28,CZ,Czechia,15470,4358434,62,40915,0.9387546077329609
2022-09-04,CZ,Czechia,16021,4374455,45,40960,0.936345213289427
2022-09-11,CZ,Czechia,18605,4393060,56,41016,0.9336544458759952
2022-09-18,CZ,Czechia,22160,4415220,52,41068,0.9301461761814813
2022-09-25,CZ,Czechia,24278,4439498,65,41133,0.9265236745235611
2022-10-02,CZ,Czechia,26213,4465711,100,41233,0.9233244157537288
2022-10-09,CZ,Czechia,26201,4491912,123,41356,0.9206769856577778
2022-10-16,CZ,Czechia,19903,4511815,142,41498,0.9197628892142077
2022-10-23,CZ,Czechia,14417,4526232,97,41595,0.9189763140731628
2022-10-30,CZ,Czechia,8162,4534394,79,41674,0.9190643777316219
2022-11-06,CZ,Czechia,7155,4541549,63,41737,0.9190036262957859
2022-11-13,CZ,Czechia,5214,4546763,62,41799,0.9193133664543324
2022-11-20,CZ,Czechia,4122,4550885,39,41838,0.91933766728889
2022-11-27,CZ,Czechia,4863,4555748,41,41879,0.9192562889782315
2022-12-04,CZ,Czechia,5617,4561365,43,41922,0.9190669898155486
2022-12-11,CZ,Czechia,6162,4567527,54,41976,0.919009345757562
2022-12-18,CZ,Czechia,5531,4573058,54,42030,0.9190786559015871
2022-12-25,CZ,Czechia,4468,4577526,69,42099,0.9196889324058454
2023-01-01,CZ,Czechia,2728,4580254,67,42166,0.9206039665049144
2023-01-08,CZ,Czechia,2915,4583169,62,42228,0.9213712171643681
2023-01-15,CZ,Czechia,1955,4585124,39,42267,0.9218289407222139
2023-01-22,CZ,Czechia,1813,4586937,32,42299,0.9221622184913375
2023-01-29,CZ,Czechia,1964,4588901,16,42315,0.9221162103954736
2023-02-05,CZ,Czechia,2720,4591621,22,42337,0.9220490976933855
2023-02-12,CZ,Czechia,3823,4595444,24,42361,0.9218042913807676
2023-02-19,CZ,Czechia,5723,4601167,35,42396,0.9214184140675615
2023-02-26,CZ,Czechia,6972,4608139,48,42444,0.9210659661090952
2023-03-05,CZ,Czechia,6012,4614151,43,42487,0.9207977805667825
2023-03-12,CZ,Czechia,6289,4620440,36,42523,0.9203236055440607
2023-03-19,CZ,Czechia,5728,4626168,57,42580,0.920416206242402
2023-03-26,CZ,Czechia,4673,4630841,56,42636,0.9206966941857861
2023-04-02,CZ,Czechia,3359,4634200,46,42682,0.921021967114065
2023-04-09,CZ,Czechia,2070,4636270,28,42710,0.9212146833553697
2023-04-16,CZ,Czechia,1768,4638038,23,42733,0.9213594196511542
2023-04-23,CZ,Czechia,1406,4639444,22,42755,0.9215543931557315
2023-04-30,CZ,Czechia,967,4640411,16,42771,0.9217071505088665
2023-05-07,CZ,Czechia,558,4640969,12,42783,0.9218548971130813
2023-05-14,CZ,Czechia,453,4641422,11,42794,0.9220019209630153
2023-05-21,CZ,Czechia,350,4641772,6,42800,0.9220616609346604
2023-05-28,CZ,Czechia,276,4642048,6,42806,0.9221360916560966
2023-06-04,CZ,Czechia,232,4642280,3,42809,0.9221546309141198
2023-06-11,CZ,Czechia,174,4642454,1,42810,0.9221416087267639
2023-06-18,CZ,Czechia,131,4642585,2,42812,0.9221586680696207
2023-06-25,CZ,Czechia,139,4642724,0,42812,0.9221310592660688
2023-07-02,CZ,Czechia,72,4642796,1,42813,0.9221382976981973
2023-07-09,CZ,Czechia,51,4642847,0,42813,0.9221281683415371
2023-07-16,CZ,Czechia,67,4642914,2,42815,0.922157937881253
2023-07-23,CZ,Czechia,79,4642993,1,42816,0.9221637852996978
2023-07-30,CZ,Czechia,76,4643069,0,42816,0.9221486908766594
2023-08-06,CZ,Czechia,123,4643192,0,42816,0.9221242627916312
2023-08-13,CZ,Czechia,168,4643360,0,42816,0.9220908996933255
2023-08-20,CZ,Czechia,294,4643654,2,42818,0.9220755896111124
2023-08-27,CZ,Czechia,398,4644052,1,42819,0.9220180997112005
2023-09-03,CZ,Czechia,476,4644528,4,42823,0.9220097284374213
2023-09-10,CZ,Czechia,891,4645419,6,42829,0.921962044758503
2023-09-17,CZ,Czechia,1762,4647181,5,42834,0.9217200707267481
2023-09-24,CZ,Czechia,2251,4649432,10,42844,0.9214889044511244
2023-10-01,CZ,Czechia,2175,4651607,8,42852,0.9212300179271379
2023-10-08,CZ,Czechia,3016,4654623,14,42866,0.9209338758477326
2023-10-15,CZ,Czechia,3035,4657658,20,42886,0.9207631818394566
2023-10-22,CZ,Czechia,3535,4661193,18,42904,0.9204510519088139
2023-10-29,CZ,Czechia,4418,4665611,16,42920,0.9199223852995888
2023-11-05,CZ,Czechia,5147,4670758,37,42957,0.9197008280026496
2023-11-12,CZ,Czechia,5519,4676277,26,42983,0.9191713835600415
2023-11-19,CZ,Czechia,5529,4681806,37,43020,0.9188761772700536
2023-11-26,CZ,Czechia,8531,4690337,34,43054,0.9179297777537093
2023-12-03,CZ,Czechia,10314,4700651,49,43103,0.9169580979315419
2023-12-10,CZ,Czechia,13248,4713899,65,43168,0.9157599685525718
2023-12-17,CZ,Czechia,16015,4729914,75,43243,0.9142449524452243
2023-12-24,CZ,Czechia,12299,4742213,69,43312,0.9133288614408505
2023-12-31,CZ,Czechia,4347,4746560,50,43362,0.9135458100182027
2024-01-07,CZ,Czechia,4420,4750980,49,43411,0.9137272731099689
2024-01-14,CZ,Czechia,0,4750980,0,43411,0.9137272731099689
2020-03-15,DK,Denmark,804,827,2,2,0.24183796856106407
2020-12-13,DK,Denmark,18258,107116,57,941,0.8784868740430934
2020-12-20,DK,Denmark,24490,131606,84,1025,0.7788398705226206
2020-12-27,DK,Denmark,19561,151167,134,1159,0.7667017272288263
2021-01-03,DK,Denmark,16374,167541,186,1345,0.8027885711557171
2021-01-10,DK,Denmark,12699,180240,197,1542,0.8555259653794941
2021-01-17,DK,Denmark,7959,188199,205,1747,0.9282727325862519
2021-05-02,DK,Denmark,5035,254545,15,2489,0.9778231746842405
2021-05-09,DK,Denmark,6137,260682,8,2497,0.9578720433324894
2021-05-16,DK,Denmark,7357,268039,5,2502,0.9334462522244896
2021-05-23,DK,Denmark,7120,275159,5,2507,0.9111095766447762
2021-05-30,DK,Denmark,6775,281934,9,2516,0.8924074428767016
2021-06-06,DK,Denmark,6202,288136,2,2518,0.8738928839159286
2021-06-13,DK,Denmark,3923,292059,7,2525,0.864551340653772
2021-06-20,DK,Denmark,1904,293963,5,2530,0.8606525311008528
2021-06-27,DK,Denmark,1306,295269,1,2531,0.8571844656906075
2021-07-04,DK,Denmark,2156,297425,6,2537,0.8529881482726739
2021-07-11,DK,Denmark,3689,301114,2,2539,0.8432022423401103
2021-07-18,DK,Denmark,6845,307959,3,2542,0.8254345545998008
2021-07-25,DK,Denmark,5417,313376,0,2542,0.811166139078934
2021-08-01,DK,Denmark,5931,319307,7,2549,0.7982912995956869
2021-08-08,DK,Denmark,6158,325465,3,2552,0.784108890356874
2021-08-15,DK,Denmark,6962,332427,7,2559,0.769793067350125
2021-08-22,DK,Denmark,6819,339246,5,2564,0.7557937308030162
2021-08-29,DK,Denmark,6605,345851,13,2577,0.745118562618006
2021-09-05,DK,Denmark,4996,350847,13,2590,0.7382135232736776
2021-09-12,DK,Denmark,3592,354439,21,2611,0.7366570834473632
2021-09-19,DK,Denmark,2454,356893,14,2625,0.7355145659903669
2021-09-26,DK,Denmark,2291,359184,15,2640,0.7349993318187893
2021-10-03,DK,Denmark,2979,362163,23,2663,0.7353042690722134
2021-10-10,DK,Denmark,3693,365856,6,2669,0.7295219977258812
2021-10-17,DK,Denmark,4704,370560,11,2680,0.7232297063903281
2021-10-24,DK,Denmark,7005,377565,17,2697,0.7143140916133646
2021-10-31,DK,Denmark,11186,388751,16,2713,0.6978760183253548
2021-11-07,DK,Denmark,13894,402645,22,2735,0.6792584038048405
2021-11-14,DK,Denmark,19954,422599,25,2760,0.6531014034581246
2021-11-21,DK,Denmark,26577,449176,47,2807,0.6249220795412044
2021-11-28,DK,Denmark,27961,477137,56,2863,0.6000373058471676
2021-12-05,DK,Denmark,31448,508585,76,2939,0.5778778375296165
2021-12-12,DK,Denmark,42315,550900,66,3005,0.5454710473770193
2021-12-19,DK,Denmark,67015,617915,62,3067,0.49634658488627076
2021-12-26,DK,Denmark,79648,697563,130,3197,0.45830985875110924
2022-01-02,DK,Denmark,125719,823282,75,3272,0.397433686148853
2022-01-09,DK,Denmark,126955,950237,99,3371,0.35475360357468716
2022-01-16,DK,Denmark,154800,1105037,113,3484,0.3152835606409559
2022-01-23,DK,Denmark,250778,1355815,112,3596,0.2652279256388224
2022-01-30,DK,Denmark,321474,1677289,121,3717,0.22160760608338814
2022-02-06,DK,Denmark,289241,1966530,146,3863,0.19643737954671428
2022-02-13,DK,Denmark,322546,2289076,175,4038,0.17640305520655494
2022-02-20,DK,Denmark,263285,2552361,240,4278,0.16760951918635333
2022-02-27,DK,Denmark,179445,2731806,260,4538,0.1661172133013838
2022-03-06,DK,Denmark,121430,2853236,292,4830,0.16928147548958444
2022-03-13,DK,Denmark,90711,2943947,298,5128,0.17418791846456474
2022-03-20,DK,Denmark,55976,2999923,247,5375,0.17917126539581182
2022-03-27,DK,Denmark,39281,3039204,208,5583,0.18369941603130294
2022-04-03,DK,Denmark,25421,3064625,162,5745,0.18746176122690378
2022-04-10,DK,Denmark,18807,3083432,140,5885,0.19085875738462857
2022-04-17,DK,Denmark,13583,3097015,100,5985,0.19325059775299763
2022-04-24,DK,Denmark,11999,3109014,87,6072,0.19530307679540845
2022-05-01,DK,Denmark,7641,3116655,86,6158,0.19758362731839102
2022-05-08,DK,Denmark,6084,3122739,76,6234,0.19963243806158634
2022-05-15,DK,Denmark,4944,3127683,51,6285,0.20094747453626213
2022-05-22,DK,Denmark,4289,3131972,35,6320,0.20178979888709095
2022-05-29,DK,Denmark,3406,3135378,30,6350,0.2025274145573516
2022-06-05,DK,Denmark,3796,3139174,28,6378,0.20317446563968738
2022-06-12,DK,Denmark,4975,3144149,25,6403,0.20364810955206003
2022-06-19,DK,Denmark,7527,3151676,20,6423,0.2037963293181152
2022-06-26,DK,Denmark,10389,3162065,19,6442,0.2037276273574389
2022-07-03,DK,Denmark,12802,3174867,34,6476,0.20397704848738543
2022-07-10,DK,Denmark,15246,3190113,40,6516,0.20425608748028673
2022-07-17,DK,Denmark,15481,3205594,39,6555,0.20448628241754885
2022-07-24,DK,Denmark,14446,3220040,42,6597,0.20487323138842997
2022-07-31,DK,Denmark,10945,3230985,52,6649,0.20578863721125293
2022-08-07,DK,Denmark,10639,3241624,77,6726,0.20748859213776796
2022-08-14,DK,Denmark,11809,3253433,74,6800,0.20900999037017204
2022-08-21,DK,Denmark,9713,3263146,52,6852,0.20998141057739983
2022-08-28,DK,Denmark,6891,3270037,47,6899,0.21097620607962542
2022-09-04,DK,Denmark,5151,3275188,42,6941,0.21192676573070002
2022-09-11,DK,Denmark,5462,3280650,31,6972,0.21251886059165107
2022-09-18,DK,Denmark,5239,3285889,24,6996,0.21291041785038997
2022-09-25,DK,Denmark,6252,3292141,34,7030,0.21353884903471632
2022-10-02,DK,Denmark,8354,3300495,48,7078,0.21445268058276107
2022-10-09,DK,Denmark,9047,3309542,49,7127,0.21534701780488055
2022-10-16,DK,Denmark,9203,3318745,53,7180,0.21634684195381088
2022-10-23,DK,Denmark,8060,3326805,80,7260,0.21822739835968744
2022-10-30,DK,Denmark,6569,3333374,69,7329,0.21986731761872505
2022-11-06,DK,Denmark,4564,3337938,66,7395,0.2215439591747959
2022-11-13,DK,Denmark,4250,3342188,45,7440,0.22260866234933524
2022-11-20,DK,Denmark,3856,3346044,38,7478,0.22348779633501534
2022-11-27,DK,Denmark,4332,3350376,39,7517,0.22436287748002015
2022-12-04,DK,Denmark,6538,3356914,25,7542,0.22467063499392598
2022-12-11,DK,Denmark,8942,3365856,49,7591,0.22552955325480353
2022-12-18,DK,Denmark,6909,3372765,51,7642,0.2265796757259993
2022-12-25,DK,Denmark,9086,3381851,70,7712,0.22804079777612912
2023-01-01,DK,Denmark,7754,3389605,81,7793,0.22990879468256625
2023-01-08,DK,Denmark,4858,3394463,116,7909,0.2329970896722103
2023-01-15,DK,Denmark,2454,3396917,96,8005,0.2356548599803881
2023-01-22,DK,Denmark,1357,3398274,77,8082,0.23782661433421787
2023-01-29,DK,Denmark,1064,3399338,46,8128,0.23910537875315724
2023-02-05,DK,Denmark,1072,3400410,42,8170,0.2402651444972812
2023-02-12,DK,Denmark,961,3401371,25,8195,0.24093225937423468
2023-02-19,DK,Denmark,880,3402251,37,8232,0.2419574569895049
2023-02-26,DK,Denmark,823,3403074,15,8247,0.24233971991205597
2023-03-05,DK,Denmark,755,3403829,30,8277,0.24316732714833791
2023-03-12,DK,Denmark,845,3404674,27,8304,0.2439000033483382
2023-03-19,DK,Denmark,1248,3405922,30,8334,0.24469145212368337
2023-03-26,DK,Denmark,1584,3407506,18,8352,0.24510595139084126
2023-04-02,DK,Denmark,1309,3408815,39,8391,0.24615592221930493
2023-04-09,DK,Denmark,815,3409630,29,8420,0.24694761601698717
2023-04-16,DK,Denmark,833,3410463,44,8464,0.2481774468745153
2023-04-23,DK,Denmark,751,3411214,45,8509,0.24944198751529512
2023-04-30,DK,Denmark,586,3411800,37,8546,0.2504836156867343
2023-05-07,DK,Denmark,524,3412324,40,8586,0.25161737279343926
2023-05-14,DK,Denmark,602,3412926,46,8632,0.2529208075416812
2023-05-21,DK,Denmark,367,3413293,32,8664,0.2538311243716845
2023-05-28,DK,Denmark,349,3413642,24,8688,0.2545082348998518
2023-06-04,DK,Denmark,193,3413835,27,8715,0.25528474574781734
2023-06-11,DK,Denmark,172,3414007,15,8730,0.2557112507385017
2023-06-18,DK,Denmark,162,3414169,11,8741,0.25602130415922586
2023-06-25,DK,Denmark,26,3414195,3,8744,0.2561072229324921
2023-07-02,DK,Denmark,79,3414274,3,8747,0.2561891634942011
2023-07-09,DK,Denmark,59,3414333,7,8754,0.25638975460214336
2023-07-16,DK,Denmark,86,3414419,2,8756,0.25644187195537516
2023-07-23,DK,Denmark,91,3414510,8,8764,0.256669331763562
2023-07-30,DK,Denmark,59,3414569,1,8765,0.2566941830725928
2023-08-06,DK,Denmark,105,3414674,6,8771,0.25686200205349036
2023-08-13,DK,Denmark,141,3414815,2,8773,0.2569099643758154
2023-08-20,DK,Denmark,276,3415091,7,8780,0.25709417406446855
2023-08-27,DK,Denmark,284,3415375,2,8782,0.25713135453647107
2023-09-03,DK,Denmark,369,3415744,8,8790,0.25733778643832794
2023-09-10,DK,Denmark,429,3416173,9,8799,0.2575689228853457
2023-09-17,DK,Denmark,381,3416554,12,8811,0.25789143095645495
2023-09-24,DK,Denmark,144,3416698,3,8814,0.257968365948644
2023-10-01,DK,Denmark,319,3417017,10,8824,0.25823693590052377
2023-10-08,DK,Denmark,0,3417017,0,8824,0.25823693590052377
2023-10-15,DK,Denmark,0,3417017,0,8824,0.25823693590052377
2023-10-22,DK,Denmark,0,3417017,0,8824,0.25823693590052377
2023-10-29,DK,Denmark,0,3417017,0,8824,0.25823693590052377
2023-11-05,DK,Denmark,941,3417958,43,8867,0.25942390163951695
2023-11-12,DK,Denmark,1079,3419037,51,8918,0.26083367919095346
2023-11-19,DK,Denmark,1209,3420246,50,8968,0.26220336198039557
2023-11-26,DK,Denmark,1657,3421903,61,9029,0.2638590281489569
2023-12-03,DK,Denmark,2050,3423953,71,9100,0.26577467622949263
2023-12-10,DK,Denmark,2712,3426665,97,9197,0.26839507217659153
2023-12-17,DK,Denmark,2688,3429353,114,9311,0.2715089406077473
2023-12-24,DK,Denmark,1951,3431304,76,9387,0.2735694651362864
2023-12-31,DK,Denmark,1034,3432338,39,9426,0.27462330341592234
2024-01-07,DK,Denmark,695,3433033,10,9436,0.2748589949470337
2024-01-14,DK,Denmark,0,3433033,0,9436,0.2748589949470337
2020-04-19,DJ,Djibouti,545,732,0,2,0.273224043715847
2020-04-26,DJ,Djibouti,276,1008,0,2,0.1984126984126984
2020-05-03,DJ,Djibouti,104,1112,0,2,0.1798561151079137
2020-05-10,DJ,Djibouti,77,1189,1,3,0.2523128679562658
2020-05-17,DJ,Djibouti,142,1331,1,4,0.30052592036063114
2020-05-24,DJ,Djibouti,939,2270,6,10,0.4405286343612335
2020-05-31,DJ,Djibouti,924,3194,12,22,0.6887914840325611
2020-06-07,DJ,Djibouti,975,4169,4,26,0.6236507555768769
2020-06-14,DJ,Djibouti,280,4449,15,41,0.9215554057091482
2020-06-21,DJ,Djibouti,116,4565,4,45,0.9857612267250823
2021-03-21,DJ,Djibouti,266,6518,0,63,0.9665541577170912
2021-03-28,DJ,Djibouti,731,7249,3,66,0.9104704097116844
2021-04-04,DJ,Djibouti,1260,8509,6,72,0.8461628863556234
2021-04-11,DJ,Djibouti,1213,9722,21,93,0.9565932935609957
2021-08-22,DM,Dominica,747,1323,1,1,0.07558578987150416
2021-08-29,DM,Dominica,315,1638,3,4,0.2442002442002442
2021-09-05,DM,Dominica,194,1832,0,4,0.21834061135371177
2021-09-12,DM,Dominica,666,2498,3,7,0.28022417934347477
2021-09-19,DM,Dominica,260,2758,1,8,0.290065264684554
2021-09-26,DM,Dominica,535,3293,7,15,0.4555116914667477
2021-10-03,DM,Dominica,309,3602,6,21,0.5830094392004442
2021-10-10,DM,Dominica,418,4020,5,26,0.6467661691542288
2021-10-17,DM,Dominica,133,4153,2,28,0.6742114134360703
2021-10-24,DM,Dominica,355,4508,2,30,0.6654835847382431
2021-10-31,DM,Dominica,275,4783,2,32,0.669036169767928
2021-11-07,DM,Dominica,178,4961,0,32,0.6450312437008667
2021-11-14,DM,Dominica,0,4961,0,32,0.6450312437008667
2021-11-21,DM,Dominica,480,5441,3,35,0.6432641058628928
2021-11-28,DM,Dominica,335,5776,2,37,0.6405817174515236
2021-12-05,DM,Dominica,310,6086,5,42,0.6901084456128821
2021-12-12,DM,Dominica,171,6257,0,42,0.6712482020137446
2021-12-19,DM,Dominica,173,6430,2,44,0.6842923794712287
2021-12-26,DM,Dominica,129,6559,1,45,0.6860801951516999
2022-01-02,DM,Dominica,303,6862,2,47,0.684931506849315
2022-01-09,DM,Dominica,532,7394,0,47,0.635650527454693
2022-01-16,DM,Dominica,563,7957,1,48,0.6032424280507729
2022-01-23,DM,Dominica,560,8517,1,49,0.5753199483386169
2022-01-30,DM,Dominica,515,9032,2,51,0.5646589902568644
2022-02-06,DM,Dominica,968,10000,0,51,0.51
2022-02-13,DM,Dominica,527,10527,2,53,0.5034672746271492
2022-02-20,DM,Dominica,225,10752,4,57,0.5301339285714286
2022-02-27,DM,Dominica,356,11108,0,57,0.5131436802304645
2022-03-06,DM,Dominica,140,11248,4,61,0.5423186344238976
2022-03-13,DM,Dominica,281,11529,1,62,0.5377743082661116
2022-03-20,DM,Dominica,216,11745,0,62,0.5278842060451255
2022-03-27,DM,Dominica,60,11805,1,63,0.5336721728081322
2022-04-03,DM,Dominica,92,11897,0,63,0.5295452635118097
2022-04-10,DM,Dominica,71,11968,0,63,0.526403743315508
2022-04-17,DM,Dominica,20,11988,0,63,0.5255255255255256
2022-04-24,DM,Dominica,45,12033,0,63,0.5235602094240838
2022-05-01,DM,Dominica,128,12161,0,63,0.5180495025080174
2022-05-08,DM,Dominica,332,12493,0,63,0.50428239814296
2022-05-15,DM,Dominica,623,13116,0,63,0.48032936870997256
2022-05-22,DM,Dominica,798,13914,0,63,0.45278137128072443
2022-05-29,DM,Dominica,381,14295,4,67,0.4686953480237846
2022-06-05,DM,Dominica,0,14295,0,67,0.4686953480237846
2022-06-12,DM,Dominica,343,14638,0,67,0.4577128022953955
2022-06-19,DM,Dominica,143,14781,0,67,0.4532846221500575
2022-06-26,DM,Dominica,71,14852,1,68,0.4578507945057905
2022-07-03,DM,Dominica,0,14852,0,68,0.4578507945057905
2022-07-10,DM,Dominica,0,14852,0,68,0.4578507945057905
2022-07-17,DM,Dominica,0,14852,0,68,0.4578507945057905
2022-07-24,DM,Dominica,0,14852,0,68,0.4578507945057905
2022-07-31,DM,Dominica,0,14852,0,68,0.4578507945057905
2022-08-07,DM,Dominica,0,14852,0,68,0.4578507945057905
2022-08-14,DM,Dominica,0,14852,0,68,0.4578507945057905
2022-08-21,DM,Dominica,0,14852,0,68,0.4578507945057905
2022-08-28,DM,Dominica,0,14852,0,68,0.4578507945057905
2022-09-04,DM,Dominica,0,14852,0,68,0.4578507945057905
2022-09-11,DM,Dominica,0,14852,0,68,0.4578507945057905
2022-09-18,DM,Dominica,0,14852,0,68,0.4578507945057905
2022-09-25,DM,Dominica,0,14852,0,68,0.4578507945057905
2022-10-02,DM,Dominica,895,15747,6,74,0.4699307804661206
2022-10-09,DM,Dominica,13,15760,0,74,0.46954314720812185
2022-10-16,DM,Dominica,0,15760,0,74,0.46954314720812185
2022-10-23,DM,Dominica,0,15760,0,74,0.46954314720812185
2022-10-30,DM,Dominica,0,15760,0,74,0.46954314720812185
2022-11-06,DM,Dominica,0,15760,0,74,0.46954314720812185
2022-11-13,DM,Dominica,0,15760,0,74,0.46954314720812185
2022-11-20,DM,Dominica,0,15760,0,74,0.46954314720812185
2022-11-27,DM,Dominica,0,15760,0,74,0.46954314720812185
2022-12-04,DM,Dominica,0,15760,0,74,0.46954314720812185
2022-12-11,DM,Dominica,0,15760,0,74,0.46954314720812185
2022-12-18,DM,Dominica,0,15760,0,74,0.46954314720812185
2022-12-25,DM,Dominica,0,15760,0,74,0.46954314720812185
2023-01-01,DM,Dominica,0,15760,0,74,0.46954314720812185
2023-01-08,DM,Dominica,0,15760,0,74,0.46954314720812185
2023-01-15,DM,Dominica,0,15760,0,74,0.46954314720812185
2023-01-22,DM,Dominica,0,15760,0,74,0.46954314720812185
2023-01-29,DM,Dominica,0,15760,0,74,0.46954314720812185
2023-02-05,DM,Dominica,0,15760,0,74,0.46954314720812185
2023-02-12,DM,Dominica,0,15760,0,74,0.46954314720812185
2023-02-19,DM,Dominica,0,15760,0,74,0.46954314720812185
2023-02-26,DM,Dominica,0,15760,0,74,0.46954314720812185
2023-03-05,DM,Dominica,0,15760,0,74,0.46954314720812185
2023-03-12,DM,Dominica,0,15760,0,74,0.46954314720812185
2023-03-19,DM,Dominica,0,15760,0,74,0.46954314720812185
2023-03-26,DM,Dominica,0,15760,0,74,0.46954314720812185
2023-04-02,DM,Dominica,0,15760,0,74,0.46954314720812185
2023-04-09,DM,Dominica,0,15760,0,74,0.46954314720812185
2023-04-16,DM,Dominica,0,15760,0,74,0.46954314720812185
2023-04-23,DM,Dominica,0,15760,0,74,0.46954314720812185
2023-04-30,DM,Dominica,0,15760,0,74,0.46954314720812185
2023-05-07,DM,Dominica,0,15760,0,74,0.46954314720812185
2023-05-14,DM,Dominica,0,15760,0,74,0.46954314720812185
2023-05-21,DM,Dominica,0,15760,0,74,0.46954314720812185
2023-05-28,DM,Dominica,17,15777,0,74,0.46903720605945365
2023-06-04,DM,Dominica,14,15791,0,74,0.4686213666012285
2023-06-11,DM,Dominica,17,15808,0,74,0.4681174089068826
2023-06-18,DM,Dominica,42,15850,0,74,0.4668769716088328
2023-06-25,DM,Dominica,27,15877,0,74,0.46608301316369594
2023-07-02,DM,Dominica,37,15914,0,74,0.4649993716224708
2023-07-09,DM,Dominica,26,15940,0,74,0.4642409033877039
2023-07-16,DM,Dominica,22,15962,0,74,0.46360105249968675
2023-07-23,DM,Dominica,8,15970,0,74,0.4633688165309956
2023-07-30,DM,Dominica,9,15979,0,74,0.4631078290255961
2023-08-06,DM,Dominica,10,15989,0,74,0.4628181875039089
2023-08-13,DM,Dominica,4,15993,0,74,0.46270243231413744
2023-08-20,DM,Dominica,9,16002,0,74,0.4624421947256593
2023-08-27,DM,Dominica,7,16009,0,74,0.4622399900056218
2023-09-03,DM,Dominica,0,16009,0,74,0.4622399900056218
2023-09-10,DM,Dominica,0,16009,0,74,0.4622399900056218
2023-09-17,DM,Dominica,4,16013,0,74,0.4621245238243927
2023-09-24,DM,Dominica,6,16019,0,74,0.46195143267370004
2023-10-01,DM,Dominica,7,16026,0,74,0.4617496568076875
2023-10-08,DM,Dominica,1,16027,0,74,0.46172084607225305
2023-10-15,DM,Dominica,3,16030,0,74,0.46163443543356203
2023-10-22,DM,Dominica,1,16031,0,74,0.4616056390742936
2023-10-29,DM,Dominica,2,16033,0,74,0.4615480571321649
2023-11-05,DM,Dominica,1,16034,0,74,0.4615192715479606
2023-11-12,DM,Dominica,1,16035,0,74,0.4614904895541004
2023-11-19,DM,Dominica,3,16038,0,74,0.46140416510786886
2023-11-26,DM,Dominica,0,16038,0,74,0.46140416510786886
2023-12-03,DM,Dominica,0,16038,0,74,0.46140416510786886
2023-12-10,DM,Dominica,0,16038,0,74,0.46140416510786886
2023-12-17,DM,Dominica,0,16038,0,74,0.46140416510786886
2023-12-24,DM,Dominica,0,16038,0,74,0.46140416510786886
2023-12-31,DM,Dominica,0,16038,0,74,0.46140416510786886
2024-01-07,DM,Dominica,0,16038,0,74,0.46140416510786886
2024-01-14,DM,Dominica,0,16038,0,74,0.46140416510786886
2022-01-09,DO,Dominican Republic,31258,451185,8,4255,0.9430721322739009
2022-01-16,DO,Dominican Republic,43410,494595,13,4268,0.8629282544303926
2022-01-23,DO,Dominican Republic,42172,536767,17,4285,0.7982979579594126
2022-01-30,DO,Dominican Republic,16064,552831,16,4301,0.7779954452626571
2022-02-06,DO,Dominican Republic,8826,561657,21,4322,0.7695087927329313
2022-02-13,DO,Dominican Republic,7367,569024,21,4343,0.763236700033742
2022-02-20,DO,Dominican Republic,2528,571552,14,4357,0.7623103409663512
2022-02-27,DO,Dominican Republic,2519,574071,11,4368,0.760881493752515
2022-03-06,DO,Dominican Republic,1812,575883,3,4371,0.759008340235777
2022-03-13,DO,Dominican Republic,484,576367,3,4374,0.7588914701917354
2022-03-20,DO,Dominican Republic,950,577317,1,4375,0.7578158966391082
2022-03-27,DO,Dominican Republic,524,577841,0,4375,0.7571286911105304
2022-04-03,DO,Dominican Republic,338,578179,0,4375,0.7566860781868591
2022-04-10,DO,Dominican Republic,305,578484,0,4375,0.7562871228936323
2022-04-17,DO,Dominican Republic,261,578745,0,4375,0.755946055689466
2022-04-24,DO,Dominican Republic,334,579079,1,4376,0.7556827306809607
2022-05-01,DO,Dominican Republic,364,579443,0,4376,0.7552080187352337
2022-05-08,DO,Dominican Republic,364,579807,0,4376,0.7547339028331841
2022-05-15,DO,Dominican Republic,605,580412,0,4376,0.7539471961296458
2022-05-22,DO,Dominican Republic,838,581250,1,4377,0.7530322580645161
2022-05-29,DO,Dominican Republic,1909,583159,0,4377,0.750567169502657
2022-06-05,DO,Dominican Republic,2940,586099,0,4377,0.7468021614095912
2022-06-12,DO,Dominican Republic,4665,590764,3,4380,0.7414128145926292
2022-06-19,DO,Dominican Republic,5918,596682,2,4382,0.7343945351125054
2022-06-26,DO,Dominican Republic,5672,602354,1,4383,0.7276452053111625
2022-07-03,DO,Dominican Republic,7036,609390,0,4383,0.7192438339979323
2022-07-10,DO,Dominican Republic,8263,617653,0,4383,0.7096217455432094
2022-07-17,DO,Dominican Republic,4283,621936,0,4383,0.704734892336189
2022-07-24,DO,Dominican Republic,4094,626030,0,4383,0.7001261920355255
2022-07-31,DO,Dominican Republic,2695,628725,0,4383,0.6971251342001671
2022-08-07,DO,Dominican Republic,3930,632655,1,4384,0.6929527151449052
2022-08-14,DO,Dominican Republic,2211,634866,0,4384,0.6905394209171699
2022-08-21,DO,Dominican Republic,1550,636416,0,4384,0.6888576025744167
2022-08-28,DO,Dominican Republic,1670,638086,0,4384,0.6870547230310647
2022-09-04,DO,Dominican Republic,1978,640064,0,4384,0.684931506849315
2022-09-11,DO,Dominican Republic,1899,641963,0,4384,0.682905401090094
2022-09-18,DO,Dominican Republic,2053,644016,0,4384,0.6807284291073513
2022-09-25,DO,Dominican Republic,1353,645369,0,4384,0.679301298946804
2022-10-02,DO,Dominican Republic,974,646343,0,4384,0.6782776327739296
2022-10-09,DO,Dominican Republic,541,646884,0,4384,0.6777103777493337
2022-10-16,DO,Dominican Republic,321,647205,0,4384,0.6773742477267636
2022-10-23,DO,Dominican Republic,161,647366,0,4384,0.6772057846720403
2022-10-30,DO,Dominican Republic,189,647555,0,4384,0.6770081305835025
2022-11-06,DO,Dominican Republic,139,647694,0,4384,0.6768628395507755
2022-11-13,DO,Dominican Republic,222,647916,0,4384,0.6766309212922663
2022-11-20,DO,Dominican Republic,490,648406,0,4384,0.6761195917372756
2022-11-27,DO,Dominican Republic,1278,649684,0,4384,0.6747895900160694
2022-12-04,DO,Dominican Republic,1783,651467,0,4384,0.6729427584206107
2022-12-11,DO,Dominican Republic,2494,653961,0,4384,0.6703763680097131
2022-12-18,DO,Dominican Republic,2845,656806,0,4384,0.6674725870348323
2022-12-25,DO,Dominican Republic,1781,658587,0,4384,0.665667557968803
2023-01-01,DO,Dominican Republic,589,659176,0,4384,0.6650727575033072
2023-01-08,DO,Dominican Republic,342,659518,0,4384,0.6647278770253428
2023-01-15,DO,Dominican Republic,215,659733,0,4384,0.6645112492478017
2023-01-22,DO,Dominican Republic,229,659962,0,4384,0.6642806707052831
2023-01-29,DO,Dominican Republic,225,660187,0,4384,0.6640542755310238
2023-02-05,DO,Dominican Republic,173,660360,0,4384,0.6638803077109455
2023-02-12,DO,Dominican Republic,108,660468,0,4384,0.6637717497289801
2023-02-19,DO,Dominican Republic,157,660625,0,4384,0.6636140018921476
2023-02-26,DO,Dominican Republic,132,660757,0,4384,0.6634814311463972
2023-03-05,DO,Dominican Republic,65,660822,0,4384,0.6634161695585196
2023-03-12,DO,Dominican Republic,54,660876,0,4384,0.663361962001949
2023-03-19,DO,Dominican Republic,39,660915,0,4384,0.663322817608921
2023-03-26,DO,Dominican Republic,22,660937,0,4384,0.6633007381944118
2023-04-02,DO,Dominican Republic,0,660937,0,4384,0.6633007381944118
2023-04-09,DO,Dominican Republic,0,660937,0,4384,0.6633007381944118
2023-04-16,DO,Dominican Republic,24,660961,0,4384,0.6632766532367265
2023-04-23,DO,Dominican Republic,47,661008,0,4384,0.6632294919274804
2023-04-30,DO,Dominican Republic,37,661045,0,4384,0.6631923696571338
2023-05-07,DO,Dominican Republic,58,661103,0,4384,0.6631341863522022
2023-05-14,DO,Dominican Republic,0,661103,0,4384,0.6631341863522022
2023-05-21,DO,Dominican Republic,0,661103,0,4384,0.6631341863522022
2023-05-28,DO,Dominican Republic,2,661105,0,4384,0.6631321802134305
2023-06-04,DO,Dominican Republic,2,661107,0,4384,0.6631301740867969
2023-06-11,DO,Dominican Republic,11,661118,0,4384,0.6631191406072744
2023-06-18,DO,Dominican Republic,2,661120,0,4384,0.6631171345595354
2023-06-25,DO,Dominican Republic,2,661122,0,4384,0.6631151285239336
2023-07-02,DO,Dominican Republic,10,661132,0,4384,0.6631050985279793
2023-07-09,DO,Dominican Republic,12,661144,0,4384,0.6630930629333398
2023-07-16,DO,Dominican Republic,4,661148,0,4384,0.6630890511655484
2023-07-23,DO,Dominican Republic,0,661148,0,4384,0.6630890511655484
2023-07-30,DO,Dominican Republic,3,661151,0,4384,0.6630860423715611
2023-08-06,DO,Dominican Republic,0,661151,0,4384,0.6630860423715611
2023-08-13,DO,Dominican Republic,1,661152,0,4384,0.6630850394462997
2023-08-20,DO,Dominican Republic,0,661152,0,4384,0.6630850394462997
2023-08-27,DO,Dominican Republic,1,661153,0,4384,0.6630840365240723
2023-09-03,DO,Dominican Republic,4,661157,0,4384,0.6630800248655009
2023-09-10,DO,Dominican Republic,0,661157,0,4384,0.6630800248655009
2023-09-17,DO,Dominican Republic,18,661175,0,4384,0.6630619730026089
2023-09-24,DO,Dominican Republic,0,661175,0,4384,0.6630619730026089
2023-10-01,DO,Dominican Republic,1,661176,0,4384,0.6630609701501566
2023-10-08,DO,Dominican Republic,1,661177,0,4384,0.6630599673007379
2023-10-15,DO,Dominican Republic,0,661177,0,4384,0.6630599673007379
2023-10-22,DO,Dominican Republic,0,661177,0,4384,0.6630599673007379
2023-10-29,DO,Dominican Republic,0,661177,0,4384,0.6630599673007379
2023-11-05,DO,Dominican Republic,1,661178,0,4384,0.6630589644543528
2023-11-12,DO,Dominican Republic,0,661178,0,4384,0.6630589644543528
2023-11-19,DO,Dominican Republic,1,661179,0,4384,0.663057961611001
2023-11-26,DO,Dominican Republic,1,661180,0,4384,0.6630569587706827
2023-12-03,DO,Dominican Republic,0,661180,0,4384,0.6630569587706827
2023-12-10,DO,Dominican Republic,0,661180,0,4384,0.6630569587706827
2023-12-17,DO,Dominican Republic,0,661180,0,4384,0.6630569587706827
2023-12-24,DO,Dominican Republic,0,661180,0,4384,0.6630569587706827
2023-12-31,DO,Dominican Republic,0,661180,0,4384,0.6630569587706827
2024-01-07,DO,Dominican Republic,0,661180,0,4384,0.6630569587706827
2024-01-14,DO,Dominican Republic,0,661180,0,4384,0.6630569587706827
2020-04-26,GQ,Equatorial Guinea,206,285,1,1,0.3508771929824561
2020-05-03,GQ,Equatorial Guinea,220,505,3,4,0.7920792079207921
2020-05-17,GQ,Equatorial Guinea,239,927,0,7,0.7551240560949299
2020-05-24,GQ,Equatorial Guinea,386,1313,5,12,0.913937547600914
2020-05-31,GQ,Equatorial Guinea,415,1728,0,12,0.6944444444444444
2020-06-07,GQ,Equatorial Guinea,460,2188,0,12,0.5484460694698354
2020-06-14,GQ,Equatorial Guinea,306,2494,0,12,0.48115477145148355
2020-07-12,GQ,Equatorial Guinea,316,4237,0,41,0.9676658012744868
2020-07-19,GQ,Equatorial Guinea,398,4635,0,41,0.8845738942826321
2020-07-26,GQ,Equatorial Guinea,143,4778,0,41,0.8580996232733361
2020-12-27,ER,Eritrea,243,997,1,1,0.10030090270812438
2021-01-03,ER,Eritrea,323,1320,2,3,0.22727272727272727
2021-01-10,ER,Eritrea,236,1556,3,6,0.3856041131105398
2021-01-17,ER,Eritrea,321,1877,0,6,0.31965903036760784
2021-01-24,ER,Eritrea,63,1940,0,6,0.30927835051546393
2021-01-31,ER,Eritrea,195,2135,1,7,0.32786885245901637
2021-02-07,ER,Eritrea,191,2326,0,7,0.3009458297506449
2021-02-14,ER,Eritrea,103,2429,0,7,0.2881844380403458
2021-02-21,ER,Eritrea,256,2685,0,7,0.260707635009311
2021-02-28,ER,Eritrea,162,2847,0,7,0.24587284861257463
2021-03-07,ER,Eritrea,97,2944,0,7,0.2377717391304348
2021-03-14,ER,Eritrea,94,3038,0,7,0.2304147465437788
2021-03-21,ER,Eritrea,80,3118,0,7,0.22450288646568314
2021-03-28,ER,Eritrea,90,3208,2,9,0.2805486284289277
2021-04-04,ER,Eritrea,126,3334,1,10,0.2999400119976005
2021-04-11,ER,Eritrea,113,3447,0,10,0.2901073397156948
2021-04-18,ER,Eritrea,44,3491,0,10,0.2864508736751647
2021-04-25,ER,Eritrea,114,3605,0,10,0.27739251040221913
2021-05-02,ER,Eritrea,66,3671,0,10,0.2724053391446472
2021-05-09,ER,Eritrea,71,3742,2,12,0.3206841261357563
2021-05-16,ER,Eritrea,102,3844,0,12,0.31217481789802287
2021-05-23,ER,Eritrea,88,3932,2,14,0.3560528992878942
2021-05-30,ER,Eritrea,129,4061,0,14,0.3447426742181729
2021-06-06,ER,Eritrea,400,4461,0,14,0.3138309796009863
2021-06-13,ER,Eritrea,387,4848,2,16,0.33003300330033003
2021-06-20,ER,Eritrea,488,5336,3,19,0.356071964017991
2021-06-27,ER,Eritrea,444,5780,2,21,0.3633217993079585
2021-07-04,ER,Eritrea,294,6074,4,25,0.4115903852486006
2021-07-11,ER,Eritrea,203,6277,4,29,0.4620041421061016
2021-07-18,ER,Eritrea,125,6402,1,30,0.4686035613870665
2021-07-25,ER,Eritrea,93,6495,3,33,0.5080831408775982
2021-08-01,ER,Eritrea,52,6547,2,35,0.5345959981670995
2021-08-08,ER,Eritrea,29,6576,0,35,0.5322384428223844
2021-08-15,ER,Eritrea,25,6601,2,37,0.5605211331616422
2021-08-22,ER,Eritrea,19,6620,0,37,0.5589123867069486
2021-08-29,ER,Eritrea,19,6639,0,37,0.5573128483205302
2021-09-05,ER,Eritrea,8,6647,1,38,0.5716864751015496
2021-09-12,ER,Eritrea,8,6655,2,40,0.6010518407212623
2021-09-19,ER,Eritrea,16,6671,0,40,0.599610253335332
2021-09-26,ER,Eritrea,23,6694,2,42,0.6274275470570659
2021-10-03,ER,Eritrea,28,6722,0,42,0.6248140434394526
2021-10-10,ER,Eritrea,19,6741,0,42,0.6230529595015576
2021-10-17,ER,Eritrea,32,6773,2,44,0.6496382695998819
2021-10-24,ER,Eritrea,16,6789,1,45,0.6628369421122404
2021-10-31,ER,Eritrea,42,6831,0,45,0.6587615283267457
2021-11-07,ER,Eritrea,112,6943,1,46,0.6625378078640357
2021-11-14,ER,Eritrea,108,7051,2,48,0.680754502907389
2021-11-21,ER,Eritrea,105,7156,6,54,0.7546115148127445
2021-11-28,ER,Eritrea,149,7305,6,60,0.8213552361396305
2021-12-05,ER,Eritrea,153,7458,1,61,0.8179136497720568
2021-12-12,ER,Eritrea,171,7629,2,63,0.8257963035784506
2021-12-19,ER,Eritrea,124,7753,5,68,0.8770798400619115
2021-12-26,ER,Eritrea,120,7873,4,72,0.9145179728184936
2022-01-02,ER,Eritrea,153,8026,4,76,0.946922501868926
2022-01-09,ER,Eritrea,277,8303,6,82,0.9875948452366614
2022-01-16,ER,Eritrea,573,8876,4,86,0.9689049121225778
2022-01-23,ER,Eritrea,374,9250,5,91,0.9837837837837837
2020-12-13,EE,Estonia,3156,23605,19,224,0.9489514933276847
2020-12-20,EE,Estonia,3696,27301,28,252,0.9230431119739204
2020-12-27,EE,Estonia,3730,31031,32,284,0.9152138184396249
2021-01-03,EE,Estonia,3709,34740,39,323,0.9297639608520437
2021-01-10,EE,Estonia,4276,39016,34,357,0.9150092269838015
2021-01-17,EE,Estonia,3543,42559,48,405,0.9516201038558236
2021-01-24,EE,Estonia,3631,46190,47,452,0.9785667893483438
2021-02-14,EE,Estonia,4561,58117,36,572,0.9842214842472943
2021-02-21,EE,Estonia,5572,63689,38,610,0.9577792083405299
2021-02-28,EE,Estonia,8183,71872,57,667,0.9280387355298307
2021-03-07,EE,Estonia,9570,81442,66,733,0.9000270130890695
2021-03-14,EE,Estonia,9905,91347,59,792,0.8670235475713488
2021-03-21,EE,Estonia,10309,101656,69,861,0.8469741087589518
2021-03-28,EE,Estonia,7822,109478,82,943,0.8613602732969181
2021-04-04,EE,Estonia,423,109901,3,946,0.8607746972275048
2021-04-11,EE,Estonia,4663,114564,86,1032,0.900806536084634
2021-04-18,EE,Estonia,3341,117905,60,1092,0.9261693736482761
2021-04-25,EE,Estonia,2604,120509,49,1141,0.9468172501638882
2021-05-02,EE,Estonia,2402,122911,26,1167,0.9494675008746166
2021-05-09,EE,Estonia,2283,125194,31,1198,0.9569148681246704
2021-05-16,EE,Estonia,1870,127064,21,1219,0.9593590631492791
2021-05-23,EE,Estonia,1465,128529,14,1233,0.9593165744695751
2021-05-30,EE,Estonia,876,129405,13,1246,0.9628685135813917
2021-06-06,EE,Estonia,612,130017,11,1257,0.9667966496688895
2021-06-13,EE,Estonia,380,130397,2,1259,0.9655130102686411
2021-06-20,EE,Estonia,282,130679,2,1261,0.9649599400056627
2021-06-27,EE,Estonia,165,130844,1,1262,0.9645073522668215
2021-07-04,EE,Estonia,227,131071,1,1263,0.9635998809805372
2021-07-11,EE,Estonia,301,131372,0,1263,0.9613920774594282
2021-07-18,EE,Estonia,375,131747,1,1264,0.9594146356273767
2021-07-25,EE,Estonia,645,132392,0,1264,0.9547404677019761
2021-08-01,EE,Estonia,1246,133638,1,1265,0.9465870485939628
2021-08-08,EE,Estonia,1472,135110,4,1269,0.9392346976537637
2021-08-15,EE,Estonia,1942,137052,2,1271,0.9273852260455885
2021-08-22,EE,Estonia,1970,139022,5,1276,0.9178403418164031
2021-08-29,EE,Estonia,2476,141498,7,1283,0.9067265968423582
2021-09-05,EE,Estonia,2405,143903,11,1294,0.8992168335614963
2021-09-12,EE,Estonia,2976,146879,11,1305,0.8884864412203242
2021-09-19,EE,Estonia,3258,150137,14,1319,0.8785309417398776
2021-09-26,EE,Estonia,3784,153921,22,1341,0.8712261484787651
2021-10-03,EE,Estonia,4970,158891,23,1364,0.8584501324807573
2021-10-10,EE,Estonia,6455,165346,27,1391,0.8412661933158347
2021-10-17,EE,Estonia,7999,173345,31,1422,0.8203294009057083
2021-10-24,EE,Estonia,9988,183333,37,1459,0.7958196287629613
2021-10-31,EE,Estonia,12069,195402,72,1531,0.7835129630198258
2021-11-07,EE,Estonia,173,195575,0,1531,0.7828198900677489
2021-11-14,EE,Estonia,6726,202301,72,1603,0.7923836263785152
2021-11-21,EE,Estonia,5181,207482,53,1656,0.7981415255299255
2021-11-28,EE,Estonia,4077,211559,55,1711,0.8087578406023852
2021-12-05,EE,Estonia,3437,214996,27,1738,0.8083871327838656
2021-12-12,EE,Estonia,3305,218301,38,1776,0.8135555952560913
2021-12-19,EE,Estonia,3913,222214,23,1799,0.809579954458315
2021-12-26,EE,Estonia,4595,226809,29,1828,0.8059644899452844
2022-01-02,EE,Estonia,6140,232949,23,1851,0.794594524981863
2022-01-09,EE,Estonia,5742,238691,16,1867,0.7821828221424352
2022-01-16,EE,Estonia,15424,254115,28,1895,0.7457253605650984
2022-01-23,EE,Estonia,27269,281384,24,1919,0.6819861825832315
2022-01-30,EE,Estonia,41085,322469,25,1944,0.6028486459163517
2022-02-06,EE,Estonia,48031,370500,32,1976,0.5333333333333333
2022-02-13,EE,Estonia,37947,408447,45,2021,0.494801039057699
2022-02-20,EE,Estonia,39239,447686,54,2075,0.4634945028435108
2022-02-27,EE,Estonia,31712,479398,64,2139,0.44618458983975734
2022-03-06,EE,Estonia,22671,502069,59,2198,0.4377884314705748
2022-03-13,EE,Estonia,14983,517052,58,2256,0.43631975120490785
2022-03-20,EE,Estonia,10967,528019,33,2289,0.433507127584424
2022-03-27,EE,Estonia,9226,537245,40,2329,0.433507989837039
2022-04-03,EE,Estonia,6835,544080,22,2351,0.43210557270989564
2022-04-10,EE,Estonia,5185,549265,29,2380,0.43330632754681253
2022-04-17,EE,Estonia,3337,552602,22,2402,0.4346708842892353
2022-04-24,EE,Estonia,2756,555358,13,2415,0.43485463430795995
2022-05-01,EE,Estonia,2039,557397,9,2424,0.43487855155302235
2022-05-08,EE,Estonia,1489,558886,8,2432,0.4351513546590897
2022-05-15,EE,Estonia,1173,560059,3,2435,0.4347756218541261
2022-05-22,EE,Estonia,953,561012,5,2440,0.4349283081288814
2022-05-29,EE,Estonia,821,561833,8,2448,0.4357166631365548
2022-06-05,EE,Estonia,781,562614,10,2458,0.4368892348928395
2022-06-12,EE,Estonia,840,563454,2,2460,0.436592871822722
2022-06-19,EE,Estonia,822,564276,2,2462,0.43631130865037676
2022-06-26,EE,Estonia,798,565074,3,2465,0.4362260518091436
2022-07-03,EE,Estonia,1345,566419,8,2473,0.4366025857183463
2022-07-10,EE,Estonia,1161,567580,8,2481,0.43711899644103036
2022-07-17,EE,Estonia,1552,569132,4,2485,0.43662981522739885
2022-07-24,EE,Estonia,2007,571139,8,2493,0.4364961944465358
2022-07-31,EE,Estonia,2229,573368,8,2501,0.4361945556780288
2022-08-07,EE,Estonia,2239,575607,6,2507,0.4355402210188548
2022-08-14,EE,Estonia,1933,577540,8,2515,0.43546767323475427
2022-08-21,EE,Estonia,1426,578966,5,2520,0.4352587198557428
2022-08-28,EE,Estonia,1107,580073,4,2524,0.43511764898555877
2022-09-04,EE,Estonia,822,580895,6,2530,0.43553482126718257
2022-09-11,EE,Estonia,914,581809,4,2534,0.43553812333600894
2022-09-18,EE,Estonia,1189,582998,6,2540,0.4356790246278718
2022-09-25,EE,Estonia,1188,584186,14,2554,0.4371895252539431
2022-10-02,EE,Estonia,1316,585502,11,2565,0.438085608588869
2022-10-09,EE,Estonia,1196,586698,21,2586,0.44077191331826593
2022-10-16,EE,Estonia,1063,587761,16,2602,0.4426969465480017
2022-10-23,EE,Estonia,1055,588816,10,2612,0.4436020760305427
2022-10-30,EE,Estonia,733,589549,9,2621,0.44457712590471704
2022-11-06,EE,Estonia,553,590102,9,2630,0.4456856611229923
2022-11-13,EE,Estonia,490,590592,15,2645,0.44785571087993065
2022-11-20,EE,Estonia,491,591083,9,2654,0.44900631552590753
2022-11-27,EE,Estonia,474,591557,9,2663,0.450167946622219
2022-12-04,EE,Estonia,536,592093,9,2672,0.45128045763081137
2022-12-11,EE,Estonia,624,592717,15,2687,0.4533360777571759
2022-12-18,EE,Estonia,819,593536,23,2710,0.4565856156998059
2022-12-25,EE,Estonia,681,594217,17,2727,0.4589232553090874
2023-01-01,EE,Estonia,541,594758,19,2746,0.4617003890658049
2023-01-08,EE,Estonia,397,595155,13,2759,0.46357671530945715
2023-01-15,EE,Estonia,377,595532,12,2771,0.46529825433394
2023-01-22,EE,Estonia,301,595833,8,2779,0.46640585533194706
2023-01-29,EE,Estonia,384,596217,8,2787,0.4674472549424119
2023-02-05,EE,Estonia,306,596523,7,2794,0.4683809341802412
2023-02-12,EE,Estonia,328,596851,7,2801,0.46929635704723627
2023-02-19,EE,Estonia,322,597173,8,2809,0.4703829543532611
2023-02-26,EE,Estonia,271,597444,6,2815,0.47117386734154165
2023-03-05,EE,Estonia,305,597749,6,2821,0.47193721779542924
2023-03-12,EE,Estonia,312,598061,3,2824,0.47219263586824756
2023-03-19,EE,Estonia,364,598425,8,2832,0.4732422609349542
2023-03-26,EE,Estonia,349,598774,8,2840,0.4743024914241434
2023-04-02,EE,Estonia,382,599156,6,2846,0.47500150211297226
2023-04-09,EE,Estonia,392,599548,8,2854,0.47602527237185344
2023-04-16,EE,Estonia,365,599913,7,2861,0.4769024841935414
2023-04-23,EE,Estonia,330,600243,14,2875,0.4789726827301609
2023-04-30,EE,Estonia,284,600527,9,2884,0.48024485160534
2023-05-07,EE,Estonia,208,600735,1,2885,0.48024503316770295
2023-05-14,EE,Estonia,193,600928,3,2888,0.480590020767879
2023-05-21,EE,Estonia,181,601109,3,2891,0.4809443877899017
2023-05-28,EE,Estonia,149,601258,2,2893,0.4811578390640956
2023-06-04,EE,Estonia,120,601378,2,2895,0.4813943975336643
2023-06-11,EE,Estonia,96,601474,2,2897,0.4816500796376901
2023-06-18,EE,Estonia,63,601537,0,2897,0.48159963560013763
2023-06-25,EE,Estonia,51,601588,1,2898,0.48172503440893105
2023-07-02,EE,Estonia,36,601624,0,2898,0.4816962089278353
2023-07-09,EE,Estonia,31,601655,0,2898,0.4816713897499397
2023-07-16,EE,Estonia,44,601699,1,2899,0.48180236297550766
2023-07-23,EE,Estonia,47,601746,1,2900,0.48193091437250934
2023-07-30,EE,Estonia,0,601746,0,2900,0.48193091437250934
2023-08-06,EE,Estonia,27,601773,1,2901,0.4820754669950297
2023-08-13,EE,Estonia,17,601790,0,2901,0.48206184881769387
2023-08-20,EE,Estonia,23,601813,0,2901,0.4820434254494336
2023-08-27,EE,Estonia,38,601851,0,2901,0.48201298992607805
2023-09-03,EE,Estonia,60,601911,0,2901,0.48196494166081033
2023-09-10,EE,Estonia,85,601996,0,2901,0.48189688968033006
2023-09-17,EE,Estonia,90,602086,0,2901,0.4818248555854147
2023-09-24,EE,Estonia,101,602187,1,2902,0.4819101043363606
2023-10-01,EE,Estonia,108,602295,0,2902,0.4818236910484065
2023-10-08,EE,Estonia,82,602377,0,2902,0.4817581016539476
2023-10-15,EE,Estonia,101,602478,0,2902,0.48167733925554124
2023-10-22,EE,Estonia,158,602636,1,2903,0.4817169900238286
2023-10-29,EE,Estonia,273,602909,3,2906,0.4819964538595377
2023-11-05,EE,Estonia,427,603336,6,2912,0.4826498004428709
2023-11-12,EE,Estonia,474,603810,2,2914,0.4826021430582468
2023-11-19,EE,Estonia,529,604339,5,2919,0.4830070539879107
2023-11-26,EE,Estonia,591,604930,1,2920,0.48270047774122626
2023-12-03,EE,Estonia,706,605636,12,2932,0.4841191738932296
2023-12-10,EE,Estonia,744,606380,15,2947,0.48599887859098256
2023-12-17,EE,Estonia,808,607188,15,2962,0.48782255248786205
2023-12-24,EE,Estonia,777,607965,5,2967,0.4880215143963879
2023-12-31,EE,Estonia,616,608581,5,2972,0.48834912690340315
2024-01-07,EE,Estonia,358,608939,4,2976,0.4887189028786134
2024-01-14,EE,Estonia,0,608939,0,2976,0.4887189028786134
2020-05-03,SZ,Eswatini,52,108,0,1,0.9259259259259258
2020-05-24,SZ,Eswatini,36,238,0,2,0.8403361344537815
2020-05-31,SZ,Eswatini,45,283,0,2,0.7067137809187279
2020-06-07,SZ,Eswatini,50,333,1,3,0.9009009009009009
2020-06-14,SZ,Eswatini,153,486,0,3,0.6172839506172839
2020-06-21,SZ,Eswatini,141,627,2,5,0.7974481658692184
2021-01-10,FO,Faroe Islands,32,649,1,1,0.15408320493066258
2021-01-17,FO,Faroe Islands,3,652,0,1,0.15337423312883436
2021-01-24,FO,Faroe Islands,3,655,0,1,0.15267175572519084
2021-01-31,FO,Faroe Islands,2,657,0,1,0.15220700152207
2021-02-07,FO,Faroe Islands,1,658,0,1,0.1519756838905775
2021-02-14,FO,Faroe Islands,2,660,0,1,0.15151515151515152
2021-02-21,FO,Faroe Islands,1,661,0,1,0.15128593040847202
2021-02-28,FO,Faroe Islands,0,661,0,1,0.15128593040847202
2021-03-07,FO,Faroe Islands,0,661,0,1,0.15128593040847202
2021-03-14,FO,Faroe Islands,3,664,0,1,0.15060240963855423
2021-03-21,FO,Faroe Islands,0,664,0,1,0.15060240963855423
2021-03-28,FO,Faroe Islands,0,664,0,1,0.15060240963855423
2021-04-04,FO,Faroe Islands,0,664,0,1,0.15060240963855423
2021-04-11,FO,Faroe Islands,0,664,0,1,0.15060240963855423
2021-04-18,FO,Faroe Islands,1,665,0,1,0.15037593984962408
2021-04-25,FO,Faroe Islands,1,666,0,1,0.15015015015015015
2021-05-02,FO,Faroe Islands,1,667,0,1,0.14992503748125938
2021-05-09,FO,Faroe Islands,4,671,0,1,0.14903129657228018
2021-05-16,FO,Faroe Islands,2,673,0,1,0.1485884101040119
2021-05-23,FO,Faroe Islands,3,676,0,1,0.14792899408284024
2021-05-30,FO,Faroe Islands,39,715,0,1,0.13986013986013987
2021-06-06,FO,Faroe Islands,29,744,0,1,0.13440860215053765
2021-06-13,FO,Faroe Islands,14,758,0,1,0.13192612137203166
2021-06-20,FO,Faroe Islands,6,764,0,1,0.13089005235602094
2021-06-27,FO,Faroe Islands,10,774,0,1,0.12919896640826875
2021-07-04,FO,Faroe Islands,10,784,0,1,0.12755102040816327
2021-07-11,FO,Faroe Islands,64,848,0,1,0.1179245283018868
2021-07-18,FO,Faroe Islands,76,924,0,1,0.10822510822510822
2021-07-25,FO,Faroe Islands,49,973,0,1,0.10277492291880781
2021-08-01,FO,Faroe Islands,13,986,0,1,0.10141987829614604
2021-08-08,FO,Faroe Islands,5,991,1,2,0.20181634712411706
2021-08-15,FO,Faroe Islands,4,995,0,2,0.20100502512562815
2021-08-22,FO,Faroe Islands,3,998,0,2,0.2004008016032064
2021-08-29,FO,Faroe Islands,5,1003,0,2,0.19940179461615154
2021-09-05,FO,Faroe Islands,6,1009,0,2,0.19821605550049554
2021-09-12,FO,Faroe Islands,29,1038,0,2,0.1926782273603083
2021-09-19,FO,Faroe Islands,24,1062,0,2,0.18832391713747645
2021-09-26,FO,Faroe Islands,56,1118,0,2,0.17889087656529518
2021-10-03,FO,Faroe Islands,95,1213,0,2,0.16488046166529266
2021-10-10,FO,Faroe Islands,69,1282,0,2,0.15600624024961
2021-10-17,FO,Faroe Islands,61,1343,0,2,0.14892032762472077
2021-10-24,FO,Faroe Islands,197,1540,0,2,0.12987012987012986
2021-10-31,FO,Faroe Islands,546,2086,0,2,0.09587727708533077
2021-11-07,FO,Faroe Islands,505,2591,3,5,0.19297568506368198
2021-11-14,FO,Faroe Islands,318,2909,2,7,0.24063251976624267
2021-11-21,FO,Faroe Islands,265,3174,5,12,0.3780718336483932
2021-11-28,FO,Faroe Islands,302,3476,1,13,0.3739930955120829
2021-12-05,FO,Faroe Islands,387,3863,0,13,0.3365260160497023
2021-12-12,FO,Faroe Islands,479,4342,0,13,0.29940119760479045
2021-12-19,FO,Faroe Islands,363,4705,0,13,0.27630180658873543
2021-12-26,FO,Faroe Islands,445,5150,0,13,0.2524271844660194
2022-01-02,FO,Faroe Islands,936,6086,1,14,0.23003614853762733
2022-01-09,FO,Faroe Islands,1473,7559,1,15,0.19843894695065487
2022-01-16,FO,Faroe Islands,2210,9769,0,15,0.15354693417954754
2022-01-23,FO,Faroe Islands,4062,13831,2,17,0.12291229845998121
2022-01-30,FO,Faroe Islands,4791,18622,1,18,0.09665986467618945
2022-02-06,FO,Faroe Islands,4973,23595,2,20,0.0847637211273575
2022-02-13,FO,Faroe Islands,4835,28430,2,22,0.07738304607808652
2022-02-20,FO,Faroe Islands,3454,31884,2,24,0.07527286413248024
2022-02-27,FO,Faroe Islands,2254,34138,4,28,0.08202003632315895
2022-03-06,FO,Faroe Islands,520,34658,0,28,0.08078942812626233
2022-03-13,FO,Faroe Islands,0,34658,0,28,0.08078942812626233
2022-03-20,FO,Faroe Islands,0,34658,0,28,0.08078942812626233
2022-03-27,FO,Faroe Islands,0,34658,0,28,0.08078942812626233
2022-04-03,FO,Faroe Islands,0,34658,0,28,0.08078942812626233
2022-04-10,FO,Faroe Islands,0,34658,0,28,0.08078942812626233
2022-04-17,FO,Faroe Islands,0,34658,0,28,0.08078942812626233
2022-04-24,FO,Faroe Islands,0,34658,0,28,0.08078942812626233
2022-05-01,FO,Faroe Islands,0,34658,0,28,0.08078942812626233
2022-05-08,FO,Faroe Islands,0,34658,0,28,0.08078942812626233
2022-05-15,FO,Faroe Islands,0,34658,0,28,0.08078942812626233
2022-05-22,FO,Faroe Islands,0,34658,0,28,0.08078942812626233
2022-05-29,FO,Faroe Islands,0,34658,0,28,0.08078942812626233
2022-06-05,FO,Faroe Islands,0,34658,0,28,0.08078942812626233
2022-06-12,FO,Faroe Islands,0,34658,0,28,0.08078942812626233
2022-06-19,FO,Faroe Islands,0,34658,0,28,0.08078942812626233
2022-06-26,FO,Faroe Islands,0,34658,0,28,0.08078942812626233
2022-07-03,FO,Faroe Islands,0,34658,0,28,0.08078942812626233
2022-07-10,FO,Faroe Islands,0,34658,0,28,0.08078942812626233
2022-07-17,FO,Faroe Islands,0,34658,0,28,0.08078942812626233
2022-07-24,FO,Faroe Islands,0,34658,0,28,0.08078942812626233
2022-07-31,FO,Faroe Islands,0,34658,0,28,0.08078942812626233
2022-08-07,FO,Faroe Islands,0,34658,0,28,0.08078942812626233
2022-08-14,FO,Faroe Islands,0,34658,0,28,0.08078942812626233
2022-08-21,FO,Faroe Islands,0,34658,0,28,0.08078942812626233
2022-08-28,FO,Faroe Islands,0,34658,0,28,0.08078942812626233
2022-09-04,FO,Faroe Islands,0,34658,0,28,0.08078942812626233
2022-09-11,FO,Faroe Islands,0,34658,0,28,0.08078942812626233
2022-09-18,FO,Faroe Islands,0,34658,0,28,0.08078942812626233
2022-09-25,FO,Faroe Islands,0,34658,0,28,0.08078942812626233
2022-10-02,FO,Faroe Islands,0,34658,0,28,0.08078942812626233
2022-10-09,FO,Faroe Islands,0,34658,0,28,0.08078942812626233
2022-10-16,FO,Faroe Islands,0,34658,0,28,0.08078942812626233
2022-10-23,FO,Faroe Islands,0,34658,0,28,0.08078942812626233
2022-10-30,FO,Faroe Islands,0,34658,0,28,0.08078942812626233
2022-11-06,FO,Faroe Islands,0,34658,0,28,0.08078942812626233
2022-11-13,FO,Faroe Islands,0,34658,0,28,0.08078942812626233
2022-11-20,FO,Faroe Islands,0,34658,0,28,0.08078942812626233
2022-11-27,FO,Faroe Islands,0,34658,0,28,0.08078942812626233
2022-12-04,FO,Faroe Islands,0,34658,0,28,0.08078942812626233
2022-12-11,FO,Faroe Islands,0,34658,0,28,0.08078942812626233
2022-12-18,FO,Faroe Islands,0,34658,0,28,0.08078942812626233
2022-12-25,FO,Faroe Islands,0,34658,0,28,0.08078942812626233
2023-01-01,FO,Faroe Islands,0,34658,0,28,0.08078942812626233
2023-01-08,FO,Faroe Islands,0,34658,0,28,0.08078942812626233
2023-01-15,FO,Faroe Islands,0,34658,0,28,0.08078942812626233
2023-01-22,FO,Faroe Islands,0,34658,0,28,0.08078942812626233
2023-01-29,FO,Faroe Islands,0,34658,0,28,0.08078942812626233
2023-02-05,FO,Faroe Islands,0,34658,0,28,0.08078942812626233
2023-02-12,FO,Faroe Islands,0,34658,0,28,0.08078942812626233
2023-02-19,FO,Faroe Islands,0,34658,0,28,0.08078942812626233
2023-02-26,FO,Faroe Islands,0,34658,0,28,0.08078942812626233
2023-03-05,FO,Faroe Islands,0,34658,0,28,0.08078942812626233
2023-03-12,FO,Faroe Islands,0,34658,0,28,0.08078942812626233
2023-03-19,FO,Faroe Islands,0,34658,0,28,0.08078942812626233
2023-03-26,FO,Faroe Islands,0,34658,0,28,0.08078942812626233
2023-04-02,FO,Faroe Islands,0,34658,0,28,0.08078942812626233
2023-04-09,FO,Faroe Islands,0,34658,0,28,0.08078942812626233
2023-04-16,FO,Faroe Islands,0,34658,0,28,0.08078942812626233
2023-04-23,FO,Faroe Islands,0,34658,0,28,0.08078942812626233
2023-04-30,FO,Faroe Islands,0,34658,0,28,0.08078942812626233
2023-05-07,FO,Faroe Islands,0,34658,0,28,0.08078942812626233
2023-05-14,FO,Faroe Islands,0,34658,0,28,0.08078942812626233
2023-05-21,FO,Faroe Islands,0,34658,0,28,0.08078942812626233
2023-05-28,FO,Faroe Islands,0,34658,0,28,0.08078942812626233
2023-06-04,FO,Faroe Islands,0,34658,0,28,0.08078942812626233
2023-06-11,FO,Faroe Islands,0,34658,0,28,0.08078942812626233
2023-06-18,FO,Faroe Islands,0,34658,0,28,0.08078942812626233
2023-06-25,FO,Faroe Islands,0,34658,0,28,0.08078942812626233
2023-07-02,FO,Faroe Islands,0,34658,0,28,0.08078942812626233
2023-07-09,FO,Faroe Islands,0,34658,0,28,0.08078942812626233
2023-07-16,FO,Faroe Islands,0,34658,0,28,0.08078942812626233
2023-07-23,FO,Faroe Islands,0,34658,0,28,0.08078942812626233
2023-07-30,FO,Faroe Islands,0,34658,0,28,0.08078942812626233
2023-08-06,FO,Faroe Islands,0,34658,0,28,0.08078942812626233
2023-08-13,FO,Faroe Islands,0,34658,0,28,0.08078942812626233
2023-08-20,FO,Faroe Islands,0,34658,0,28,0.08078942812626233
2023-08-27,FO,Faroe Islands,0,34658,0,28,0.08078942812626233
2023-09-03,FO,Faroe Islands,0,34658,0,28,0.08078942812626233
2023-09-10,FO,Faroe Islands,0,34658,0,28,0.08078942812626233
2023-09-17,FO,Faroe Islands,0,34658,0,28,0.08078942812626233
2023-09-24,FO,Faroe Islands,0,34658,0,28,0.08078942812626233
2023-10-01,FO,Faroe Islands,0,34658,0,28,0.08078942812626233
2023-10-08,FO,Faroe Islands,0,34658,0,28,0.08078942812626233
2023-10-15,FO,Faroe Islands,0,34658,0,28,0.08078942812626233
2023-10-22,FO,Faroe Islands,0,34658,0,28,0.08078942812626233
2023-10-29,FO,Faroe Islands,0,34658,0,28,0.08078942812626233
2023-11-05,FO,Faroe Islands,0,34658,0,28,0.08078942812626233
2023-11-12,FO,Faroe Islands,0,34658,0,28,0.08078942812626233
2023-11-19,FO,Faroe Islands,0,34658,0,28,0.08078942812626233
2023-11-26,FO,Faroe Islands,0,34658,0,28,0.08078942812626233
2023-12-03,FO,Faroe Islands,0,34658,0,28,0.08078942812626233
2023-12-10,FO,Faroe Islands,0,34658,0,28,0.08078942812626233
2023-12-17,FO,Faroe Islands,0,34658,0,28,0.08078942812626233
2023-12-24,FO,Faroe Islands,0,34658,0,28,0.08078942812626233
2023-12-31,FO,Faroe Islands,0,34658,0,28,0.08078942812626233
2024-01-07,FO,Faroe Islands,0,34658,0,28,0.08078942812626233
2024-01-14,FO,Faroe Islands,0,34658,0,28,0.08078942812626233
2021-06-06,FJ,Fiji,286,687,0,4,0.5822416302765648
2021-06-13,FJ,Fiji,430,1117,0,4,0.35810205908683973
2021-06-20,FJ,Fiji,847,1964,3,7,0.3564154786150713
2021-06-27,FJ,Fiji,1627,3591,8,15,0.4177109440267335
2021-07-04,FJ,Fiji,2570,6161,15,30,0.48693393929556894
2021-07-11,FJ,Fiji,4351,10512,25,55,0.5232115677321156
2021-07-18,FJ,Fiji,7002,17514,43,98,0.5595523581135092
2021-07-25,FJ,Fiji,5625,23139,88,186,0.803837676649812
2021-08-01,FJ,Fiji,7274,30413,55,241,0.7924242922434485
2021-08-08,FJ,Fiji,6566,36979,58,299,0.8085670245274346
2021-08-15,FJ,Fiji,3258,40237,72,371,0.9220369311827422
2020-03-08,FI,Finland,112,120,1,1,0.8333333333333334
2021-07-04,FI,Finland,2048,99640,5,986,0.9895624247290244
2021-07-11,FI,Finland,2602,102242,2,988,0.966334774358874
2021-07-18,FI,Finland,4208,106450,12,1000,0.9394081728511038
2021-07-25,FI,Finland,4968,111418,12,1012,0.9082912994309716
2021-08-01,FI,Finland,5280,116698,10,1022,0.8757647945980221
2021-08-08,FI,Finland,4491,121189,10,1032,0.8515624355345782
2021-08-15,FI,Finland,4110,125299,11,1043,0.8324088779639104
2021-08-22,FI,Finland,4299,129598,14,1057,0.8155990061575025
2021-08-29,FI,Finland,3239,132837,13,1070,0.8054984680473061
2021-09-05,FI,Finland,3013,135850,11,1081,0.7957305852042694
2021-09-12,FI,Finland,2851,138701,14,1095,0.7894679922999834
2021-09-19,FI,Finland,3729,142430,21,1116,0.7835427929509232
2021-09-26,FI,Finland,4133,146563,29,1145,0.7812340085833396
2021-10-03,FI,Finland,3916,150479,31,1176,0.7815043959622273
2021-10-10,FI,Finland,3586,154065,18,1194,0.7749975659624184
2021-10-17,FI,Finland,4087,158152,41,1235,0.7808943295057919
2021-10-24,FI,Finland,4805,162957,40,1275,0.7824149929122406
2021-10-31,FI,Finland,5725,168682,55,1330,0.7884658706915972
2021-11-07,FI,Finland,6973,175655,49,1379,0.7850616264837323
2021-11-14,FI,Finland,7953,183608,60,1439,0.7837349135113938
2021-11-21,FI,Finland,8925,192533,58,1497,0.7775290469685716
2021-11-28,FI,Finland,9936,202469,44,1541,0.7611041690332842
2021-12-05,FI,Finland,12486,214955,47,1588,0.7387592751971342
2021-12-12,FI,Finland,19191,234146,47,1635,0.698282268328308
2021-12-19,FI,Finland,36453,270599,83,1718,0.6348877859859053
2021-12-26,FI,Finland,52236,322835,118,1836,0.5687115709263246
2022-01-02,FI,Finland,61448,384283,130,1966,0.5116021265577712
2022-01-09,FI,Finland,59617,443900,137,2103,0.4737553503041225
2022-01-16,FI,Finland,50478,494378,119,2222,0.44945365691839034
2022-01-23,FI,Finland,45303,539681,140,2362,0.4376659545175761
2022-01-30,FI,Finland,45279,584960,122,2484,0.424644420131291
2022-02-06,FI,Finland,44745,629705,131,2615,0.41527381869288
2022-02-13,FI,Finland,45014,674719,156,2771,0.4106894870308973
2022-02-20,FI,Finland,44912,719631,161,2932,0.40743103062541774
2022-02-27,FI,Finland,48818,768449,191,3123,0.40640302739674333
2022-03-06,FI,Finland,54053,822502,208,3331,0.4049838176685284
2022-03-13,FI,Finland,54223,876725,255,3586,0.4090222133508226
2022-03-20,FI,Finland,48332,925057,211,3797,0.41046119320214863
2022-03-27,FI,Finland,38754,963811,200,3997,0.41470786284862904
2022-04-03,FI,Finland,33726,997537,205,4202,0.4212375079821601
2022-04-10,FI,Finland,26539,1024076,151,4353,0.42506610837476905
2022-04-17,FI,Finland,20917,1044993,139,4492,0.42985933877069027
2022-04-24,FI,Finland,17852,1062845,84,4576,0.4305425532415357
2022-05-01,FI,Finland,15720,1078565,82,4658,0.4318701237292143
2022-05-08,FI,Finland,11808,1090373,80,4738,0.4345302020501241
2022-05-15,FI,Finland,10247,1100620,76,4814,0.43738983482037397
2022-05-22,FI,Finland,11545,1112165,44,4858,0.43680568980322165
2022-05-29,FI,Finland,10612,1122777,62,4920,0.43819921498213804
2022-06-05,FI,Finland,10572,1133349,62,4982,0.43958215871721773
2022-06-12,FI,Finland,11536,1144885,53,5035,0.4397821615271403
2022-06-19,FI,Finland,11488,1156373,56,5091,0.44025586899728725
2022-06-26,FI,Finland,11565,1167938,82,5173,0.44291734663997573
2022-07-03,FI,Finland,14574,1182512,86,5259,0.4447312162582705
2022-07-10,FI,Finland,16971,1199483,92,5351,0.4461088652361059
2022-07-17,FI,Finland,17749,1217232,111,5462,0.4487230043245659
2022-07-24,FI,Finland,15829,1233061,108,5570,0.45172136658283735
2022-07-31,FI,Finland,13367,1246428,121,5691,0.45658473654314574
2022-08-07,FI,Finland,11624,1258052,104,5795,0.4606327878338892
2022-08-14,FI,Finland,7926,1265978,75,5870,0.46367314439903384
2022-08-21,FI,Finland,6134,1272112,59,5929,0.46607531412328473
2022-08-28,FI,Finland,6404,1278516,79,6008,0.46991981328352556
2022-09-04,FI,Finland,8414,1286930,105,6113,0.4750064106050834
2022-09-11,FI,Finland,8323,1295253,92,6205,0.47905698732216795
2022-09-18,FI,Finland,10024,1305277,142,6347,0.48625694009777237
2022-09-25,FI,Finland,12296,1317573,168,6515,0.4944697561349542
2022-10-02,FI,Finland,13920,1331493,201,6716,0.5043961928451746
2022-10-09,FI,Finland,13466,1344959,213,6929,0.515182990708267
2022-10-16,FI,Finland,12837,1357796,178,7107,0.5234217805914879
2022-10-23,FI,Finland,12153,1369949,189,7296,0.5325745702942226
2022-10-30,FI,Finland,12416,1382365,206,7502,0.5426931382087943
2022-11-06,FI,Finland,12234,1394599,172,7674,0.5502657036180293
2022-11-13,FI,Finland,11580,1406179,158,7832,0.5569703430359862
2022-11-20,FI,Finland,11967,1418146,140,7972,0.5621424028273534
2022-11-27,FI,Finland,11488,1429634,164,8136,0.5690967058701738
2022-12-04,FI,Finland,10908,1440542,142,8278,0.5746448211853594
2022-12-11,FI,Finland,8283,1448825,163,8441,0.5826100460718169
2022-12-18,FI,Finland,4406,1453231,135,8576,0.590133296083004
2022-12-25,FI,Finland,2918,1456149,122,8698,0.5973289821302628
2023-01-01,FI,Finland,1521,1457670,77,8775,0.6019881043034432
2023-01-08,FI,Finland,1003,1458673,49,8824,0.6049333880862949
2023-01-15,FI,Finland,715,1459388,36,8860,0.6071037996749322
2023-01-22,FI,Finland,648,1460036,34,8894,0.6091630617327244
2023-01-29,FI,Finland,579,1460615,22,8916,0.6104277992489465
2023-02-05,FI,Finland,570,1461185,24,8940,0.6118321773081438
2023-02-12,FI,Finland,651,1461836,43,8983,0.614501216278707
2023-02-19,FI,Finland,693,1462529,29,9012,0.6161929096790559
2023-02-26,FI,Finland,747,1463276,30,9042,0.6179285384302073
2023-03-05,FI,Finland,838,1464114,39,9081,0.6202385879788049
2023-03-12,FI,Finland,1155,1465269,43,9124,0.6226842989239518
2023-03-19,FI,Finland,1391,1466660,78,9202,0.6274119427815581
2023-03-26,FI,Finland,1522,1468182,84,9286,0.632482893810168
2023-04-02,FI,Finland,1721,1469903,74,9360,0.6367767124769458
2023-04-09,FI,Finland,1811,1471714,104,9464,0.6430597249193797
2023-04-16,FI,Finland,1978,1473692,97,9561,0.6487787135982281
2023-04-23,FI,Finland,1690,1475382,97,9658,0.6546101280888611
2023-04-30,FI,Finland,1483,1476865,90,9748,0.6600467882981856
2023-05-07,FI,Finland,1325,1478190,71,9819,0.6642583159133806
2023-05-14,FI,Finland,979,1479169,69,9888,0.6684834525331453
2023-05-21,FI,Finland,734,1479903,35,9923,0.6705169190142867
2023-05-28,FI,Finland,605,1480508,35,9958,0.6726069700400134
2023-06-04,FI,Finland,628,1481136,58,10016,0.6762376986313208
2023-06-11,FI,Finland,531,1481667,41,10057,0.6787625019656913
2023-06-18,FI,Finland,335,1482002,29,10086,0.6805658831769458
2023-06-25,FI,Finland,226,1482228,21,10107,0.6818789012216744
2023-07-02,FI,Finland,194,1482422,12,10119,0.6825991519283983
2023-07-09,FI,Finland,155,1482577,13,10132,0.6834046393543135
2023-07-16,FI,Finland,164,1482741,13,10145,0.6842058053294541
2023-07-23,FI,Finland,174,1482915,11,10156,0.6848673052737345
2023-07-30,FI,Finland,187,1483102,18,10174,0.6859946247796848
2023-08-06,FI,Finland,246,1483348,15,10189,0.6868920846625336
2023-08-13,FI,Finland,234,1483582,16,10205,0.6878622145590874
2023-08-20,FI,Finland,315,1483897,22,10227,0.6891987786214272
2023-08-27,FI,Finland,346,1484243,22,10249,0.6905203527993732
2023-09-03,FI,Finland,436,1484679,31,10280,0.6924055637615942
2023-09-10,FI,Finland,492,1485171,28,10308,0.6940614919090125
2023-09-17,FI,Finland,564,1485735,36,10344,0.6962210623024967
2023-09-24,FI,Finland,624,1486359,51,10395,0.6993599796549824
2023-10-01,FI,Finland,842,1487201,74,10469,0.7039398171464382
2023-10-08,FI,Finland,1241,1488442,90,10559,0.7093994928925682
2023-10-15,FI,Finland,1935,1490377,119,10678,0.7164630157336029
2023-10-22,FI,Finland,2857,1493234,114,10792,0.7227266456563406
2023-10-29,FI,Finland,3629,1496863,59,10851,0.7249160410805798
2023-11-05,FI,Finland,2585,1499448,164,11015,0.734603667482967
2023-11-12,FI,Finland,264,1499712,204,11219,0.7480769641104426
2023-11-19,FI,Finland,0,1499712,108,11327,0.7552783467759143
2023-11-26,FI,Finland,0,1499712,7,11334,0.7557451030597875
2023-12-03,FI,Finland,0,1499712,15,11349,0.7567452950966586
2023-12-10,FI,Finland,0,1499712,16,11365,0.7578121666026544
2023-12-17,FI,Finland,0,1499712,15,11380,0.7588123586395255
2023-12-24,FI,Finland,0,1499712,5,11385,0.7591457559851492
2023-12-31,FI,Finland,0,1499712,6,11391,0.7595458327998975
2024-01-07,FI,Finland,0,1499712,1,11392,0.7596125122690223
2024-01-14,FI,Finland,0,1499712,0,11392,0.7596125122690223
2022-01-16,FR,France,1961912,13538779,1499,128463,0.9488521823127477
2022-01-23,FR,France,2417043,15955822,1658,130121,0.8155079694421259
2022-01-30,FR,France,2329374,18285196,1933,132054,0.72219078209498
2022-02-06,FR,France,1707588,19992784,1996,134050,0.6704919134823845
2022-02-13,FR,France,958639,20951423,1988,136038,0.6493019591079804
2022-02-20,FR,France,565947,21517370,1745,137783,0.6403338326198788
2022-02-27,FR,France,393549,21910919,1331,139114,0.6349071894245969
2022-03-06,FR,France,348284,22259203,1094,140208,0.6298877816964066
2022-03-13,FR,France,419228,22678431,820,141028,0.6218595986644755
2022-03-20,FR,France,586328,23264759,792,141820,0.6095915285432357
2022-03-27,FR,France,851993,24116752,727,142547,0.5910704725080724
2022-04-03,FR,France,959358,25076110,801,143348,0.5716516636751076
2022-04-10,FR,France,928373,26004483,788,144136,0.5542736611991094
2022-04-17,FR,France,822438,26826921,852,144988,0.5404571027737398
2022-04-24,FR,France,539161,27366082,889,145877,0.5330576733636916
2022-05-01,FR,France,376510,27742592,867,146744,0.5289484126068682
2022-05-08,FR,France,264928,28007520,749,147493,0.5266192793935343
2022-05-15,FR,France,216715,28224235,614,148107,0.5247511580030425
2022-05-22,FR,France,162239,28386474,466,148573,0.523393641633688
2022-05-29,FR,France,113355,28499829,300,148873,0.5223645376959981
2022-06-05,FR,France,148073,28647902,329,149202,0.5208130075284396
2022-06-12,FR,France,193813,28841715,237,149439,0.5181349306031212
2022-06-19,FR,France,297927,29139642,265,149704,0.5137468744468446
2022-06-26,FR,France,456705,29596347,291,149995,0.5068024104461271
2022-07-03,FR,France,731586,30327933,264,150259,0.49544754665608104
2022-07-10,FR,France,903969,31231902,424,150683,0.48246501285768634
2022-07-17,FR,France,683784,31915686,585,151268,0.47396129915553126
2022-07-24,FR,France,522296,32437982,731,151999,0.46858340324623154
2022-07-31,FR,France,329431,32767413,597,152596,0.46569437752073983
2022-08-07,FR,France,212195,32979608,529,153125,0.4643020620499795
2022-08-14,FR,France,151186,33130794,518,153643,0.4637468090864348
2022-08-21,FR,France,119216,33250010,413,154056,0.46332617644325524
2022-08-28,FR,France,117039,33367049,317,154373,0.46265104235019405
2022-09-04,FR,France,106571,33473620,302,154675,0.46208028889615166
2022-09-11,FR,France,112374,33585994,263,154938,0.4613172979188885
2022-09-18,FR,France,188853,33774847,202,155140,0.4593359075764281
2022-09-25,FR,France,230732,34005579,217,155357,0.4568573880185954
2022-10-02,FR,France,310114,34315693,217,155574,0.45336109050748297
2022-10-09,FR,France,385474,34701167,314,155888,0.44922984866762555
2022-10-16,FR,France,392073,35093240,414,156302,0.4453906222394968
2022-10-23,FR,France,348646,35441886,522,156824,0.44248209590200704
2022-10-30,FR,France,222885,35664771,495,157319,0.44110475292270906
2022-11-06,FR,France,153617,35818388,445,157764,0.44045533260737474
2022-11-13,FR,France,151055,35969443,397,158161,0.4397093388407488
2022-11-20,FR,France,221689,36191132,469,158630,0.438311794171014
2022-11-27,FR,France,293632,36484764,455,159085,0.43603132529512867
2022-12-04,FR,France,384070,36868834,485,159570,0.43280457418317053
2022-12-11,FR,France,429679,37298513,569,160139,0.42934419396290674
2022-12-18,FR,France,391192,37689705,721,160860,0.42680089960905765
2022-12-25,FR,France,299842,37989547,807,161667,0.4255565353279943
2023-01-01,FR,France,151707,38141254,808,162475,0.4259823234967576
2023-01-08,FR,France,80829,38222083,775,163250,0.42710911385965017
2023-01-15,FR,France,43524,38265607,506,163756,0.4279456484252295
2023-01-22,FR,France,31693,38297300,398,164154,0.42863073898159926
2023-01-29,FR,France,29999,38327299,326,164480,0.42914581588439094
2023-02-05,FR,France,26127,38353426,260,164740,0.42953138006497776
2023-02-12,FR,France,22545,38375971,171,164911,0.42972463159303514
2023-02-19,FR,France,24116,38400087,180,165091,0.42992350512122535
2023-02-26,FR,France,26274,38426361,170,165261,0.43007194982631847
2023-03-05,FR,France,25318,38451679,152,165413,0.4301840759671379
2023-03-12,FR,France,35851,38487530,125,165538,0.43010814152012355
2023-03-19,FR,France,46305,38533835,163,165701,0.4300142978242368
2023-03-26,FR,France,54593,38588428,168,165869,0.4298412985364421
2023-04-02,FR,France,57282,38645710,210,166079,0.42974757094642585
2023-04-09,FR,France,55344,38701054,188,166267,0.42961879022726357
2023-04-16,FR,France,52509,38753563,162,166429,0.4294547058808502
2023-04-23,FR,France,48578,38802141,280,166709,0.42963866349539837
2023-04-30,FR,France,40443,38842584,249,166958,0.4298323716053494
2023-05-07,FR,France,31332,38873916,239,167197,0.43010073901481904
2023-05-14,FR,France,24280,38898196,160,167357,0.4302436030709496
2023-05-21,FR,France,20650,38918846,132,167489,0.4303544868725038
2023-05-28,FR,France,25230,38944076,149,167638,0.4304582807408244
2023-06-04,FR,France,18614,38962690,112,167750,0.4305400884795172
2023-06-11,FR,France,15618,38978308,106,167856,0.4306395239116074
2023-06-18,FR,France,11200,38989508,67,167923,0.43068766089584926
2023-06-25,FR,France,7982,38997490,62,167985,0.4307584924055368
2023-07-02,FR,France,0,38997490,0,167985,0.4307584924055368
2023-07-09,FR,France,0,38997490,0,167985,0.4307584924055368
2023-07-16,FR,France,0,38997490,0,167985,0.4307584924055368
2023-07-23,FR,France,0,38997490,0,167985,0.4307584924055368
2023-07-30,FR,France,0,38997490,0,167985,0.4307584924055368
2023-08-06,FR,France,0,38997490,0,167985,0.4307584924055368
2023-08-13,FR,France,0,38997490,0,167985,0.4307584924055368
2023-08-20,FR,France,0,38997490,0,167985,0.4307584924055368
2023-08-27,FR,France,0,38997490,0,167985,0.4307584924055368
2023-09-03,FR,France,0,38997490,0,167985,0.4307584924055368
2023-09-10,FR,France,0,38997490,0,167985,0.4307584924055368
2023-09-17,FR,France,0,38997490,0,167985,0.4307584924055368
2023-09-24,FR,France,0,38997490,0,167985,0.4307584924055368
2023-10-01,FR,France,0,38997490,0,167985,0.4307584924055368
2023-10-08,FR,France,0,38997490,0,167985,0.4307584924055368
2023-10-15,FR,France,0,38997490,0,167985,0.4307584924055368
2023-10-22,FR,France,0,38997490,0,167985,0.4307584924055368
2023-10-29,FR,France,0,38997490,0,167985,0.4307584924055368
2023-11-05,FR,France,0,38997490,0,167985,0.4307584924055368
2023-11-12,FR,France,0,38997490,0,167985,0.4307584924055368
2023-11-19,FR,France,0,38997490,0,167985,0.4307584924055368
2023-11-26,FR,France,0,38997490,0,167985,0.4307584924055368
2023-12-03,FR,France,0,38997490,0,167985,0.4307584924055368
2023-12-10,FR,France,0,38997490,0,167985,0.4307584924055368
2023-12-17,FR,France,0,38997490,0,167985,0.4307584924055368
2023-12-24,FR,France,0,38997490,0,167985,0.4307584924055368
2023-12-31,FR,France,0,38997490,0,167985,0.4307584924055368
2024-01-07,FR,France,0,38997490,0,167985,0.4307584924055368
2024-01-14,FR,France,0,38997490,0,167985,0.4307584924055368
2020-04-26,GF,French Guiana,13,109,1,1,0.9174311926605505
2020-05-03,GF,French Guiana,19,128,0,1,0.78125
2020-05-10,GF,French Guiana,13,141,0,1,0.7092198581560284
2020-05-17,GF,French Guiana,48,189,0,1,0.5291005291005291
2020-05-24,GF,French Guiana,72,261,0,1,0.38314176245210724
2020-05-31,GF,French Guiana,175,436,0,1,0.22935779816513763
2020-06-07,GF,French Guiana,203,639,0,1,0.1564945226917058
2020-06-14,GF,French Guiana,522,1161,1,2,0.17226528854435832
2020-06-21,GF,French Guiana,1002,2163,3,5,0.2311604253351826
2020-06-28,GF,French Guiana,1298,3461,7,12,0.34672060098237506
2020-07-05,GF,French Guiana,1452,4913,4,16,0.3256665988194586
2020-07-12,GF,French Guiana,1036,5949,10,26,0.43704824340225246
2020-07-19,GF,French Guiana,706,6655,11,37,0.5559729526671675
2020-07-26,GF,French Guiana,677,7332,4,41,0.5591925804691762
2020-08-02,GF,French Guiana,525,7857,2,43,0.5472826778668703
2020-08-09,GF,French Guiana,410,8267,5,48,0.5806217491230192
2020-08-16,GF,French Guiana,321,8588,5,53,0.6171401956217979
2020-08-23,GF,French Guiana,209,8797,2,55,0.6252131408434694
2020-08-30,GF,French Guiana,279,9076,3,58,0.639048038783605
2020-09-06,GF,French Guiana,246,9322,4,62,0.6650933276121004
2020-09-13,GF,French Guiana,199,9521,1,63,0.6616952000840248
2020-09-20,GF,French Guiana,171,9692,2,65,0.6706562113082956
2020-09-27,GF,French Guiana,171,9863,0,65,0.659028693095407
2020-10-04,GF,French Guiana,166,10029,2,67,0.6680626184066207
2020-10-11,GF,French Guiana,115,10144,2,69,0.680205047318612
2020-10-18,GF,French Guiana,95,10239,0,69,0.6738939349545854
2020-10-25,GF,French Guiana,137,10376,0,69,0.6649961449498843
2020-11-01,GF,French Guiana,160,10536,1,70,0.6643887623386484
2020-11-08,GF,French Guiana,168,10704,0,70,0.6539611360239163
2020-11-15,GF,French Guiana,140,10844,0,70,0.6455182589450387
2020-11-22,GF,French Guiana,170,11014,0,70,0.6355547485019067
2020-11-29,GF,French Guiana,165,11179,0,70,0.6261740763932373
2020-12-06,GF,French Guiana,228,11407,1,71,0.6224248268606996
2020-12-13,GF,French Guiana,393,11800,0,71,0.6016949152542372
2020-12-20,GF,French Guiana,569,12369,0,71,0.574015684372221
2020-12-27,GF,French Guiana,404,12773,0,71,0.5558600172238315
2021-01-03,GF,French Guiana,500,13273,0,71,0.5349205153318768
2021-01-10,GF,French Guiana,840,14113,3,74,0.5243392616736342
2021-01-17,GF,French Guiana,862,14975,1,75,0.5008347245409015
2021-01-24,GF,French Guiana,689,15664,1,76,0.4851889683350358
2021-01-31,GF,French Guiana,419,16083,0,76,0.472548653858111
2021-02-07,GF,French Guiana,213,16296,3,79,0.4847815414825724
2021-02-14,GF,French Guiana,160,16456,1,80,0.48614487117160915
2021-02-21,GF,French Guiana,73,16529,3,83,0.5021477403351685
2021-02-28,GF,French Guiana,98,16627,2,85,0.5112166957358513
2021-03-07,GF,French Guiana,66,16693,2,87,0.5211765410651171
2021-03-14,GF,French Guiana,71,16764,0,87,0.5189692197566214
2021-03-21,GF,French Guiana,0,16764,0,87,0.5189692197566214
2021-03-28,GF,French Guiana,158,16922,2,89,0.5259425599810897
2021-04-04,GF,French Guiana,210,17132,4,93,0.5428438010740135
2021-04-11,GF,French Guiana,417,17549,1,94,0.5356430565844208
2021-04-18,GF,French Guiana,532,18081,1,95,0.5254134173994801
2021-04-25,GF,French Guiana,745,18826,3,98,0.5205566769361522
2021-05-02,GF,French Guiana,717,19543,3,101,0.516809087652868
2021-05-09,GF,French Guiana,823,20366,3,104,0.5106550132573897
2021-05-16,GF,French Guiana,1099,21465,4,108,0.5031446540880503
2021-05-23,GF,French Guiana,1315,22780,4,112,0.4916593503072871
2021-05-30,GF,French Guiana,983,23763,4,116,0.48815385262803523
2021-06-06,GF,French Guiana,962,24725,5,121,0.48938321536905965
2021-06-13,GF,French Guiana,781,25506,12,133,0.521445934289971
2021-06-20,GF,French Guiana,944,26450,8,141,0.5330812854442344
2021-06-27,GF,French Guiana,836,27286,1,142,0.5204133988125779
2021-07-04,GF,French Guiana,444,27730,6,148,0.5337179949513162
2021-07-11,GF,French Guiana,551,28281,9,157,0.5551430288886532
2021-07-18,GF,French Guiana,522,28803,6,163,0.5659132729229595
2021-07-25,GF,French Guiana,730,29533,11,174,0.589171435343514
2021-08-01,GF,French Guiana,631,30164,13,187,0.6199443044689034
2021-08-08,GF,French Guiana,711,30875,6,193,0.6251012145748988
2021-08-15,GF,French Guiana,951,31826,5,198,0.6221328473575064
2021-08-22,GF,French Guiana,1234,33060,6,204,0.617059891107078
2021-08-29,GF,French Guiana,1315,34375,11,215,0.6254545454545455
2021-09-05,GF,French Guiana,1346,35721,6,221,0.6186836874667563
2021-09-12,GF,French Guiana,1138,36859,6,227,0.6158604411405627
2021-09-19,GF,French Guiana,1407,38266,8,235,0.6141221972508232
2021-09-26,GF,French Guiana,1524,39790,21,256,0.6433777330987686
2021-10-03,GF,French Guiana,1535,41325,12,268,0.6485178463399879
2021-10-10,GF,French Guiana,1218,42543,18,286,0.6722610065110595
2021-10-17,GF,French Guiana,833,43376,9,295,0.6800995942456658
2021-10-24,GF,French Guiana,684,44060,4,299,0.6786200635497049
2021-10-31,GF,French Guiana,569,44629,9,308,0.690134217661162
2021-11-07,GF,French Guiana,399,45028,7,315,0.699564715288265
2021-11-14,GF,French Guiana,338,45366,7,322,0.7097826566150862
2021-11-21,GF,French Guiana,250,45616,0,322,0.7058926692388635
2021-11-28,GF,French Guiana,248,45864,4,326,0.710797139368568
2021-12-05,GF,French Guiana,278,46142,2,328,0.7108491179402713
2021-12-12,GF,French Guiana,279,46421,4,332,0.7151935546412185
2021-12-19,GF,French Guiana,311,46732,4,336,0.7189934092270821
2021-12-26,GF,French Guiana,497,47229,1,337,0.7135446441804822
2022-01-02,GF,French Guiana,1708,48937,2,339,0.6927273841878333
2022-01-09,GF,French Guiana,7043,55980,4,343,0.6127188281529117
2022-01-16,GF,French Guiana,11295,67275,5,348,0.5172798216276477
2022-01-23,GF,French Guiana,5544,72819,11,359,0.49300319971436024
2022-01-30,GF,French Guiana,2423,75242,12,371,0.49307567581935624
2022-02-06,GF,French Guiana,1267,76509,12,383,0.5005947012769739
2022-02-13,GF,French Guiana,655,77164,1,384,0.4976413871753667
2022-02-20,GF,French Guiana,290,77454,3,387,0.4996514059958169
2022-02-27,GF,French Guiana,198,77652,4,391,0.5035285633338484
2022-03-06,GF,French Guiana,130,77782,2,393,0.5052582859787612
2022-03-13,GF,French Guiana,293,78075,1,394,0.5046429715017611
2022-03-20,GF,French Guiana,251,78326,0,394,0.503025815182698
2022-03-27,GF,French Guiana,353,78679,0,394,0.5007689472413224
2022-04-03,GF,French Guiana,396,79075,0,394,0.49826114448308567
2022-04-10,GF,French Guiana,454,79529,0,394,0.49541676621106767
2022-04-17,GF,French Guiana,506,80035,0,394,0.4922846254763541
2022-04-24,GF,French Guiana,387,80422,0,394,0.48991569471040264
2022-05-01,GF,French Guiana,437,80859,1,395,0.48850468098789246
2022-05-08,GF,French Guiana,0,80859,0,395,0.48850468098789246
2022-05-15,GF,French Guiana,925,81784,2,397,0.485425022009195
2022-05-22,GF,French Guiana,529,82313,0,397,0.48230534666456093
2022-05-29,GF,French Guiana,639,82952,0,397,0.4785900279679815
2022-06-05,GF,French Guiana,719,83671,0,397,0.4744774175042727
2022-06-12,GF,French Guiana,836,84507,2,399,0.472150236075118
2022-06-19,GF,French Guiana,1089,85596,1,400,0.46731155661479507
2022-06-26,GF,French Guiana,1315,86911,1,401,0.4613915384703893
2022-07-03,GF,French Guiana,1451,88362,0,401,0.4538149883434055
2022-07-10,GF,French Guiana,1417,89779,1,402,0.4477661814009958
2022-07-17,GF,French Guiana,1142,90921,0,402,0.4421420793876002
2022-07-24,GF,French Guiana,891,91812,2,404,0.4400296257569817
2022-07-31,GF,French Guiana,763,92575,3,407,0.4396435322711315
2022-08-07,GF,French Guiana,414,92989,0,407,0.43768617793502457
2022-08-14,GF,French Guiana,288,93277,1,408,0.43740686342828344
2022-08-21,GF,French Guiana,143,93420,0,408,0.4367373153500321
2022-08-28,GF,French Guiana,166,93586,0,408,0.4359626439852115
2022-09-04,GF,French Guiana,149,93735,0,408,0.43526964314290284
2022-09-11,GF,French Guiana,102,93837,1,409,0.4358621865575413
2022-09-18,GF,French Guiana,88,93925,1,410,0.43651849880223587
2022-09-25,GF,French Guiana,49,93974,0,410,0.43629088896928936
2022-10-02,GF,French Guiana,49,94023,0,410,0.43606351637365326
2022-10-09,GF,French Guiana,50,94073,0,410,0.4358317476853082
2022-10-16,GF,French Guiana,55,94128,0,410,0.4355770865204827
2022-10-23,GF,French Guiana,68,94196,1,411,0.43632426005350544
2022-10-30,GF,French Guiana,63,94259,0,411,0.4360326334885793
2022-11-06,GF,French Guiana,50,94309,0,411,0.4358014611542907
2022-11-13,GF,French Guiana,112,94421,0,411,0.43528452356996855
2022-11-20,GF,French Guiana,308,94729,0,411,0.43386924806553434
2022-11-27,GF,French Guiana,722,95451,0,411,0.4305874218185247
2022-12-04,GF,French Guiana,938,96389,0,411,0.4263972030003424
2022-12-11,GF,French Guiana,708,97097,0,411,0.4232880521540316
2022-12-18,GF,French Guiana,429,97526,1,412,0.42245144884441077
2022-12-25,GF,French Guiana,250,97776,1,413,0.42239404352806414
2023-01-01,GF,French Guiana,103,97879,0,413,0.42194954995453565
2023-01-08,GF,French Guiana,67,97946,0,413,0.42166091519817045
2023-01-15,GF,French Guiana,36,97982,0,413,0.42150599089628704
2023-01-22,GF,French Guiana,30,98012,0,413,0.42137697424805126
2023-01-29,GF,French Guiana,16,98028,0,413,0.4213081976578121
2023-02-05,GF,French Guiana,13,98041,0,413,0.42125233320753563
2023-02-12,GF,French Guiana,0,98041,0,413,0.42125233320753563
2023-02-19,GF,French Guiana,0,98041,0,413,0.42125233320753563
2023-02-26,GF,French Guiana,0,98041,0,413,0.42125233320753563
2023-03-05,GF,French Guiana,0,98041,0,413,0.42125233320753563
2023-03-12,GF,French Guiana,0,98041,0,413,0.42125233320753563
2023-03-19,GF,French Guiana,0,98041,0,413,0.42125233320753563
2023-03-26,GF,French Guiana,0,98041,0,413,0.42125233320753563
2023-04-02,GF,French Guiana,0,98041,0,413,0.42125233320753563
2023-04-09,GF,French Guiana,0,98041,0,413,0.42125233320753563
2023-04-16,GF,French Guiana,0,98041,0,413,0.42125233320753563
2023-04-23,GF,French Guiana,0,98041,0,413,0.42125233320753563
2023-04-30,GF,French Guiana,0,98041,0,413,0.42125233320753563
2023-05-07,GF,French Guiana,0,98041,0,413,0.42125233320753563
2023-05-14,GF,French Guiana,0,98041,0,413,0.42125233320753563
2023-05-21,GF,French Guiana,0,98041,0,413,0.42125233320753563
2023-05-28,GF,French Guiana,0,98041,0,413,0.42125233320753563
2023-06-04,GF,French Guiana,0,98041,0,413,0.42125233320753563
2023-06-11,GF,French Guiana,0,98041,0,413,0.42125233320753563
2023-06-18,GF,French Guiana,0,98041,0,413,0.42125233320753563
2023-06-25,GF,French Guiana,0,98041,0,413,0.42125233320753563
2023-07-02,GF,French Guiana,0,98041,0,413,0.42125233320753563
2023-07-09,GF,French Guiana,0,98041,0,413,0.42125233320753563
2023-07-16,GF,French Guiana,0,98041,0,413,0.42125233320753563
2023-07-23,GF,French Guiana,0,98041,0,413,0.42125233320753563
2023-07-30,GF,French Guiana,0,98041,0,413,0.42125233320753563
2023-08-06,GF,French Guiana,0,98041,0,413,0.42125233320753563
2023-08-13,GF,French Guiana,0,98041,0,413,0.42125233320753563
2023-08-20,GF,French Guiana,0,98041,0,413,0.42125233320753563
2023-08-27,GF,French Guiana,0,98041,0,413,0.42125233320753563
2023-09-03,GF,French Guiana,0,98041,0,413,0.42125233320753563
2023-09-10,GF,French Guiana,0,98041,0,413,0.42125233320753563
2023-09-17,GF,French Guiana,0,98041,0,413,0.42125233320753563
2023-09-24,GF,French Guiana,0,98041,0,413,0.42125233320753563
2023-10-01,GF,French Guiana,0,98041,0,413,0.42125233320753563
2023-10-08,GF,French Guiana,0,98041,0,413,0.42125233320753563
2023-10-15,GF,French Guiana,0,98041,0,413,0.42125233320753563
2023-10-22,GF,French Guiana,0,98041,0,413,0.42125233320753563
2023-10-29,GF,French Guiana,0,98041,0,413,0.42125233320753563
2023-11-05,GF,French Guiana,0,98041,0,413,0.42125233320753563
2023-11-12,GF,French Guiana,0,98041,0,413,0.42125233320753563
2023-11-19,GF,French Guiana,0,98041,0,413,0.42125233320753563
2023-11-26,GF,French Guiana,0,98041,0,413,0.42125233320753563
2023-12-03,GF,French Guiana,0,98041,0,413,0.42125233320753563
2023-12-10,GF,French Guiana,0,98041,0,413,0.42125233320753563
2023-12-17,GF,French Guiana,0,98041,0,413,0.42125233320753563
2023-12-24,GF,French Guiana,0,98041,0,413,0.42125233320753563
2023-12-31,GF,French Guiana,0,98041,0,413,0.42125233320753563
2024-01-07,GF,French Guiana,0,98041,0,413,0.42125233320753563
2024-01-14,GF,French Guiana,0,98041,0,413,0.42125233320753563
2020-09-13,PF,French Polynesia,300,1020,2,2,0.19607843137254902
2020-09-20,PF,French Polynesia,298,1318,0,2,0.15174506828528073
2020-09-27,PF,French Polynesia,261,1579,4,6,0.37998733375554145
2020-10-04,PF,French Polynesia,447,2026,2,8,0.3948667324777887
2020-10-11,PF,French Polynesia,728,2754,2,10,0.36310820624546114
2020-10-18,PF,French Polynesia,1043,3797,4,14,0.3687121411640769
2020-10-25,PF,French Polynesia,2062,5859,6,20,0.3413551800648575
2020-11-01,PF,French Polynesia,1403,7262,9,29,0.39933902506196645
2020-11-08,PF,French Polynesia,2733,9995,10,39,0.3901950975487744
2020-11-15,PF,French Polynesia,1711,11706,14,53,0.4527592687510678
2020-11-22,PF,French Polynesia,1272,12978,10,63,0.48543689320388345
2020-11-29,PF,French Polynesia,1118,14096,10,73,0.5178774120317821
2020-12-06,PF,French Polynesia,1011,15107,6,79,0.5229363871053154
2020-12-13,PF,French Polynesia,511,15618,12,91,0.5826610321423998
2020-12-20,PF,French Polynesia,564,16182,12,103,0.6365097021381781
2020-12-27,PF,French Polynesia,368,16550,5,108,0.6525679758308157
2021-01-03,PF,French Polynesia,376,16926,6,114,0.673520028358738
2021-01-10,PF,French Polynesia,315,17241,8,122,0.7076155675424859
2021-01-17,PF,French Polynesia,394,17635,4,126,0.7144882336263113
2021-01-24,PF,French Polynesia,217,17852,2,128,0.7170064978713869
2021-01-31,PF,French Polynesia,208,18060,3,131,0.7253599114064231
2021-02-07,PF,French Polynesia,125,18185,2,133,0.7313720098982678
2021-02-14,PF,French Polynesia,78,18263,2,135,0.7391994743470405
2021-02-21,PF,French Polynesia,83,18346,2,137,0.7467567862204295
2021-02-28,PF,French Polynesia,41,18387,2,139,0.755968891064339
2021-03-07,PF,French Polynesia,72,18459,1,140,0.7584376185058779
2021-03-14,PF,French Polynesia,68,18527,1,141,0.7610514384411939
2021-03-21,PF,French Polynesia,49,18576,0,141,0.7590439276485789
2021-03-28,PF,French Polynesia,31,18607,0,141,0.757779330359542
2021-04-04,PF,French Polynesia,26,18633,0,141,0.7567219449364031
2021-04-11,PF,French Polynesia,19,18652,0,141,0.7559511044392022
2021-04-18,PF,French Polynesia,44,18696,0,141,0.7541720154043646
2021-04-25,PF,French Polynesia,38,18734,0,141,0.7526422547240311
2021-05-02,PF,French Polynesia,24,18758,0,141,0.7516792835057042
2021-05-09,PF,French Polynesia,32,18790,0,141,0.7503991484832357
2021-05-16,PF,French Polynesia,25,18815,0,141,0.7494020728142439
2021-05-23,PF,French Polynesia,29,18844,0,141,0.7482487794523456
2021-05-30,PF,French Polynesia,16,18860,1,142,0.752916224814422
2021-06-06,PF,French Polynesia,29,18889,0,142,0.7517602837630367
2021-06-13,PF,French Polynesia,41,18930,0,142,0.7501320655044903
2021-06-20,PF,French Polynesia,33,18963,0,142,0.748826662447925
2021-06-27,PF,French Polynesia,31,18994,0,142,0.747604506686322
2021-07-04,PF,French Polynesia,17,19011,0,142,0.7469359844300668
2021-07-11,PF,French Polynesia,15,19026,2,144,0.7568590350047304
2021-07-18,PF,French Polynesia,59,19085,0,144,0.7545192559601782
2021-07-25,PF,French Polynesia,200,19285,1,145,0.7518796992481203
2021-08-01,PF,French Polynesia,763,20048,4,149,0.7432162809257782
2021-08-08,PF,French Polynesia,2411,22459,8,157,0.699051605147157
2021-08-15,PF,French Polynesia,5871,28330,31,188,0.6636074832333216
2021-08-22,PF,French Polynesia,8042,36372,69,257,0.7065874848784779
2021-08-29,PF,French Polynesia,3806,40178,128,385,0.9582358504654288
2022-02-27,PF,French Polynesia,4128,66699,2,639,0.9580353528538659
2022-03-06,PF,French Polynesia,2276,68975,4,643,0.9322218194998187
2022-03-13,PF,French Polynesia,1461,70436,2,645,0.9157249133965586
2022-03-20,PF,French Polynesia,1033,71469,0,645,0.9024891911178273
2022-03-27,PF,French Polynesia,589,72058,1,646,0.8965000416331288
2022-04-03,PF,French Polynesia,328,72386,1,647,0.8938192468156825
2022-04-10,PF,French Polynesia,184,72570,1,648,0.8929309632079372
2022-04-17,PF,French Polynesia,26,72596,0,648,0.8926111631494849
2022-04-24,PF,French Polynesia,82,72678,0,648,0.8916040617518368
2022-05-01,PF,French Polynesia,68,72746,0,648,0.8907706265636599
2022-05-08,PF,French Polynesia,40,72786,0,648,0.8902810980133543
2022-05-15,PF,French Polynesia,50,72836,1,649,0.8910428908781372
2022-05-22,PF,French Polynesia,40,72876,0,649,0.8905538174433283
2022-05-29,PF,French Polynesia,46,72922,0,649,0.8899920462960423
2022-06-05,PF,French Polynesia,92,73014,0,649,0.8888706275508806
2022-06-12,PF,French Polynesia,92,73106,0,649,0.8877520312970207
2022-06-19,PF,French Polynesia,60,73166,0,649,0.8870240275537818
2022-06-26,PF,French Polynesia,102,73268,0,649,0.8857891576131464
2022-07-03,PF,French Polynesia,118,73386,0,649,0.8843648652331507
2022-07-10,PF,French Polynesia,302,73688,0,649,0.8807404190641623
2022-07-17,PF,French Polynesia,425,74113,0,649,0.8756898249969641
2022-07-24,PF,French Polynesia,696,74809,0,649,0.8675426753465492
2022-07-31,PF,French Polynesia,631,75440,0,649,0.860286320254507
2022-08-07,PF,French Polynesia,518,75958,0,649,0.8544195476447511
2022-08-14,PF,French Polynesia,239,76197,0,649,0.851739569799336
2022-08-21,PF,French Polynesia,123,76320,0,649,0.8503668763102725
2022-08-28,PF,French Polynesia,119,76439,0,649,0.8490430277737804
2022-09-04,PF,French Polynesia,61,76500,0,649,0.8483660130718953
2022-09-11,PF,French Polynesia,42,76542,0,649,0.8479004990724046
2022-09-18,PF,French Polynesia,36,76578,0,649,0.847501893494215
2022-09-25,PF,French Polynesia,10,76588,0,649,0.8473912362249961
2022-10-02,PF,French Polynesia,115,76703,0,649,0.8461207514699556
2022-10-09,PF,French Polynesia,3,76706,0,649,0.8460876593747555
2022-10-16,PF,French Polynesia,25,76731,0,649,0.8458119925453857
2022-10-23,PF,French Polynesia,0,76731,0,649,0.8458119925453857
2022-10-30,PF,French Polynesia,27,76758,0,649,0.8455144740613356
2022-11-06,PF,French Polynesia,6,76764,0,649,0.8454483872648638
2022-11-13,PF,French Polynesia,63,76827,0,649,0.8447550991187994
2022-11-20,PF,French Polynesia,0,76827,0,649,0.8447550991187994
2022-11-27,PF,French Polynesia,72,76899,0,649,0.843964160782325
2022-12-04,PF,French Polynesia,376,77275,0,649,0.8398576512455517
2022-12-11,PF,French Polynesia,429,77704,0,649,0.8352208380520951
2022-12-18,PF,French Polynesia,68,77772,0,649,0.8344905621560459
2022-12-25,PF,French Polynesia,138,77910,0,649,0.8330124502631242
2023-01-01,PF,French Polynesia,47,77957,0,649,0.8325102299985889
2023-01-08,PF,French Polynesia,0,77957,0,649,0.8325102299985889
2023-01-15,PF,French Polynesia,0,77957,0,649,0.8325102299985889
2023-01-22,PF,French Polynesia,0,77957,0,649,0.8325102299985889
2023-01-29,PF,French Polynesia,0,77957,0,649,0.8325102299985889
2023-02-05,PF,French Polynesia,0,77957,0,649,0.8325102299985889
2023-02-12,PF,French Polynesia,0,77957,0,649,0.8325102299985889
2023-02-19,PF,French Polynesia,0,77957,0,649,0.8325102299985889
2023-02-26,PF,French Polynesia,86,78043,0,649,0.831592839844701
2023-03-05,PF,French Polynesia,12,78055,0,649,0.8314649926333996
2023-03-12,PF,French Polynesia,22,78077,0,649,0.8312307081470856
2023-03-19,PF,French Polynesia,24,78101,0,649,0.8309752756046658
2023-03-26,PF,French Polynesia,52,78153,0,649,0.8304223766202193
2023-04-02,PF,French Polynesia,66,78219,0,649,0.8297216788759764
2023-04-09,PF,French Polynesia,78,78297,0,649,0.8288951045378495
2023-04-16,PF,French Polynesia,81,78378,0,649,0.8280384801857663
2023-04-23,PF,French Polynesia,40,78418,0,649,0.8276161085465071
2023-04-30,PF,French Polynesia,30,78448,0,649,0.8272996124821538
2023-05-07,PF,French Polynesia,70,78518,0,649,0.8265620622022976
2023-05-14,PF,French Polynesia,27,78545,0,649,0.8262779298491311
2023-05-21,PF,French Polynesia,24,78569,0,649,0.8260255316982524
2023-05-28,PF,French Polynesia,12,78581,0,649,0.8258993904378922
2023-06-04,PF,French Polynesia,9,78590,0,649,0.8258048097722357
2023-06-11,PF,French Polynesia,6,78596,0,649,0.8257417680289073
2023-06-18,PF,French Polynesia,4,78600,0,649,0.8256997455470738
2023-06-25,PF,French Polynesia,1,78601,0,649,0.8256892405949033
2023-07-02,PF,French Polynesia,0,78601,0,649,0.8256892405949033
2023-07-09,PF,French Polynesia,12,78613,0,649,0.8255632020149339
2023-07-16,PF,French Polynesia,2,78615,0,649,0.8255421993258284
2023-07-23,PF,French Polynesia,1,78616,0,649,0.8255316983820088
2023-07-30,PF,French Polynesia,1,78617,0,649,0.825521197705331
2023-08-06,PF,French Polynesia,0,78617,0,649,0.825521197705331
2023-08-13,PF,French Polynesia,2,78619,0,649,0.8255001971533598
2023-08-20,PF,French Polynesia,2,78621,0,649,0.8254791976698338
2023-08-27,PF,French Polynesia,2,78623,0,649,0.825458199254671
2023-09-03,PF,French Polynesia,2,78625,0,649,0.8254372019077902
2023-09-10,PF,French Polynesia,0,78625,0,649,0.8254372019077902
2023-09-17,PF,French Polynesia,2,78627,0,649,0.8254162056291096
2023-09-24,PF,French Polynesia,5,78632,0,649,0.8253637196052498
2023-10-01,PF,French Polynesia,0,78632,0,649,0.8253637196052498
2023-10-08,PF,French Polynesia,7,78639,0,649,0.8252902503846691
2023-10-15,PF,French Polynesia,3,78642,0,649,0.8252587675796649
2023-10-22,PF,French Polynesia,7,78649,0,649,0.825185317041539
2023-10-29,PF,French Polynesia,4,78653,0,649,0.825143351175416
2023-11-05,PF,French Polynesia,6,78659,0,649,0.8250804103789776
2023-11-12,PF,French Polynesia,11,78670,0,649,0.8249650438540739
2023-11-19,PF,French Polynesia,30,78700,0,649,0.8246505717916137
2023-11-26,PF,French Polynesia,0,78700,0,649,0.8246505717916137
2023-12-03,PF,French Polynesia,0,78700,0,649,0.8246505717916137
2023-12-10,PF,French Polynesia,527,79227,0,649,0.8191651835864036
2023-12-17,PF,French Polynesia,0,79227,0,649,0.8191651835864036
2023-12-24,PF,French Polynesia,0,79227,0,649,0.8191651835864036
2023-12-31,PF,French Polynesia,0,79227,0,649,0.8191651835864036
2024-01-07,PF,French Polynesia,27,79254,1,650,0.8201478789714084
2024-01-14,PF,French Polynesia,0,79254,0,650,0.8201478789714084
2020-05-17,GA,Gabon,659,1320,3,11,0.8333333333333334
2020-05-24,GA,Gabon,614,1934,1,12,0.6204756980351602
2020-05-31,GA,Gabon,721,2655,5,17,0.64030131826742
2020-06-07,GA,Gabon,446,3101,4,21,0.6772009029345373
2020-06-14,GA,Gabon,362,3463,2,23,0.6641640196361537
2020-06-21,GA,Gabon,965,4428,11,34,0.7678410117434508
2020-06-28,GA,Gabon,781,5209,6,40,0.7679017085813016
2020-07-05,GA,Gabon,411,5620,4,44,0.7829181494661922
2020-07-12,GA,Gabon,322,5942,2,46,0.7741501178054527
2020-07-19,GA,Gabon,373,6315,0,46,0.728424386381631
2020-07-26,GA,Gabon,669,6984,3,49,0.7016036655211914
2020-08-02,GA,Gabon,547,7531,1,50,0.6639224538573895
2020-08-09,GA,Gabon,392,7923,1,51,0.6436955698599016
2020-08-16,GA,Gabon,302,8225,0,51,0.6200607902735562
2020-08-23,GA,Gabon,163,8388,2,53,0.631855030996662
2020-08-30,GA,Gabon,117,8505,0,53,0.6231628453850676
2020-09-06,GA,Gabon,96,8601,0,53,0.6162074177421231
2020-09-13,GA,Gabon,42,8643,0,53,0.6132130047437232
2020-09-20,GA,Gabon,53,8696,0,53,0.609475620975161
2020-09-27,GA,Gabon,32,8728,1,54,0.618698441796517
2020-10-04,GA,Gabon,69,8797,0,54,0.6138456291917699
2020-10-11,GA,Gabon,18,8815,0,54,0.6125921724333522
2020-10-18,GA,Gabon,66,8881,0,54,0.6080396351762188
2020-10-25,GA,Gabon,38,8919,0,54,0.6054490413723511
2020-11-01,GA,Gabon,49,8968,1,55,0.6132917038358608
2020-11-08,GA,Gabon,54,9022,0,55,0.6096209266238084
2020-11-15,GA,Gabon,40,9062,3,58,0.640035312293092
2020-11-22,GA,Gabon,69,9131,1,59,0.64615047639908
2020-11-29,GA,Gabon,60,9191,0,59,0.6419323251006419
2020-12-06,GA,Gabon,63,9254,1,60,0.6483682731791658
2020-12-13,GA,Gabon,76,9330,3,63,0.67524115755627
2020-12-20,GA,Gabon,70,9400,1,64,0.6808510638297872
2020-12-27,GA,Gabon,97,9497,0,64,0.6738970201116142
2021-01-03,GA,Gabon,74,9571,0,64,0.6686866576115349
2021-01-10,GA,Gabon,123,9694,2,66,0.6808335052609862
2021-01-17,GA,Gabon,205,9899,0,66,0.6667340135367209
2021-01-24,GA,Gabon,379,10278,1,67,0.6518777972368165
2021-01-31,GA,Gabon,470,10748,1,68,0.6326758466691477
2021-02-07,GA,Gabon,709,11457,3,71,0.6197084751680195
2021-02-14,GA,Gabon,1120,12577,2,73,0.5804245845591158
2021-02-21,GA,Gabon,976,13553,2,75,0.5533830148306649
2021-02-28,GA,Gabon,1011,14564,8,83,0.5698983795660533
2021-03-07,GA,Gabon,953,15517,7,90,0.5800090223625701
2021-03-14,GA,Gabon,1143,16660,6,96,0.5762304921968787
2021-03-21,GA,Gabon,637,17297,9,105,0.6070416835289356
2021-03-28,GA,Gabon,1129,18426,4,109,0.5915554108325193
2021-04-04,GA,Gabon,1437,19863,10,119,0.599103861450939
2021-04-11,GA,Gabon,773,20636,8,127,0.6154293467726304
2021-04-18,GA,Gabon,1222,21858,6,133,0.6084728703449538
2021-04-25,GA,Gabon,575,22433,5,138,0.6151651584718941
2021-05-02,GA,Gabon,642,23075,1,139,0.6023835319609968
2021-05-09,GA,Gabon,357,23432,4,143,0.6102765448958689
2021-05-16,GA,Gabon,367,23799,0,143,0.6008655825875037
2021-05-23,GA,Gabon,308,24107,4,147,0.6097813912971336
2021-05-30,GA,Gabon,258,24365,3,150,0.615637184485943
2021-06-06,GA,Gabon,226,24591,4,154,0.6262453743239397
2021-06-13,GA,Gabon,145,24736,2,156,0.630659767141009
2021-06-20,GA,Gabon,0,24736,0,156,0.630659767141009
2021-06-27,GA,Gabon,248,24984,3,159,0.6364073006724303
2021-07-04,GA,Gabon,92,25076,0,159,0.6340724198436752
2021-07-11,GA,Gabon,88,25164,3,162,0.6437768240343348
2021-07-18,GA,Gabon,96,25260,0,162,0.6413301662707839
2021-07-25,GA,Gabon,65,25325,1,163,0.6436327739387957
2021-08-01,GA,Gabon,59,25384,1,164,0.6460762685156004
2021-08-08,GA,Gabon,78,25462,1,165,0.6480245071086325
2021-08-15,GA,Gabon,102,25564,0,165,0.6454388984509466
2021-08-22,GA,Gabon,103,25667,0,165,0.6428487941715043
2021-08-29,GA,Gabon,152,25819,0,165,0.6390642550060033
2021-09-05,GA,Gabon,260,26079,2,167,0.6403619770696729
2021-09-12,GA,Gabon,559,26638,3,170,0.6381860500037541
2021-09-19,GA,Gabon,1005,27643,5,175,0.6330716637123323
2021-09-26,GA,Gabon,1483,29126,3,178,0.6111378150106433
2021-10-03,GA,Gabon,1522,30648,12,190,0.6199425737405377
2021-10-10,GA,Gabon,1487,32135,11,201,0.6254862299673253
2021-10-17,GA,Gabon,1307,33442,12,213,0.6369236289695592
2021-10-24,GA,Gabon,1159,34601,11,224,0.6473801335221525
2021-10-31,GA,Gabon,924,35525,15,239,0.6727656579873329
2021-11-07,GA,Gabon,669,36194,15,254,0.7017737746587832
2021-11-14,GA,Gabon,498,36692,12,266,0.7249536683745775
2021-11-21,GA,Gabon,353,37045,7,273,0.7369415575651235
2021-11-28,GA,Gabon,253,37298,6,279,0.7480293849536168
2021-12-05,GA,Gabon,44,37342,0,279,0.7471479835038295
2021-12-12,GA,Gabon,249,37591,3,282,0.7501795642574021
2021-12-19,GA,Gabon,152,37743,3,285,0.7551069072410779
2021-12-26,GA,Gabon,1127,38870,2,287,0.73835863133522
2022-01-02,GA,Gabon,2928,41798,1,288,0.6890281831666587
2022-01-09,GA,Gabon,2141,43939,7,295,0.6713853296615763
2022-01-16,GA,Gabon,1213,45152,2,297,0.6577781715095676
2022-01-23,GA,Gabon,1046,46198,3,300,0.6493787609853241
2022-01-30,GA,Gabon,524,46722,1,301,0.6442361200291084
2022-02-06,GA,Gabon,426,47148,0,301,0.638415203189955
2022-02-13,GA,Gabon,251,47399,1,302,0.637144243549442
2022-02-20,GA,Gabon,85,47484,1,303,0.6381096790497852
2022-02-27,GA,Gabon,50,47534,0,303,0.6374384650986662
2022-03-06,GA,Gabon,25,47559,0,303,0.6371033873714754
2022-03-13,GA,Gabon,5,47564,0,303,0.6370364140946935
2022-03-20,GA,Gabon,6,47570,0,303,0.6369560647466891
2022-03-27,GA,Gabon,14,47584,0,303,0.636768661735037
2022-04-03,GA,Gabon,2,47586,0,303,0.6367418988778212
2022-04-10,GA,Gabon,5,47591,0,303,0.6366750015759282
2022-04-17,GA,Gabon,3,47594,0,303,0.6366348699415892
2022-04-24,GA,Gabon,3,47597,0,303,0.6365947433661786
2022-05-01,GA,Gabon,5,47602,1,304,0.6386286290491996
2022-05-08,GA,Gabon,0,47602,0,304,0.6386286290491996
2022-05-15,GA,Gabon,6,47608,0,304,0.6385481431692153
2022-05-22,GA,Gabon,14,47622,0,304,0.6383604216538574
2022-05-29,GA,Gabon,28,47650,0,304,0.6379853095487933
2022-06-05,GA,Gabon,27,47677,0,304,0.6376240115779096
2022-06-12,GA,Gabon,34,47711,0,304,0.6371696254532498
2022-06-19,GA,Gabon,31,47742,0,304,0.6367558962758159
2022-06-26,GA,Gabon,82,47824,1,305,0.6377551020408163
2022-07-03,GA,Gabon,115,47939,0,305,0.6362252028619705
2022-07-10,GA,Gabon,218,48157,0,305,0.6333451004007725
2022-07-17,GA,Gabon,132,48289,1,306,0.6336846900950527
2022-07-24,GA,Gabon,128,48417,0,306,0.632009418179565
2022-07-31,GA,Gabon,94,48511,0,306,0.6307847704644307
2022-08-07,GA,Gabon,81,48592,0,306,0.6297332894303589
2022-08-14,GA,Gabon,43,48635,0,306,0.6291765189678216
2022-08-21,GA,Gabon,0,48635,0,306,0.6291765189678216
2022-08-28,GA,Gabon,14,48649,0,306,0.6289954572550309
2022-09-04,GA,Gabon,6,48655,0,306,0.6289178912753057
2022-09-11,GA,Gabon,13,48668,0,306,0.6287498972630887
2022-09-18,GA,Gabon,14,48682,0,306,0.6285690809744875
2022-09-25,GA,Gabon,9,48691,0,306,0.6284528968392515
2022-10-02,GA,Gabon,22,48713,0,306,0.6281690719109888
2022-10-09,GA,Gabon,59,48772,0,306,0.62740916919544
2022-10-16,GA,Gabon,38,48810,0,306,0.626920712968654
2022-10-23,GA,Gabon,104,48914,0,306,0.6255877662836816
2022-10-30,GA,Gabon,31,48945,0,306,0.6251915415262029
2022-11-06,GA,Gabon,14,48959,0,306,0.6250127657836149
2022-11-13,GA,Gabon,0,48959,0,306,0.6250127657836149
2022-11-20,GA,Gabon,13,48972,0,306,0.6248468512619456
2022-11-27,GA,Gabon,1,48973,0,306,0.624834092254916
2022-12-04,GA,Gabon,0,48973,0,306,0.624834092254916
2022-12-11,GA,Gabon,0,48973,0,306,0.624834092254916
2022-12-18,GA,Gabon,3,48976,0,306,0.6247958183600131
2022-12-25,GA,Gabon,3,48979,0,306,0.624757549153719
2023-01-01,GA,Gabon,1,48980,0,306,0.6247447937933851
2023-01-08,GA,Gabon,0,48980,0,306,0.6247447937933851
2023-01-15,GA,Gabon,0,48980,0,306,0.6247447937933851
2023-01-22,GA,Gabon,1,48981,0,306,0.6247320389538801
2023-01-29,GA,Gabon,0,48981,0,306,0.6247320389538801
2023-02-05,GA,Gabon,0,48981,0,306,0.6247320389538801
2023-02-12,GA,Gabon,0,48981,0,306,0.6247320389538801
2023-02-19,GA,Gabon,0,48981,0,306,0.6247320389538801
2023-02-26,GA,Gabon,0,48981,0,306,0.6247320389538801
2023-03-05,GA,Gabon,0,48981,0,306,0.6247320389538801
2023-03-12,GA,Gabon,0,48981,0,306,0.6247320389538801
2023-03-19,GA,Gabon,0,48981,0,306,0.6247320389538801
2023-03-26,GA,Gabon,0,48981,0,306,0.6247320389538801
2023-04-02,GA,Gabon,0,48981,0,306,0.6247320389538801
2023-04-09,GA,Gabon,11,48992,1,307,0.6266329196603527
2023-04-16,GA,Gabon,0,48992,0,307,0.6266329196603527
2023-04-23,GA,Gabon,0,48992,0,307,0.6266329196603527
2023-04-30,GA,Gabon,0,48992,0,307,0.6266329196603527
2023-05-07,GA,Gabon,0,48992,0,307,0.6266329196603527
2023-05-14,GA,Gabon,0,48992,0,307,0.6266329196603527
2023-05-21,GA,Gabon,0,48992,0,307,0.6266329196603527
2023-05-28,GA,Gabon,0,48992,0,307,0.6266329196603527
2023-06-04,GA,Gabon,0,48992,0,307,0.6266329196603527
2023-06-11,GA,Gabon,0,48992,0,307,0.6266329196603527
2023-06-18,GA,Gabon,0,48992,0,307,0.6266329196603527
2023-06-25,GA,Gabon,0,48992,0,307,0.6266329196603527
2023-07-02,GA,Gabon,0,48992,0,307,0.6266329196603527
2023-07-09,GA,Gabon,0,48992,0,307,0.6266329196603527
2023-07-16,GA,Gabon,0,48992,0,307,0.6266329196603527
2023-07-23,GA,Gabon,0,48992,0,307,0.6266329196603527
2023-07-30,GA,Gabon,0,48992,0,307,0.6266329196603527
2023-08-06,GA,Gabon,0,48992,0,307,0.6266329196603527
2023-08-13,GA,Gabon,0,48992,0,307,0.6266329196603527
2023-08-20,GA,Gabon,0,48992,0,307,0.6266329196603527
2023-08-27,GA,Gabon,0,48992,0,307,0.6266329196603527
2023-09-03,GA,Gabon,0,48992,0,307,0.6266329196603527
2023-09-10,GA,Gabon,0,48992,0,307,0.6266329196603527
2023-09-17,GA,Gabon,0,48992,0,307,0.6266329196603527
2023-09-24,GA,Gabon,0,48992,0,307,0.6266329196603527
2023-10-01,GA,Gabon,0,48992,0,307,0.6266329196603527
2023-10-08,GA,Gabon,1,48993,0,307,0.6266201294062417
2023-10-15,GA,Gabon,2,48995,0,307,0.6265945504643331
2023-10-22,GA,Gabon,0,48995,0,307,0.6265945504643331
2023-10-29,GA,Gabon,0,48995,0,307,0.6265945504643331
2023-11-05,GA,Gabon,12,49007,0,307,0.6264411206562328
2023-11-12,GA,Gabon,10,49017,0,307,0.626313319868617
2023-11-19,GA,Gabon,32,49049,0,307,0.6259047075373606
2023-11-26,GA,Gabon,0,49049,0,307,0.6259047075373606
2023-12-03,GA,Gabon,0,49049,0,307,0.6259047075373606
2023-12-10,GA,Gabon,2,49051,0,307,0.6258791869686653
2023-12-17,GA,Gabon,0,49051,0,307,0.6258791869686653
2023-12-24,GA,Gabon,0,49051,0,307,0.6258791869686653
2023-12-31,GA,Gabon,-59,48992,0,307,0.6266329196603527
2024-01-07,GA,Gabon,0,48992,0,307,0.6266329196603527
2024-01-14,GA,Gabon,0,48992,0,307,0.6266329196603527
2020-04-05,GE,Georgia,72,170,1,1,0.5882352941176471
2020-09-13,GE,Georgia,577,2227,0,19,0.8531656937584194
2020-09-20,GE,Georgia,1275,3502,0,19,0.5425471159337522
2020-09-27,GE,Georgia,1752,5254,9,28,0.5329272934906737
2020-10-04,GE,Georgia,2864,8118,22,50,0.6159152500615915
2020-10-11,GE,Georgia,3676,11794,35,85,0.72070544344582
2020-10-18,GE,Georgia,5683,17477,51,136,0.7781655890599073
2020-10-25,GE,Georgia,10954,28431,65,201,0.7069747810488551
2020-11-01,GE,Georgia,12296,40727,134,335,0.8225501510054755
2020-11-08,GE,Georgia,17026,57753,140,475,0.8224680968953993
2020-11-15,GE,Georgia,21925,79678,228,703,0.8823012625818921
2020-11-22,GE,Georgia,25054,104732,273,976,0.9319023794064851
2020-11-29,GE,Georgia,27636,132368,254,1230,0.9292276078810588
2020-12-06,GE,Georgia,30107,162475,274,1504,0.9256808739806124
2020-12-13,GE,Georgia,27251,189726,286,1790,0.9434658402116736
2022-08-07,GE,Georgia,12802,1701020,10,16819,0.9887596853652515
2022-08-14,GE,Georgia,13729,1714749,8,16827,0.9813098010262725
2022-08-21,GE,Georgia,13338,1728087,6,16833,0.9740829020761108
2022-08-28,GE,Georgia,13595,1741682,6,16839,0.9668240241329933
2022-09-04,GE,Georgia,19907,1761589,4,16843,0.9561254072317664
2022-09-11,GE,Georgia,10340,1771929,6,16849,0.9508846009066955
2022-09-18,GE,Georgia,8480,1780409,5,16854,0.9466364189351997
2022-09-25,GE,Georgia,7214,1787623,4,16858,0.9430400034011646
2022-10-02,GE,Georgia,5150,1792773,4,16862,0.9405541024993126
2022-10-09,GE,Georgia,3997,1796770,5,16867,0.9387400724633649
2022-10-16,GE,Georgia,2229,1798999,3,16870,0.9377437119197954
2022-10-23,GE,Georgia,1814,1800813,1,16871,0.9368546317690953
2022-10-30,GE,Georgia,1444,1802257,2,16873,0.9362149793286972
2022-11-06,GE,Georgia,1139,1803396,5,16878,0.9359009335719941
2022-11-13,GE,Georgia,1169,1804565,0,16878,0.9352946554986936
2022-11-20,GE,Georgia,1077,1805642,3,16881,0.9349029320319311
2022-11-27,GE,Georgia,889,1806531,6,16887,0.9347749914061813
2022-12-04,GE,Georgia,748,1807279,3,16890,0.9345541003906978
2022-12-11,GE,Georgia,623,1807902,3,16893,0.9343979928115573
2022-12-18,GE,Georgia,636,1808538,4,16897,0.9342905706156023
2022-12-25,GE,Georgia,641,1809179,1,16898,0.9340148210873551
2023-01-01,GE,Georgia,691,1809870,5,16903,0.9339344814820953
2023-01-08,GE,Georgia,1044,1810914,5,16908,0.9336721677561718
2023-01-15,GE,Georgia,1152,1812066,7,16915,0.9334648958702387
2023-01-22,GE,Georgia,1612,1813678,8,16923,0.9330763233605965
2023-01-29,GE,Georgia,2034,1815712,10,16933,0.932581819143124
2023-02-05,GE,Georgia,2940,1818652,7,16940,0.9314591246703603
2023-02-12,GE,Georgia,3195,1821847,9,16949,0.9303196152036916
2023-02-19,GE,Georgia,2997,1824844,15,16964,0.9296137094458485
2023-02-26,GE,Georgia,2531,1827375,5,16969,0.9285997674259525
2023-03-05,GE,Georgia,2058,1829433,16,16985,0.928429737519767
2023-03-12,GE,Georgia,1812,1831245,15,17000,0.9283301797411051
2023-03-19,GE,Georgia,1791,1833036,13,17013,0.9281323443729419
2023-03-26,GE,Georgia,1597,1834633,9,17022,0.9278149907910738
2023-04-02,GE,Georgia,1465,1836098,7,17029,0.927455941894169
2023-04-09,GE,Georgia,1558,1837656,11,17040,0.9272682155963903
2023-04-16,GE,Georgia,1147,1838803,7,17047,0.9270704909661339
2023-04-23,GE,Georgia,1054,1839857,10,17057,0.9270829200312851
2023-04-30,GE,Georgia,1008,1840865,7,17064,0.9269555344905792
2023-05-07,GE,Georgia,874,1841739,2,17066,0.9266242393737658
2023-05-14,GE,Georgia,686,1842425,8,17074,0.9267134347395416
2023-05-21,GE,Georgia,684,1843109,7,17081,0.9267493132527702
2023-05-28,GE,Georgia,558,1843667,5,17086,0.9267400240932879
2023-06-04,GE,Georgia,533,1844200,3,17089,0.9266348552217764
2023-06-11,GE,Georgia,410,1844610,3,17092,0.9265915288326529
2023-06-18,GE,Georgia,422,1845032,3,17095,0.9265421954741164
2023-06-25,GE,Georgia,376,1845408,4,17099,0.9265701676810765
2023-07-02,GE,Georgia,423,1845831,3,17102,0.9265203585810402
2023-07-09,GE,Georgia,460,1846291,4,17106,0.9265061683125791
2023-07-16,GE,Georgia,442,1846733,1,17107,0.9263385665388554
2023-07-23,GE,Georgia,610,1847343,3,17110,0.9261950812599501
2023-07-30,GE,Georgia,781,1848124,4,17114,0.9260201155333733
2023-08-06,GE,Georgia,1126,1849250,2,17116,0.9255644180073002
2023-08-13,GE,Georgia,1522,1850772,6,17122,0.9251274603246645
2023-08-20,GE,Georgia,2093,1852865,5,17127,0.9243522868638567
2023-08-27,GE,Georgia,2424,1855289,5,17132,0.9234140880477381
2023-09-03,GE,Georgia,0,1855289,0,17132,0.9234140880477381
2023-09-10,GE,Georgia,0,1855289,0,17132,0.9234140880477381
2023-09-17,GE,Georgia,0,1855289,0,17132,0.9234140880477381
2023-09-24,GE,Georgia,0,1855289,0,17132,0.9234140880477381
2023-10-01,GE,Georgia,0,1855289,0,17132,0.9234140880477381
2023-10-08,GE,Georgia,0,1855289,0,17132,0.9234140880477381
2023-10-15,GE,Georgia,0,1855289,0,17132,0.9234140880477381
2023-10-22,GE,Georgia,0,1855289,0,17132,0.9234140880477381
2023-10-29,GE,Georgia,0,1855289,0,17132,0.9234140880477381
2023-11-05,GE,Georgia,0,1855289,0,17132,0.9234140880477381
2023-11-12,GE,Georgia,0,1855289,0,17132,0.9234140880477381
2023-11-19,GE,Georgia,0,1855289,0,17132,0.9234140880477381
2023-11-26,GE,Georgia,0,1855289,0,17132,0.9234140880477381
2023-12-03,GE,Georgia,0,1855289,0,17132,0.9234140880477381
2023-12-10,GE,Georgia,0,1855289,0,17132,0.9234140880477381
2023-12-17,GE,Georgia,0,1855289,0,17132,0.9234140880477381
2023-12-24,GE,Georgia,0,1855289,0,17132,0.9234140880477381
2023-12-31,GE,Georgia,0,1855289,0,17132,0.9234140880477381
2024-01-07,GE,Georgia,0,1855289,0,17132,0.9234140880477381
2024-01-14,GE,Georgia,0,1855289,0,17132,0.9234140880477381
2022-02-20,DE,Germany,1193271,13753768,1786,127263,0.925295526287778
2022-02-27,DE,Germany,1093093,14846861,1645,128908,0.8682508713458017
2022-03-06,DE,Germany,1134009,15980870,1606,130514,0.8166889537303037
2022-03-13,DE,Germany,1413846,17394716,1778,132292,0.7605298068677867
2022-03-20,DE,Germany,1582504,18977220,1934,134226,0.7073006478293449
2022-03-27,DE,Germany,1588891,20566111,1881,136107,0.6618023213042077
2022-04-03,DE,Germany,1295125,21861236,1536,137643,0.6296213077796698
2022-04-10,DE,Germany,984600,22845836,1292,138935,0.6081414573754271
2022-04-17,DE,Germany,778948,23624784,985,139920,0.5922593831969003
2022-04-24,DE,Germany,731499,24356283,808,140728,0.5777893121048069
2022-05-01,DE,Germany,596917,24953200,678,141406,0.5666848340092653
2022-05-08,DE,Germany,471440,25424640,541,141947,0.5583048570205911
2022-05-15,DE,Germany,408745,25833385,418,142365,0.5510892204022044
2022-05-22,DE,Germany,292505,26125890,330,142695,0.5461823501515164
2022-05-29,DE,Germany,187159,26313049,213,142908,0.5431069580723997
2022-06-05,DE,Germany,245141,26558190,223,143131,0.5389335643731745
2022-06-12,DE,Germany,331434,26889624,285,143416,0.5333507080649398
2022-06-19,DE,Germany,413791,27303415,402,143818,0.5267399700733406
2022-06-26,DE,Germany,574225,27877640,566,144384,0.5179204552465704
2022-07-03,DE,Germany,622776,28500416,610,144994,0.5087434513236578
2022-07-10,DE,Germany,629349,29129765,702,145696,0.5001619477534405
2022-07-17,DE,Germany,675130,29804895,960,146656,0.4920534026373856
2022-07-24,DE,Germany,627179,30432074,1129,147785,0.4856225047297138
2022-07-31,DE,Germany,495729,30927803,1038,148823,0.48119486534494543
2022-08-07,DE,Germany,362936,31290739,791,149614,0.47814147182653627
2022-08-14,DE,Germany,298292,31589031,623,150237,0.47559863422211335
2022-08-21,DE,Germany,263329,31852360,593,150830,0.47352849208033565
2022-08-28,DE,Germany,227979,32080339,397,151227,0.47140087889968996
2022-09-04,DE,Germany,201757,32282096,351,151578,0.46954200247716255
2022-09-11,DE,Germany,204084,32486180,317,151895,0.4675680550929657
2022-09-18,DE,Germany,228913,32715093,354,152249,0.46537847225438117
2022-09-25,DE,Germany,286535,33001628,520,152769,0.4629135265690529
2022-10-02,DE,Germany,458852,33460480,880,153649,0.45919544489499253
2022-10-09,DE,Germany,594073,34054553,1284,154933,0.45495531830941954
2022-10-16,DE,Germany,644986,34699539,1560,156493,0.4509944642204037
2022-10-23,DE,Germany,544616,35244155,1477,157970,0.4482161652052659
2022-10-30,DE,Germany,373903,35618058,1049,159019,0.44645612065655016
2022-11-06,DE,Germany,243578,35861636,698,159717,0.4453700885257995
2022-11-13,DE,Germany,202015,36063651,640,160357,0.4446499329754494
2022-11-20,DE,Germany,169667,36233318,553,160910,0.44409402417962385
2022-11-27,DE,Germany,170589,36403907,640,161550,0.4437710490799792
2022-12-04,DE,Germany,184825,36588732,800,162350,0.44371584125954405
2022-12-11,DE,Germany,199505,36788237,961,163311,0.4439217894567767
2022-12-18,DE,Germany,222953,37011190,1139,164450,0.4443250811443782
2022-12-25,DE,Germany,230746,37241936,1288,165738,0.44503056983933376
2023-01-01,DE,Germany,151567,37393503,970,166708,0.4458207619649862
2023-01-08,DE,Germany,130316,37523819,829,167537,0.4464817400382408
2023-01-15,DE,Germany,89089,37612908,517,168054,0.44679874260187485
2023-01-22,DE,Germany,62867,37675775,338,168392,0.4469503281617963
2023-01-29,DE,Germany,73298,37749073,331,168723,0.4469593200341635
2023-02-05,DE,Germany,84243,37833316,344,169067,0.4468733324882228
2023-02-12,DE,Germany,86595,37919911,455,169522,0.4470527370172362
2023-02-19,DE,Germany,97850,38017761,601,170123,0.4474829540855917
2023-02-26,DE,Germany,113434,38131195,599,170722,0.4477226585739052
2023-03-05,DE,Germany,86321,38217516,535,171257,0.4481112796551194
2023-03-12,DE,Germany,43758,38261274,572,171829,0.4490937756019311
2023-03-19,DE,Germany,40307,38301581,626,172455,0.45025556516844567
2023-03-26,DE,Germany,32639,38334220,545,173000,0.45129390920175233
2023-04-02,DE,Germany,22652,38356872,431,173431,0.45215105131617617
2023-04-09,DE,Germany,14679,38371551,278,173709,0.452702576447848
2023-04-16,DE,Germany,13045,38384596,304,174013,0.4533407099035248
2023-04-23,DE,Germany,11468,38396064,231,174244,0.4538069318771841
2023-04-30,DE,Germany,9193,38405257,162,174406,0.4541201221489027
2023-05-07,DE,Germany,7360,38412617,167,174573,0.45446786403540274
2023-05-14,DE,Germany,6708,38419325,109,174682,0.45467222550109876
2023-05-21,DE,Germany,4359,38423684,85,174767,0.4548418626386788
2023-05-28,DE,Germany,4272,38427956,72,174839,0.4549786618887562
2023-06-04,DE,Germany,2767,38430723,55,174894,0.4550890182315852
2023-06-11,DE,Germany,2392,38433115,32,174926,0.4551439559348754
2023-06-18,DE,Germany,2014,38435129,30,174956,0.4551981599957684
2023-06-25,DE,Germany,1528,38436657,15,174971,0.45521908942289124
2023-07-02,DE,Germany,1099,38437756,8,174979,0.4552268868141002
2023-07-09,DE,Germany,0,38437756,0,174979,0.4552268868141002
2023-07-16,DE,Germany,0,38437756,0,174979,0.4552268868141002
2023-07-23,DE,Germany,0,38437756,0,174979,0.4552268868141002
2023-07-30,DE,Germany,0,38437756,0,174979,0.4552268868141002
2023-08-06,DE,Germany,0,38437756,0,174979,0.4552268868141002
2023-08-13,DE,Germany,0,38437756,0,174979,0.4552268868141002
2023-08-20,DE,Germany,0,38437756,0,174979,0.4552268868141002
2023-08-27,DE,Germany,0,38437756,0,174979,0.4552268868141002
2023-09-03,DE,Germany,0,38437756,0,174979,0.4552268868141002
2023-09-10,DE,Germany,0,38437756,0,174979,0.4552268868141002
2023-09-17,DE,Germany,0,38437756,0,174979,0.4552268868141002
2023-09-24,DE,Germany,0,38437756,0,174979,0.4552268868141002
2023-10-01,DE,Germany,0,38437756,0,174979,0.4552268868141002
2023-10-08,DE,Germany,0,38437756,0,174979,0.4552268868141002
2023-10-15,DE,Germany,0,38437756,0,174979,0.4552268868141002
2023-10-22,DE,Germany,0,38437756,0,174979,0.4552268868141002
2023-10-29,DE,Germany,0,38437756,0,174979,0.4552268868141002
2023-11-05,DE,Germany,0,38437756,0,174979,0.4552268868141002
2023-11-12,DE,Germany,0,38437756,0,174979,0.4552268868141002
2023-11-19,DE,Germany,0,38437756,0,174979,0.4552268868141002
2023-11-26,DE,Germany,0,38437756,0,174979,0.4552268868141002
2023-12-03,DE,Germany,0,38437756,0,174979,0.4552268868141002
2023-12-10,DE,Germany,0,38437756,0,174979,0.4552268868141002
2023-12-17,DE,Germany,0,38437756,0,174979,0.4552268868141002
2023-12-24,DE,Germany,0,38437756,0,174979,0.4552268868141002
2023-12-31,DE,Germany,0,38437756,0,174979,0.4552268868141002
2024-01-07,DE,Germany,0,38437756,0,174979,0.4552268868141002
2024-01-14,DE,Germany,0,38437756,0,174979,0.4552268868141002
2020-09-27,GH,Ghana,510,46626,301,301,0.6455625616608759
2020-10-04,GH,Ghana,203,46829,2,303,0.6470349569711076
2020-10-11,GH,Ghana,297,47126,7,310,0.6578109748334252
2020-10-18,GH,Ghana,335,47461,2,312,0.6573818503613493
2020-10-25,GH,Ghana,314,47775,4,316,0.6614338042909471
2020-11-01,GH,Ghana,736,48511,4,320,0.6596442044072478
2020-11-08,GH,Ghana,791,49302,0,320,0.6490608900247454
2020-11-15,GH,Ghana,1155,50457,3,323,0.6401490377945578
2020-11-22,GH,Ghana,727,51184,0,323,0.6310565801813066
2020-11-29,GH,Ghana,606,51790,0,323,0.6236725236532149
2020-12-06,GH,Ghana,832,52622,3,326,0.6195127513207404
2020-12-13,GH,Ghana,764,53386,1,327,0.6125201363653392
2020-12-20,GH,Ghana,657,54043,6,333,0.6161760079936347
2020-12-27,GH,Ghana,638,54681,2,335,0.6126442457160622
2021-01-03,GH,Ghana,487,55168,0,335,0.6072360788863109
2021-01-10,GH,Ghana,1253,56421,3,338,0.5990677230109357
2021-01-17,GH,Ghana,2010,58431,20,358,0.6126884701613869
2021-01-24,GH,Ghana,4320,62751,19,377,0.6007872384503833
2021-01-31,GH,Ghana,5031,67782,47,424,0.6255348027499926
2021-02-07,GH,Ghana,5221,73003,58,482,0.6602468391709929
2021-02-14,GH,Ghana,4745,77748,79,561,0.7215619694397283
2021-02-21,GH,Ghana,3497,81245,23,584,0.7188134654440274
2021-02-28,GH,Ghana,3104,84349,27,611,0.7243713618418712
2021-03-07,GH,Ghana,2624,86973,51,662,0.7611557609832936
2021-03-14,GH,Ghana,1448,88421,43,705,0.7973219031677995
2021-03-21,GH,Ghana,1472,89893,29,734,0.8165263146184909
2021-03-28,GH,Ghana,659,90552,8,742,0.8194186765615338
2021-04-04,GH,Ghana,457,91009,10,752,0.8262919051961893
2021-04-11,GH,Ghana,468,91477,11,763,0.8340894432480296
2021-04-18,GH,Ghana,306,91783,9,772,0.841114367584411
2021-04-25,GH,Ghana,681,92464,7,779,0.8424900501816924
2021-05-02,GH,Ghana,276,92740,1,780,0.8410610308389044
2021-05-09,GH,Ghana,271,93011,3,783,0.8418359118813903
2021-05-16,GH,Ghana,445,93456,0,783,0.8378274268104776
2021-05-23,GH,Ghana,255,93711,0,783,0.8355475877965233
2021-05-30,GH,Ghana,300,94011,2,785,0.8350086691982852
2021-06-06,GH,Ghana,358,94369,4,789,0.8360796447986096
2021-06-13,GH,Ghana,455,94824,1,790,0.8331224162659242
2021-06-20,GH,Ghana,412,95236,4,794,0.8337183418035197
2021-06-27,GH,Ghana,678,95914,2,796,0.8299101278228412
2021-07-04,GH,Ghana,794,96708,1,797,0.8241303718410059
2021-07-11,GH,Ghana,1020,97728,5,802,0.820645055664702
2021-07-18,GH,Ghana,2006,99734,15,817,0.8191790161830468
2021-07-25,GH,Ghana,2835,102569,6,823,0.8023866860357418
2021-08-01,GH,Ghana,450,103019,0,823,0.7988817596753998
2021-08-08,GH,Ghana,5658,108677,57,880,0.8097389512040266
2021-08-15,GH,Ghana,3701,112378,65,945,0.8409119222623644
2021-08-22,GH,Ghana,3147,115525,37,982,0.8500324605063839
2021-08-29,GH,Ghana,3911,119436,54,1036,0.8674101610904585
2021-09-05,GH,Ghana,2721,122157,47,1083,0.886564011886343
2021-09-12,GH,Ghana,1717,123874,15,1098,0.8863845520448197
2021-09-19,GH,Ghana,1956,125830,32,1130,0.8980370340936183
2021-09-26,GH,Ghana,1186,127016,20,1150,0.9053977451659633
2021-10-03,GH,Ghana,1143,128159,7,1157,0.9027848219789479
2021-10-10,GH,Ghana,933,129092,7,1164,0.9016825209927803
2021-10-17,GH,Ghana,559,129651,5,1169,0.9016513563335415
2021-10-24,GH,Ghana,390,130041,5,1174,0.9027921963073184
2021-10-31,GH,Ghana,350,130391,14,1188,0.911105827856217
2021-11-07,GH,Ghana,217,130608,15,1203,0.9210768099963249
2021-11-14,GH,Ghana,136,130744,5,1208,0.9239429725264638
2021-11-21,GH,Ghana,176,130920,1,1209,0.9234647112740605
2021-11-28,GH,Ghana,217,131137,15,1224,0.9333750200172339
2021-12-05,GH,Ghana,215,131352,11,1235,0.940221694378464
2021-12-12,GH,Ghana,488,131840,18,1253,0.9503944174757282
2021-12-19,GH,Ghana,2194,134034,14,1267,0.9452825402509811
2021-12-26,GH,Ghana,7261,141295,20,1287,0.9108602569093032
2022-01-02,GH,Ghana,6784,148079,26,1313,0.8866888620263509
2022-01-09,GH,Ghana,4650,152729,23,1336,0.8747520117332007
2022-01-16,GH,Ghana,2162,154891,21,1357,0.8760999670736196
2022-01-23,GH,Ghana,1501,156392,27,1384,0.8849557522123894
2022-01-30,GH,Ghana,828,157220,20,1404,0.893016155705381
2022-02-06,GH,Ghana,697,157917,22,1426,0.9030060094859957
2022-02-13,GH,Ghana,517,158434,12,1438,0.9076334625143593
2022-02-20,GH,Ghana,690,159124,4,1442,0.9062115080063348
2022-02-27,GH,Ghana,904,160028,0,1442,0.9010923088459519
2022-03-06,GH,Ghana,612,160640,0,1442,0.8976593625498007
2022-03-13,GH,Ghana,121,160761,3,1445,0.8988498454227082
2022-03-20,GH,Ghana,109,160870,0,1445,0.8982408155653633
2022-03-27,GH,Ghana,55,160925,0,1445,0.8979338201025323
2022-04-03,GH,Ghana,109,161034,0,1445,0.8973260305277145
2022-04-10,GH,Ghana,52,161086,0,1445,0.8970363656680284
2022-04-17,GH,Ghana,31,161117,0,1445,0.8968637698070346
2022-04-24,GH,Ghana,55,161172,0,1445,0.8965577147395329
2022-05-01,GH,Ghana,44,161216,0,1445,0.8963130210400954
2022-05-08,GH,Ghana,55,161271,0,1445,0.8960073416795331
2022-05-15,GH,Ghana,54,161325,0,1445,0.8957074229040756
2022-05-22,GH,Ghana,45,161370,0,1445,0.8954576439239016
2022-05-29,GH,Ghana,111,161481,0,1445,0.894842117648516
2022-06-05,GH,Ghana,360,161841,0,1445,0.8928516259785839
2022-06-12,GH,Ghana,805,162646,0,1445,0.8884325467579897
2022-06-19,GH,Ghana,1895,164541,3,1448,0.8800238238493749
2022-06-26,GH,Ghana,1208,165749,1,1449,0.8742134190854847
2022-07-03,GH,Ghana,1067,166816,4,1453,0.8710195664684444
2022-07-10,GH,Ghana,399,167215,3,1456,0.8707352809257543
2022-07-17,GH,Ghana,0,167215,0,1456,0.8707352809257543
2022-07-24,GH,Ghana,792,168007,1,1457,0.8672257703548066
2022-07-31,GH,Ghana,120,168127,0,1457,0.8666067912946761
2022-08-07,GH,Ghana,236,168363,1,1458,0.8659859945474956
2022-08-14,GH,Ghana,94,168457,1,1459,0.8660963925512148
2022-08-21,GH,Ghana,0,168457,0,1459,0.8660963925512148
2022-08-28,GH,Ghana,123,168580,0,1459,0.8654644679084115
2022-09-04,GH,Ghana,36,168616,0,1459,0.86527968876026
2022-09-11,GH,Ghana,0,168616,0,1459,0.86527968876026
2022-09-18,GH,Ghana,197,168813,0,1459,0.8642699318180471
2022-09-25,GH,Ghana,287,169100,0,1459,0.8628030751034891
2022-10-02,GH,Ghana,585,169685,0,1459,0.8598285057606742
2022-10-09,GH,Ghana,418,170103,0,1459,0.8577156193600348
2022-10-16,GH,Ghana,318,170421,1,1460,0.8567019322736048
2022-10-23,GH,Ghana,152,170573,0,1460,0.855938513129276
2022-10-30,GH,Ghana,134,170707,0,1460,0.855266626441798
2022-11-06,GH,Ghana,187,170894,0,1460,0.8543307547368545
2022-11-13,GH,Ghana,78,170972,1,1461,0.8545258872797884
2022-11-20,GH,Ghana,24,170996,0,1461,0.854405951016398
2022-11-27,GH,Ghana,13,171009,0,1461,0.8543409995965124
2022-12-04,GH,Ghana,14,171023,0,1461,0.8542710629564444
2022-12-11,GH,Ghana,8,171031,0,1461,0.8542311043027286
2022-12-18,GH,Ghana,7,171038,0,1461,0.854196143547048
2022-12-25,GH,Ghana,0,171038,0,1461,0.854196143547048
2023-01-01,GH,Ghana,27,171065,0,1461,0.8540613217198141
2023-01-08,GH,Ghana,5,171070,0,1461,0.8540363593850471
2023-01-15,GH,Ghana,18,171088,1,1462,0.8545310015898252
2023-01-22,GH,Ghana,14,171102,0,1462,0.8544610816939604
2023-01-29,GH,Ghana,10,171112,0,1462,0.8544111459161251
2023-02-05,GH,Ghana,28,171140,0,1462,0.8542713567839196
2023-02-12,GH,Ghana,12,171152,0,1462,0.8542114611573339
2023-02-19,GH,Ghana,8,171160,0,1462,0.8541715354054685
2023-02-26,GH,Ghana,12,171172,0,1462,0.8541116537751501
2023-03-05,GH,Ghana,57,171229,0,1462,0.8538273306507659
2023-03-12,GH,Ghana,52,171281,0,1462,0.8535681132174613
2023-03-19,GH,Ghana,7,171288,0,1462,0.8535332305824108
2023-03-26,GH,Ghana,124,171412,0,1462,0.8529157818589129
2023-04-02,GH,Ghana,115,171527,0,1462,0.8523439458510905
2023-04-09,GH,Ghana,0,171527,0,1462,0.8523439458510905
2023-04-16,GH,Ghana,92,171619,0,1462,0.8518870288254796
2023-04-23,GH,Ghana,0,171619,0,1462,0.8518870288254796
2023-04-30,GH,Ghana,34,171653,0,1462,0.8517182921358788
2023-05-07,GH,Ghana,0,171653,0,1462,0.8517182921358788
2023-05-14,GH,Ghana,0,171653,0,1462,0.8517182921358788
2023-05-21,GH,Ghana,0,171653,0,1462,0.8517182921358788
2023-05-28,GH,Ghana,0,171653,0,1462,0.8517182921358788
2023-06-04,GH,Ghana,0,171653,0,1462,0.8517182921358788
2023-06-11,GH,Ghana,0,171653,0,1462,0.8517182921358788
2023-06-18,GH,Ghana,0,171653,0,1462,0.8517182921358788
2023-06-25,GH,Ghana,0,171653,0,1462,0.8517182921358788
2023-07-02,GH,Ghana,0,171653,0,1462,0.8517182921358788
2023-07-09,GH,Ghana,0,171653,0,1462,0.8517182921358788
2023-07-16,GH,Ghana,0,171653,0,1462,0.8517182921358788
2023-07-23,GH,Ghana,0,171653,0,1462,0.8517182921358788
2023-07-30,GH,Ghana,0,171653,0,1462,0.8517182921358788
2023-08-06,GH,Ghana,0,171653,0,1462,0.8517182921358788
2023-08-13,GH,Ghana,0,171653,0,1462,0.8517182921358788
2023-08-20,GH,Ghana,0,171653,0,1462,0.8517182921358788
2023-08-27,GH,Ghana,0,171653,0,1462,0.8517182921358788
2023-09-03,GH,Ghana,0,171653,0,1462,0.8517182921358788
2023-09-10,GH,Ghana,0,171653,0,1462,0.8517182921358788
2023-09-17,GH,Ghana,0,171653,0,1462,0.8517182921358788
2023-09-24,GH,Ghana,0,171653,0,1462,0.8517182921358788
2023-10-01,GH,Ghana,0,171653,0,1462,0.8517182921358788
2023-10-08,GH,Ghana,30,171683,0,1462,0.8515694623230022
2023-10-15,GH,Ghana,20,171703,0,1462,0.8514702713406289
2023-10-22,GH,Ghana,23,171726,0,1462,0.8513562302738084
2023-10-29,GH,Ghana,27,171753,0,1462,0.8512223949508888
2023-11-05,GH,Ghana,31,171784,0,1462,0.8510687840543939
2023-11-12,GH,Ghana,24,171808,0,1462,0.850949897560067
2023-11-19,GH,Ghana,10,171818,0,1462,0.8509003713231442
2023-11-26,GH,Ghana,9,171827,0,1462,0.8508558026387005
2023-12-03,GH,Ghana,7,171834,0,1462,0.8508211413340782
2023-12-10,GH,Ghana,0,171834,0,1462,0.8508211413340782
2023-12-17,GH,Ghana,0,171834,0,1462,0.8508211413340782
2023-12-24,GH,Ghana,0,171834,0,1462,0.8508211413340782
2023-12-31,GH,Ghana,0,171834,0,1462,0.8508211413340782
2024-01-07,GH,Ghana,0,171834,0,1462,0.8508211413340782
2024-01-14,GH,Ghana,0,171834,0,1462,0.8508211413340782
2020-11-15,GI,Gibraltar,106,868,1,1,0.1152073732718894
2020-11-22,GI,Gibraltar,67,935,2,3,0.32085561497326204
2020-11-29,GI,Gibraltar,56,991,2,5,0.5045408678102926
2020-12-06,GI,Gibraltar,43,1034,0,5,0.4835589941972921
2020-12-13,GI,Gibraltar,28,1062,0,5,0.4708097928436911
2020-12-20,GI,Gibraltar,114,1176,1,6,0.5102040816326531
2020-12-27,GI,Gibraltar,350,1526,0,6,0.39318479685452157
2021-01-03,GI,Gibraltar,678,2204,1,7,0.3176043557168784
2021-01-10,GI,Gibraltar,809,3013,5,12,0.39827414537006306
2021-01-17,GI,Gibraltar,554,3567,18,30,0.8410428931875525
2022-01-16,GI,Gibraltar,1007,10725,0,100,0.9324009324009324
2022-01-23,GI,Gibraltar,977,11702,0,100,0.8545547769612033
2022-01-30,GI,Gibraltar,1050,12752,0,100,0.7841907151819323
2022-02-06,GI,Gibraltar,825,13577,1,101,0.7439051336819621
2022-02-13,GI,Gibraltar,768,14345,0,101,0.7040780759846637
2022-02-20,GI,Gibraltar,528,14873,0,101,0.6790829019027768
2022-02-27,GI,Gibraltar,440,15313,0,101,0.6595702997453144
2022-03-06,GI,Gibraltar,296,15609,0,101,0.6470625920943046
2022-03-13,GI,Gibraltar,231,15840,0,101,0.6376262626262627
2022-03-20,GI,Gibraltar,326,16166,0,101,0.624768031671409
2022-03-27,GI,Gibraltar,434,16600,0,101,0.608433734939759
2022-04-03,GI,Gibraltar,379,16979,0,101,0.5948524648094705
2022-04-10,GI,Gibraltar,331,17310,0,101,0.5834777585210861
2022-04-17,GI,Gibraltar,0,17310,0,101,0.5834777585210861
2022-04-24,GI,Gibraltar,447,17757,0,101,0.568789773047249
2022-05-01,GI,Gibraltar,129,17886,1,102,0.5702784300570278
2022-05-08,GI,Gibraltar,121,18007,0,102,0.5664463819625701
2022-05-15,GI,Gibraltar,133,18140,0,102,0.5622932745314222
2022-05-22,GI,Gibraltar,144,18284,0,102,0.5578647998249836
2022-05-29,GI,Gibraltar,143,18427,0,102,0.5535355728007815
2022-06-05,GI,Gibraltar,164,18591,0,102,0.5486525738260448
2022-06-12,GI,Gibraltar,215,18806,0,102,0.5423800914601723
2022-06-19,GI,Gibraltar,204,19010,0,102,0.536559705418201
2022-06-26,GI,Gibraltar,296,19306,2,104,0.5386926344141718
2022-07-03,GI,Gibraltar,327,19633,0,104,0.5297203687668721
2022-07-10,GI,Gibraltar,163,19796,1,105,0.5304101838755304
2022-07-17,GI,Gibraltar,66,19862,0,105,0.5286476689155171
2022-07-24,GI,Gibraltar,40,19902,0,105,0.5275851673198674
2022-07-31,GI,Gibraltar,0,19902,0,105,0.5275851673198674
2022-08-07,GI,Gibraltar,97,19999,1,106,0.5300265013250662
2022-08-14,GI,Gibraltar,35,20034,0,106,0.5291005291005291
2022-08-21,GI,Gibraltar,15,20049,1,107,0.533692453488952
2022-08-28,GI,Gibraltar,0,20049,0,107,0.533692453488952
2022-09-04,GI,Gibraltar,20,20069,1,108,0.5381434052518811
2022-09-11,GI,Gibraltar,0,20069,0,108,0.5381434052518811
2022-09-18,GI,Gibraltar,0,20069,0,108,0.5381434052518811
2022-09-25,GI,Gibraltar,23,20092,0,108,0.5375273740792356
2022-10-02,GI,Gibraltar,3,20095,0,108,0.5374471261507837
2022-10-09,GI,Gibraltar,0,20095,0,108,0.5374471261507837
2022-10-16,GI,Gibraltar,26,20121,0,108,0.5367526464887431
2022-10-23,GI,Gibraltar,0,20121,0,108,0.5367526464887431
2022-10-30,GI,Gibraltar,0,20121,0,108,0.5367526464887431
2022-11-06,GI,Gibraltar,0,20121,0,108,0.5367526464887431
2022-11-13,GI,Gibraltar,45,20166,2,110,0.5454725776058713
2022-11-20,GI,Gibraltar,18,20184,0,110,0.5449861276258423
2022-11-27,GI,Gibraltar,9,20193,0,110,0.5447432278512356
2022-12-04,GI,Gibraltar,14,20207,0,110,0.5443658138268916
2022-12-11,GI,Gibraltar,16,20223,0,110,0.5439351233743758
2022-12-18,GI,Gibraltar,29,20252,0,110,0.5431562314833103
2022-12-25,GI,Gibraltar,23,20275,0,110,0.5425400739827373
2023-01-01,GI,Gibraltar,30,20305,0,110,0.5417384880571288
2023-01-08,GI,Gibraltar,37,20342,1,111,0.5456690590895684
2023-01-15,GI,Gibraltar,37,20379,0,111,0.5446783453555131
2023-01-22,GI,Gibraltar,13,20392,0,111,0.5443311102393095
2023-01-29,GI,Gibraltar,7,20399,0,111,0.5441443208000392
2023-02-05,GI,Gibraltar,0,20399,0,111,0.5441443208000392
2023-02-12,GI,Gibraltar,0,20399,0,111,0.5441443208000392
2023-02-19,GI,Gibraltar,15,20414,0,111,0.5437444890761243
2023-02-26,GI,Gibraltar,9,20423,0,111,0.5435048719580865
2023-03-05,GI,Gibraltar,10,20433,0,111,0.543238878285127
2023-03-12,GI,Gibraltar,29,20462,0,111,0.542468966865409
2023-03-19,GI,Gibraltar,0,20462,0,111,0.542468966865409
2023-03-26,GI,Gibraltar,0,20462,0,111,0.542468966865409
2023-04-02,GI,Gibraltar,0,20462,0,111,0.542468966865409
2023-04-09,GI,Gibraltar,88,20550,2,113,0.5498783454987834
2023-04-16,GI,Gibraltar,0,20550,0,113,0.5498783454987834
2023-04-23,GI,Gibraltar,0,20550,0,113,0.5498783454987834
2023-04-30,GI,Gibraltar,0,20550,0,113,0.5498783454987834
2023-05-07,GI,Gibraltar,0,20550,0,113,0.5498783454987834
2023-05-14,GI,Gibraltar,0,20550,0,113,0.5498783454987834
2023-05-21,GI,Gibraltar,0,20550,0,113,0.5498783454987834
2023-05-28,GI,Gibraltar,0,20550,0,113,0.5498783454987834
2023-06-04,GI,Gibraltar,0,20550,0,113,0.5498783454987834
2023-06-11,GI,Gibraltar,0,20550,0,113,0.5498783454987834
2023-06-18,GI,Gibraltar,0,20550,0,113,0.5498783454987834
2023-06-25,GI,Gibraltar,0,20550,0,113,0.5498783454987834
2023-07-02,GI,Gibraltar,0,20550,0,113,0.5498783454987834
2023-07-09,GI,Gibraltar,0,20550,0,113,0.5498783454987834
2023-07-16,GI,Gibraltar,0,20550,0,113,0.5498783454987834
2023-07-23,GI,Gibraltar,0,20550,0,113,0.5498783454987834
2023-07-30,GI,Gibraltar,0,20550,0,113,0.5498783454987834
2023-08-06,GI,Gibraltar,0,20550,0,113,0.5498783454987834
2023-08-13,GI,Gibraltar,0,20550,0,113,0.5498783454987834
2023-08-20,GI,Gibraltar,0,20550,0,113,0.5498783454987834
2023-08-27,GI,Gibraltar,0,20550,0,113,0.5498783454987834
2023-09-03,GI,Gibraltar,0,20550,0,113,0.5498783454987834
2023-09-10,GI,Gibraltar,0,20550,0,113,0.5498783454987834
2023-09-17,GI,Gibraltar,0,20550,0,113,0.5498783454987834
2023-09-24,GI,Gibraltar,0,20550,0,113,0.5498783454987834
2023-10-01,GI,Gibraltar,0,20550,0,113,0.5498783454987834
2023-10-08,GI,Gibraltar,0,20550,0,113,0.5498783454987834
2023-10-15,GI,Gibraltar,0,20550,0,113,0.5498783454987834
2023-10-22,GI,Gibraltar,0,20550,0,113,0.5498783454987834
2023-10-29,GI,Gibraltar,0,20550,0,113,0.5498783454987834
2023-11-05,GI,Gibraltar,0,20550,0,113,0.5498783454987834
2023-11-12,GI,Gibraltar,0,20550,0,113,0.5498783454987834
2023-11-19,GI,Gibraltar,0,20550,0,113,0.5498783454987834
2023-11-26,GI,Gibraltar,0,20550,0,113,0.5498783454987834
2023-12-03,GI,Gibraltar,0,20550,0,113,0.5498783454987834
2023-12-10,GI,Gibraltar,0,20550,0,113,0.5498783454987834
2023-12-17,GI,Gibraltar,0,20550,0,113,0.5498783454987834
2023-12-24,GI,Gibraltar,0,20550,0,113,0.5498783454987834
2023-12-31,GI,Gibraltar,0,20550,0,113,0.5498783454987834
2024-01-07,GI,Gibraltar,0,20550,0,113,0.5498783454987834
2024-01-14,GI,Gibraltar,0,20550,0,113,0.5498783454987834
2020-03-15,GR,Greece,327,413,4,4,0.9685230024213075
2022-03-20,GR,Greece,152111,2797753,367,27028,0.9660609782207363
2022-03-27,GR,Greece,143814,2941567,366,27394,0.9312723456579436
2022-04-03,GR,Greece,143843,3085410,416,27810,0.9013388820286445
2022-04-10,GR,Greece,98897,3184307,456,28266,0.8876656679145571
2022-04-17,GR,Greece,62234,3246541,419,28685,0.8835557598071302
2022-04-24,GR,Greece,44022,3290563,319,29004,0.881429712787751
2022-05-01,GR,Greece,45138,3335701,269,29273,0.8775666643982778
2022-05-08,GR,Greece,32496,3368197,189,29462,0.8747113069692777
2022-05-15,GR,Greece,30781,3398978,153,29615,0.8712913116825116
2022-05-22,GR,Greece,26875,3425853,132,29747,0.8683092940648651
2022-05-29,GR,Greece,25494,3451347,102,29849,0.8648507379872263
2022-06-05,GR,Greece,25086,3476433,93,29942,0.8612851160945716
2022-06-12,GR,Greece,30745,3507178,99,30041,0.8565576084247791
2022-06-19,GR,Greece,46178,3553356,71,30112,0.8474242378191209
2022-06-26,GR,Greece,74364,3627720,96,30208,0.8326993262986119
2022-07-03,GR,Greece,104747,3732467,129,30337,0.8127868243711197
2022-07-10,GR,Greece,123806,3856273,180,30517,0.7913599478045253
2022-07-17,GR,Greece,122642,3978915,223,30740,0.7725724223814784
2022-07-24,GR,Greece,111500,4090415,307,31047,0.7590183392149696
2022-07-31,GR,Greece,98860,4189275,395,31442,0.750535593867674
2022-08-07,GR,Greece,80050,4269325,363,31805,0.7449655390489129
2022-08-14,GR,Greece,58577,4327902,295,32100,0.7416988647155134
2022-08-21,GR,Greece,43917,4371819,269,32369,0.7404011922725986
2022-08-28,GR,Greece,39307,4411126,223,32592,0.7388589670755268
2022-09-04,GR,Greece,31034,4442160,188,32780,0.7379292956579682
2022-09-11,GR,Greece,26254,4468414,129,32909,0.7364805499221871
2022-09-18,GR,Greece,27374,4495788,115,33024,0.7345542094066713
2022-09-25,GR,Greece,33079,4528867,101,33125,0.7314191386057484
2022-10-02,GR,Greece,41207,4570074,91,33216,0.7268153644776868
2022-10-09,GR,Greece,39791,4609865,118,33334,0.7231014357253411
2022-10-16,GR,Greece,43578,4653443,114,33448,0.7187796218842694
2022-10-23,GR,Greece,41373,4694816,151,33599,0.7156617000538467
2022-10-30,GR,Greece,41133,4735949,170,33769,0.7130355500027555
2022-11-06,GR,Greece,46212,4782161,152,33921,0.7093236718713569
2022-11-13,GR,Greece,41738,4823899,126,34047,0.7057983593769273
2022-11-20,GR,Greece,39464,4863363,166,34213,0.7034843995811129
2022-11-27,GR,Greece,31609,4894972,132,34345,0.7016383341927186
2022-12-04,GR,Greece,31490,4926462,159,34504,0.7003809224551006
2022-12-11,GR,Greece,36508,4962970,144,34648,0.69813035339726
2022-12-18,GR,Greece,33272,4996242,158,34806,0.6966435973277515
2022-12-25,GR,Greece,26921,5023163,170,34976,0.6962943468089727
2023-01-01,GR,Greece,34711,5057874,154,35130,0.6945605999674962
2023-01-08,GR,Greece,39318,5097192,169,35299,0.6925185474669191
2023-01-15,GR,Greece,34620,5131812,206,35505,0.691860886564044
2023-01-22,GR,Greece,24354,5156166,183,35688,0.6921421847163183
2023-01-29,GR,Greece,15380,5171546,179,35867,0.6935450250273322
2023-02-05,GR,Greece,12032,5183578,120,35987,0.69425018780464
2023-02-12,GR,Greece,11224,5194802,113,36100,0.6949254273791379
2023-02-19,GR,Greece,13029,5207831,101,36201,0.6951262435359365
2023-02-26,GR,Greece,14969,5222800,93,36294,0.6949146051926169
2023-03-05,GR,Greece,13365,5236165,96,36390,0.6949742798403029
2023-03-12,GR,Greece,10361,5246526,76,36466,0.6950504009700895
2023-03-19,GR,Greece,7500,5254026,77,36543,0.6955237754818876
2023-03-26,GR,Greece,7318,5261344,66,36609,0.6958108042355717
2023-04-02,GR,Greece,7142,5268486,50,36659,0.6958165970261665
2023-04-09,GR,Greece,6466,5274952,48,36707,0.6958736306984405
2023-04-16,GR,Greece,6149,5281101,46,36753,0.6959344273097599
2023-04-23,GR,Greece,8656,5289757,47,36800,0.6956841306698965
2023-04-30,GR,Greece,7292,5297049,61,36861,0.6958780256705196
2023-05-07,GR,Greece,6621,5303670,55,36916,0.6960463226407375
2023-05-14,GR,Greece,7212,5310882,56,36972,0.6961555538232632
2023-05-21,GR,Greece,7592,5318474,56,37028,0.6962147412960935
2023-05-28,GR,Greece,6130,5324604,49,37077,0.6963334738132638
2023-06-04,GR,Greece,4259,5328863,44,37121,0.6966026336199673
2023-06-11,GR,Greece,3145,5332008,39,37160,0.6969231854115748
2023-06-18,GR,Greece,2467,5334475,20,37180,0.6969758036170383
2023-06-25,GR,Greece,2367,5336842,20,37200,0.697041433866695
2023-07-02,GR,Greece,1850,5338692,18,37218,0.6971370515474578
2023-07-09,GR,Greece,1873,5340565,16,37234,0.6971921510177295
2023-07-16,GR,Greece,1989,5342554,17,37251,0.697250790539506
2023-07-23,GR,Greece,2598,5345152,17,37268,0.6972299384563807
2023-07-30,GR,Greece,3375,5348527,26,37294,0.6972760911555649
2023-08-06,GR,Greece,4424,5352951,27,37321,0.6972042150208362
2023-08-13,GR,Greece,5477,5358428,21,37342,0.6968834889635542
2023-08-20,GR,Greece,5781,5364209,37,37379,0.6968222155400731
2023-08-27,GR,Greece,6876,5371085,43,37422,0.6967307350377066
2023-09-03,GR,Greece,7378,5378463,39,37461,0.6965000967748592
2023-09-10,GR,Greece,7542,5386005,39,37500,0.6962488894830212
2023-09-17,GR,Greece,8636,5394641,44,37544,0.6959499251201331
2023-09-24,GR,Greece,11333,5405974,44,37588,0.6953048608816839
2023-10-01,GR,Greece,11478,5417452,56,37644,0.6948654090520784
2023-10-08,GR,Greece,12532,5429984,55,37699,0.6942746055973645
2023-10-15,GR,Greece,13137,5443121,55,37754,0.6936094200367767
2023-10-22,GR,Greece,11849,5454970,52,37806,0.6930560571368861
2023-10-29,GR,Greece,9555,5464525,63,37869,0.6929971040483848
2023-11-05,GR,Greece,9279,5473804,62,37931,0.692955027253442
2023-11-12,GR,Greece,7755,5481559,57,37988,0.6930145237878494
2023-11-19,GR,Greece,7795,5489354,30,38018,0.6925769407474905
2023-11-26,GR,Greece,8341,5497695,47,38065,0.6923810797070409
2023-12-03,GR,Greece,9891,5507586,46,38111,0.6919728534425064
2023-12-10,GR,Greece,11898,5519484,57,38168,0.6915139168806359
2023-12-17,GR,Greece,14565,5534049,66,38234,0.6908865461798405
2023-12-24,GR,Greece,16922,5550971,78,38312,0.6901855549236341
2023-12-31,GR,Greece,19289,5570260,85,38397,0.6893215038436267
2024-01-07,GR,Greece,17814,5588074,93,38490,0.6887883016581384
2024-01-14,GR,Greece,0,5588074,0,38490,0.6887883016581384
2021-12-26,GL,Greenland,230,2141,1,1,0.046707146193367584
2022-01-02,GL,Greenland,475,2616,0,1,0.0382262996941896
2022-01-09,GL,Greenland,1883,4499,0,1,0.02222716159146477
2022-01-16,GL,Greenland,3047,7546,1,2,0.026504108136761195
2022-01-23,GL,Greenland,1939,9485,2,4,0.04217185028993147
2022-01-30,GL,Greenland,1142,10627,1,5,0.047049967065023054
2022-02-06,GL,Greenland,450,11077,1,6,0.05416629051187144
2022-02-13,GL,Greenland,352,11429,1,7,0.06124770321112959
2022-02-20,GL,Greenland,186,11615,5,12,0.10331467929401636
2022-02-27,GL,Greenland,110,11725,6,18,0.15351812366737738
2022-03-06,GL,Greenland,85,11810,2,20,0.1693480101608806
2022-03-13,GL,Greenland,69,11879,0,20,0.16836434043269635
2022-03-20,GL,Greenland,57,11936,0,20,0.1675603217158177
2022-03-27,GL,Greenland,35,11971,1,21,0.1754239411912121
2022-04-03,GL,Greenland,0,11971,0,21,0.1754239411912121
2022-04-10,GL,Greenland,0,11971,0,21,0.1754239411912121
2022-04-17,GL,Greenland,0,11971,0,21,0.1754239411912121
2022-04-24,GL,Greenland,0,11971,0,21,0.1754239411912121
2022-05-01,GL,Greenland,0,11971,0,21,0.1754239411912121
2022-05-08,GL,Greenland,0,11971,0,21,0.1754239411912121
2022-05-15,GL,Greenland,0,11971,0,21,0.1754239411912121
2022-05-22,GL,Greenland,0,11971,0,21,0.1754239411912121
2022-05-29,GL,Greenland,0,11971,0,21,0.1754239411912121
2022-06-05,GL,Greenland,0,11971,0,21,0.1754239411912121
2022-06-12,GL,Greenland,0,11971,0,21,0.1754239411912121
2022-06-19,GL,Greenland,0,11971,0,21,0.1754239411912121
2022-06-26,GL,Greenland,0,11971,0,21,0.1754239411912121
2022-07-03,GL,Greenland,0,11971,0,21,0.1754239411912121
2022-07-10,GL,Greenland,0,11971,0,21,0.1754239411912121
2022-07-17,GL,Greenland,0,11971,0,21,0.1754239411912121
2022-07-24,GL,Greenland,0,11971,0,21,0.1754239411912121
2022-07-31,GL,Greenland,0,11971,0,21,0.1754239411912121
2022-08-07,GL,Greenland,0,11971,0,21,0.1754239411912121
2022-08-14,GL,Greenland,0,11971,0,21,0.1754239411912121
2022-08-21,GL,Greenland,0,11971,0,21,0.1754239411912121
2022-08-28,GL,Greenland,0,11971,0,21,0.1754239411912121
2022-09-04,GL,Greenland,0,11971,0,21,0.1754239411912121
2022-09-11,GL,Greenland,0,11971,0,21,0.1754239411912121
2022-09-18,GL,Greenland,0,11971,0,21,0.1754239411912121
2022-09-25,GL,Greenland,0,11971,0,21,0.1754239411912121
2022-10-02,GL,Greenland,0,11971,0,21,0.1754239411912121
2022-10-09,GL,Greenland,0,11971,0,21,0.1754239411912121
2022-10-16,GL,Greenland,0,11971,0,21,0.1754239411912121
2022-10-23,GL,Greenland,0,11971,0,21,0.1754239411912121
2022-10-30,GL,Greenland,0,11971,0,21,0.1754239411912121
2022-11-06,GL,Greenland,0,11971,0,21,0.1754239411912121
2022-11-13,GL,Greenland,0,11971,0,21,0.1754239411912121
2022-11-20,GL,Greenland,0,11971,0,21,0.1754239411912121
2022-11-27,GL,Greenland,0,11971,0,21,0.1754239411912121
2022-12-04,GL,Greenland,0,11971,0,21,0.1754239411912121
2022-12-11,GL,Greenland,0,11971,0,21,0.1754239411912121
2022-12-18,GL,Greenland,0,11971,0,21,0.1754239411912121
2022-12-25,GL,Greenland,0,11971,0,21,0.1754239411912121
2023-01-01,GL,Greenland,0,11971,0,21,0.1754239411912121
2023-01-08,GL,Greenland,0,11971,0,21,0.1754239411912121
2023-01-15,GL,Greenland,0,11971,0,21,0.1754239411912121
2023-01-22,GL,Greenland,0,11971,0,21,0.1754239411912121
2023-01-29,GL,Greenland,0,11971,0,21,0.1754239411912121
2023-02-05,GL,Greenland,0,11971,0,21,0.1754239411912121
2023-02-12,GL,Greenland,0,11971,0,21,0.1754239411912121
2023-02-19,GL,Greenland,0,11971,0,21,0.1754239411912121
2023-02-26,GL,Greenland,0,11971,0,21,0.1754239411912121
2023-03-05,GL,Greenland,0,11971,0,21,0.1754239411912121
2023-03-12,GL,Greenland,0,11971,0,21,0.1754239411912121
2023-03-19,GL,Greenland,0,11971,0,21,0.1754239411912121
2023-03-26,GL,Greenland,0,11971,0,21,0.1754239411912121
2023-04-02,GL,Greenland,0,11971,0,21,0.1754239411912121
2023-04-09,GL,Greenland,0,11971,0,21,0.1754239411912121
2023-04-16,GL,Greenland,0,11971,0,21,0.1754239411912121
2023-04-23,GL,Greenland,0,11971,0,21,0.1754239411912121
2023-04-30,GL,Greenland,0,11971,0,21,0.1754239411912121
2023-05-07,GL,Greenland,0,11971,0,21,0.1754239411912121
2023-05-14,GL,Greenland,0,11971,0,21,0.1754239411912121
2023-05-21,GL,Greenland,0,11971,0,21,0.1754239411912121
2023-05-28,GL,Greenland,0,11971,0,21,0.1754239411912121
2023-06-04,GL,Greenland,0,11971,0,21,0.1754239411912121
2023-06-11,GL,Greenland,0,11971,0,21,0.1754239411912121
2023-06-18,GL,Greenland,0,11971,0,21,0.1754239411912121
2023-06-25,GL,Greenland,0,11971,0,21,0.1754239411912121
2023-07-02,GL,Greenland,0,11971,0,21,0.1754239411912121
2023-07-09,GL,Greenland,0,11971,0,21,0.1754239411912121
2023-07-16,GL,Greenland,0,11971,0,21,0.1754239411912121
2023-07-23,GL,Greenland,0,11971,0,21,0.1754239411912121
2023-07-30,GL,Greenland,0,11971,0,21,0.1754239411912121
2023-08-06,GL,Greenland,0,11971,0,21,0.1754239411912121
2023-08-13,GL,Greenland,0,11971,0,21,0.1754239411912121
2023-08-20,GL,Greenland,0,11971,0,21,0.1754239411912121
2023-08-27,GL,Greenland,0,11971,0,21,0.1754239411912121
2023-09-03,GL,Greenland,0,11971,0,21,0.1754239411912121
2023-09-10,GL,Greenland,0,11971,0,21,0.1754239411912121
2023-09-17,GL,Greenland,0,11971,0,21,0.1754239411912121
2023-09-24,GL,Greenland,0,11971,0,21,0.1754239411912121
2023-10-01,GL,Greenland,0,11971,0,21,0.1754239411912121
2023-10-08,GL,Greenland,0,11971,0,21,0.1754239411912121
2023-10-15,GL,Greenland,0,11971,0,21,0.1754239411912121
2023-10-22,GL,Greenland,0,11971,0,21,0.1754239411912121
2023-10-29,GL,Greenland,0,11971,0,21,0.1754239411912121
2023-11-05,GL,Greenland,0,11971,0,21,0.1754239411912121
2023-11-12,GL,Greenland,0,11971,0,21,0.1754239411912121
2023-11-19,GL,Greenland,0,11971,0,21,0.1754239411912121
2023-11-26,GL,Greenland,0,11971,0,21,0.1754239411912121
2023-12-03,GL,Greenland,0,11971,0,21,0.1754239411912121
2023-12-10,GL,Greenland,0,11971,0,21,0.1754239411912121
2023-12-17,GL,Greenland,0,11971,0,21,0.1754239411912121
2023-12-24,GL,Greenland,0,11971,0,21,0.1754239411912121
2023-12-31,GL,Greenland,0,11971,0,21,0.1754239411912121
2024-01-07,GL,Greenland,0,11971,0,21,0.1754239411912121
2024-01-14,GL,Greenland,0,11971,0,21,0.1754239411912121
2021-01-10,GD,Grenada,6,135,1,1,0.7407407407407408
2021-01-17,GD,Grenada,4,139,0,1,0.7194244604316548
2021-01-24,GD,Grenada,8,147,0,1,0.6802721088435374
2021-01-31,GD,Grenada,1,148,0,1,0.6756756756756757
2021-02-07,GD,Grenada,0,148,0,1,0.6756756756756757
2021-02-14,GD,Grenada,0,148,0,1,0.6756756756756757
2021-02-21,GD,Grenada,0,148,0,1,0.6756756756756757
2021-02-28,GD,Grenada,0,148,0,1,0.6756756756756757
2021-03-07,GD,Grenada,3,151,0,1,0.6622516556291391
2021-03-14,GD,Grenada,0,151,0,1,0.6622516556291391
2021-03-21,GD,Grenada,3,154,0,1,0.6493506493506493
2021-03-28,GD,Grenada,1,155,0,1,0.6451612903225806
2021-04-04,GD,Grenada,0,155,0,1,0.6451612903225806
2021-04-11,GD,Grenada,2,157,0,1,0.6369426751592357
2021-04-18,GD,Grenada,2,159,0,1,0.628930817610063
2021-04-25,GD,Grenada,0,159,0,1,0.628930817610063
2021-05-02,GD,Grenada,2,161,0,1,0.6211180124223602
2021-05-09,GD,Grenada,0,161,0,1,0.6211180124223602
2021-05-16,GD,Grenada,0,161,0,1,0.6211180124223602
2021-05-23,GD,Grenada,0,161,0,1,0.6211180124223602
2021-05-30,GD,Grenada,0,161,0,1,0.6211180124223602
2021-06-06,GD,Grenada,0,161,0,1,0.6211180124223602
2021-06-13,GD,Grenada,0,161,0,1,0.6211180124223602
2021-06-20,GD,Grenada,0,161,0,1,0.6211180124223602
2021-06-27,GD,Grenada,1,162,0,1,0.6172839506172839
2021-07-04,GD,Grenada,0,162,0,1,0.6172839506172839
2021-07-11,GD,Grenada,0,162,0,1,0.6172839506172839
2021-07-18,GD,Grenada,1,163,0,1,0.6134969325153374
2021-07-25,GD,Grenada,2,165,0,1,0.6060606060606061
2021-08-01,GD,Grenada,4,169,0,1,0.591715976331361
2021-08-08,GD,Grenada,3,172,0,1,0.5813953488372093
2021-08-15,GD,Grenada,13,185,0,1,0.5405405405405406
2021-08-22,GD,Grenada,27,212,0,1,0.4716981132075472
2021-08-29,GD,Grenada,84,296,0,1,0.33783783783783783
2021-09-05,GD,Grenada,802,1098,4,5,0.45537340619307837
2020-09-13,GP,Guadeloupe,1717,3080,4,24,0.7792207792207793
2020-09-20,GP,Guadeloupe,346,3426,2,26,0.7589025102159953
2020-09-27,GP,Guadeloupe,1528,4954,16,42,0.8477997577714977
2022-01-23,GP,Guadeloupe,17089,90749,9,844,0.9300377965597416
2022-01-30,GP,Guadeloupe,13430,104179,11,855,0.8207028287850718
2022-02-06,GP,Guadeloupe,8489,112668,18,873,0.7748429012674406
2022-02-13,GP,Guadeloupe,5509,118177,16,889,0.7522614383509482
2022-02-20,GP,Guadeloupe,4034,122211,20,909,0.74379556668385
2022-02-27,GP,Guadeloupe,2317,124528,9,918,0.7371836052935886
2022-03-06,GP,Guadeloupe,1728,126256,1,919,0.727886199467748
2022-03-13,GP,Guadeloupe,2097,128353,5,924,0.71988967924396
2022-03-20,GP,Guadeloupe,4006,132359,4,928,0.7011234596816235
2022-03-27,GP,Guadeloupe,3622,135981,3,931,0.684654473786779
2022-04-03,GP,Guadeloupe,3535,139516,7,938,0.6723243212248058
2022-04-10,GP,Guadeloupe,3057,142573,2,940,0.6593113703155576
2022-04-17,GP,Guadeloupe,2655,145228,1,941,0.6479466769493486
2022-04-24,GP,Guadeloupe,2379,147607,1,942,0.638181116071731
2022-05-01,GP,Guadeloupe,2348,149955,2,944,0.6295221899903304
2022-05-08,GP,Guadeloupe,2561,152516,1,945,0.6196071231870754
2022-05-15,GP,Guadeloupe,2576,155092,0,945,0.6093157609676837
2022-05-22,GP,Guadeloupe,2773,157865,2,947,0.5998796439996199
2022-05-29,GP,Guadeloupe,2498,160363,1,948,0.5911588084533215
2022-06-05,GP,Guadeloupe,1827,162190,1,949,0.5851162217152722
2022-06-12,GP,Guadeloupe,2135,164325,1,950,0.5781226228510574
2022-06-19,GP,Guadeloupe,2099,166424,0,950,0.5708311301254627
2022-06-26,GP,Guadeloupe,2290,168714,5,955,0.5660466825515369
2022-07-03,GP,Guadeloupe,2717,171431,2,957,0.5582420915703694
2022-07-10,GP,Guadeloupe,3917,175348,1,958,0.5463421310764879
2022-07-17,GP,Guadeloupe,3937,179285,2,960,0.5354603006386479
2022-07-24,GP,Guadeloupe,3733,183018,5,965,0.5272705416953524
2022-07-31,GP,Guadeloupe,3362,186380,6,971,0.5209786457774439
2022-08-07,GP,Guadeloupe,2236,188616,4,975,0.5169232726810027
2022-08-14,GP,Guadeloupe,1438,190054,3,978,0.5145905900428299
2022-08-21,GP,Guadeloupe,1063,191117,4,982,0.5138213764343308
2022-08-28,GP,Guadeloupe,880,191997,4,986,0.5135496908805868
2022-09-04,GP,Guadeloupe,767,192764,0,986,0.5115062978564462
2022-09-11,GP,Guadeloupe,729,193493,1,987,0.5100959724641202
2022-09-18,GP,Guadeloupe,653,194146,2,989,0.50941044368671
2022-09-25,GP,Guadeloupe,563,194709,1,990,0.5084510731399164
2022-10-02,GP,Guadeloupe,505,195214,0,990,0.5071357587058305
2022-10-09,GP,Guadeloupe,379,195593,0,990,0.5061530831880486
2022-10-16,GP,Guadeloupe,361,195954,1,991,0.5057309368525266
2022-10-23,GP,Guadeloupe,316,196270,2,993,0.5059357008202986
2022-10-30,GP,Guadeloupe,0,196270,0,993,0.5059357008202986
2022-11-06,GP,Guadeloupe,455,196725,0,993,0.5047655356462066
2022-11-13,GP,Guadeloupe,380,197105,0,993,0.5037923949164151
2022-11-20,GP,Guadeloupe,389,197494,2,995,0.5038127740589587
2022-11-27,GP,Guadeloupe,0,197494,0,995,0.5038127740589587
2022-12-04,GP,Guadeloupe,824,198318,0,995,0.5017194606641858
2022-12-11,GP,Guadeloupe,290,198608,2,997,0.5019938773866108
2022-12-18,GP,Guadeloupe,716,199324,2,999,0.5011940358411431
2022-12-25,GP,Guadeloupe,664,199988,0,999,0.49952997179830794
2023-01-01,GP,Guadeloupe,545,200533,1,1000,0.49867104167393894
2023-01-08,GP,Guadeloupe,432,200965,3,1003,0.49909188167093776
2023-01-15,GP,Guadeloupe,277,201242,3,1006,0.49989564802576
2023-01-22,GP,Guadeloupe,152,201394,1,1007,0.5000148961736695
2023-01-29,GP,Guadeloupe,169,201563,2,1009,0.500587905518374
2023-02-05,GP,Guadeloupe,141,201704,1,1010,0.5007337484630945
2023-02-12,GP,Guadeloupe,92,201796,0,1010,0.500505460960574
2023-02-19,GP,Guadeloupe,56,201852,0,1010,0.5003666052355191
2023-02-26,GP,Guadeloupe,15,201867,0,1010,0.5003294248193118
2023-03-05,GP,Guadeloupe,19,201886,0,1010,0.5002823375568389
2023-03-12,GP,Guadeloupe,52,201938,0,1010,0.5001535124642217
2023-03-19,GP,Guadeloupe,121,202059,0,1010,0.4998540030387164
2023-03-26,GP,Guadeloupe,104,202163,2,1012,0.5005861606723288
2023-04-02,GP,Guadeloupe,0,202163,0,1012,0.5005861606723288
2023-04-09,GP,Guadeloupe,0,202163,0,1012,0.5005861606723288
2023-04-16,GP,Guadeloupe,201,202364,3,1015,0.5015714257476626
2023-04-23,GP,Guadeloupe,118,202482,2,1017,0.5022668681660591
2023-04-30,GP,Guadeloupe,171,202653,0,1017,0.5018430519163299
2023-05-07,GP,Guadeloupe,0,202653,0,1017,0.5018430519163299
2023-05-14,GP,Guadeloupe,0,202653,0,1017,0.5018430519163299
2023-05-21,GP,Guadeloupe,183,202836,0,1017,0.5013902857480921
2023-05-28,GP,Guadeloupe,0,202836,0,1017,0.5013902857480921
2023-06-04,GP,Guadeloupe,0,202836,0,1017,0.5013902857480921
2023-06-11,GP,Guadeloupe,0,202836,0,1017,0.5013902857480921
2023-06-18,GP,Guadeloupe,0,202836,0,1017,0.5013902857480921
2023-06-25,GP,Guadeloupe,399,203235,4,1021,0.5023740989494919
2023-07-02,GP,Guadeloupe,0,203235,0,1021,0.5023740989494919
2023-07-09,GP,Guadeloupe,0,203235,0,1021,0.5023740989494919
2023-07-16,GP,Guadeloupe,0,203235,0,1021,0.5023740989494919
2023-07-23,GP,Guadeloupe,0,203235,0,1021,0.5023740989494919
2023-07-30,GP,Guadeloupe,0,203235,0,1021,0.5023740989494919
2023-08-06,GP,Guadeloupe,0,203235,0,1021,0.5023740989494919
2023-08-13,GP,Guadeloupe,0,203235,0,1021,0.5023740989494919
2023-08-20,GP,Guadeloupe,0,203235,0,1021,0.5023740989494919
2023-08-27,GP,Guadeloupe,0,203235,0,1021,0.5023740989494919
2023-09-03,GP,Guadeloupe,0,203235,0,1021,0.5023740989494919
2023-09-10,GP,Guadeloupe,0,203235,0,1021,0.5023740989494919
2023-09-17,GP,Guadeloupe,0,203235,0,1021,0.5023740989494919
2023-09-24,GP,Guadeloupe,0,203235,0,1021,0.5023740989494919
2023-10-01,GP,Guadeloupe,0,203235,0,1021,0.5023740989494919
2023-10-08,GP,Guadeloupe,0,203235,0,1021,0.5023740989494919
2023-10-15,GP,Guadeloupe,0,203235,0,1021,0.5023740989494919
2023-10-22,GP,Guadeloupe,0,203235,0,1021,0.5023740989494919
2023-10-29,GP,Guadeloupe,0,203235,0,1021,0.5023740989494919
2023-11-05,GP,Guadeloupe,0,203235,0,1021,0.5023740989494919
2023-11-12,GP,Guadeloupe,0,203235,0,1021,0.5023740989494919
2023-11-19,GP,Guadeloupe,0,203235,0,1021,0.5023740989494919
2023-11-26,GP,Guadeloupe,0,203235,0,1021,0.5023740989494919
2023-12-03,GP,Guadeloupe,0,203235,0,1021,0.5023740989494919
2023-12-10,GP,Guadeloupe,0,203235,0,1021,0.5023740989494919
2023-12-17,GP,Guadeloupe,0,203235,0,1021,0.5023740989494919
2023-12-24,GP,Guadeloupe,0,203235,0,1021,0.5023740989494919
2023-12-31,GP,Guadeloupe,0,203235,0,1021,0.5023740989494919
2024-01-07,GP,Guadeloupe,0,203235,0,1021,0.5023740989494919
2024-01-14,GP,Guadeloupe,0,203235,0,1021,0.5023740989494919
2020-08-16,GU,Guam,104,508,0,5,0.984251968503937
2020-08-23,GU,Guam,304,812,2,7,0.8620689655172413
2020-08-30,GU,Guam,527,1339,3,10,0.7468259895444361
2020-09-06,GU,Guam,332,1671,6,16,0.9575104727707959
2022-02-13,GU,Guam,5903,34140,10,306,0.8963093145869947
2022-02-20,GU,Guam,2078,36218,10,316,0.8724943398310233
2022-02-27,GU,Guam,1082,37300,6,322,0.8632707774798928
2022-03-06,GU,Guam,1062,38362,9,331,0.8628330118346281
2022-03-13,GU,Guam,653,39015,6,337,0.8637703447392028
2022-03-20,GU,Guam,356,39371,3,340,0.8635797922328616
2022-03-27,GU,Guam,273,39644,0,340,0.8576329331046313
2022-04-03,GU,Guam,266,39910,9,349,0.8744675519919819
2022-04-10,GU,Guam,143,40053,3,352,0.87883554290565
2022-04-17,GU,Guam,0,40053,0,352,0.87883554290565
2022-04-24,GU,Guam,318,40371,1,353,0.8743900324490352
2022-05-01,GU,Guam,186,40557,0,353,0.870379959069951
2022-05-08,GU,Guam,166,40723,2,355,0.8717432409203644
2022-05-15,GU,Guam,151,40874,6,361,0.8832020355238048
2022-05-22,GU,Guam,153,41027,0,361,0.8799083530358057
2022-05-29,GU,Guam,240,41267,2,363,0.8796374827343881
2022-06-05,GU,Guam,283,41550,2,365,0.878459687123947
2022-06-12,GU,Guam,479,42029,4,369,0.8779652144947535
2022-06-19,GU,Guam,534,42563,2,371,0.8716490848859337
2022-06-26,GU,Guam,510,43073,0,371,0.8613284424117197
2022-07-03,GU,Guam,656,43729,0,371,0.848407235473027
2022-07-10,GU,Guam,603,44332,2,373,0.8413786880808445
2022-07-17,GU,Guam,582,44914,3,376,0.8371554526428284
2022-07-24,GU,Guam,448,45362,1,377,0.8310921035227724
2022-07-31,GU,Guam,819,46181,3,380,0.8228492237067193
2022-08-07,GU,Guam,618,46799,3,383,0.8183935554178509
2022-08-14,GU,Guam,572,47371,3,386,0.8148445251314095
2022-08-21,GU,Guam,448,47819,3,389,0.8134841799284803
2022-08-28,GU,Guam,367,48186,0,389,0.8072884240235754
2022-09-04,GU,Guam,202,48388,1,390,0.8059849549475075
2022-09-11,GU,Guam,236,48624,4,394,0.8102994406054622
2022-09-18,GU,Guam,218,48842,7,401,0.8210147004627166
2022-09-25,GU,Guam,28,48870,0,401,0.8205443012072846
2022-10-02,GU,Guam,85,48955,0,401,0.8191195996323154
2022-10-09,GU,Guam,54,49009,0,401,0.8182170621722541
2022-10-16,GU,Guam,0,49009,0,401,0.8182170621722541
2022-10-23,GU,Guam,8,49017,0,401,0.8180835220433728
2022-10-30,GU,Guam,110,49127,2,403,0.8203228367292934
2022-11-06,GU,Guam,47,49174,1,404,0.8215723756456664
2022-11-13,GU,Guam,61,49235,2,406,0.824616634507972
2022-11-20,GU,Guam,128,49363,1,407,0.8245041832951806
2022-11-27,GU,Guam,214,49577,2,409,0.8249793250902635
2022-12-04,GU,Guam,0,49577,1,410,0.8269963894547875
2022-12-11,GU,Guam,123,49700,0,410,0.8249496981891348
2022-12-18,GU,Guam,107,49807,1,411,0.8251852149296284
2022-12-25,GU,Guam,131,49938,0,411,0.8230205454763908
2023-01-01,GU,Guam,64,50002,0,411,0.8219671213151474
2023-01-08,GU,Guam,0,50002,0,411,0.8219671213151474
2023-01-15,GU,Guam,403,50405,0,411,0.8153952980855074
2023-01-22,GU,Guam,37,50442,0,411,0.8147971928155109
2023-01-29,GU,Guam,193,50635,0,411,0.8116915177248938
2023-02-05,GU,Guam,90,50725,2,413,0.8141941843272549
2023-02-12,GU,Guam,59,50784,0,413,0.8132482671707625
2023-02-19,GU,Guam,33,50817,0,413,0.8127201527048035
2023-02-26,GU,Guam,23,50840,0,413,0.8123524783634933
2023-03-05,GU,Guam,29,50869,0,413,0.8118893628732627
2023-03-12,GU,Guam,45,50914,0,413,0.8111717798640845
2023-03-19,GU,Guam,41,50955,0,413,0.8105190854675695
2023-03-26,GU,Guam,19,50974,0,413,0.8102169733589673
2023-04-02,GU,Guam,31,51005,0,413,0.8097245368101167
2023-04-09,GU,Guam,12,51017,0,413,0.8095340768763353
2023-04-16,GU,Guam,45,51062,0,413,0.8088206494066037
2023-04-23,GU,Guam,48,51110,0,413,0.8080610448053218
2023-04-30,GU,Guam,69,51179,0,413,0.8069716094491881
2023-05-07,GU,Guam,61,51240,0,413,0.8060109289617485
2023-05-14,GU,Guam,105,51345,0,413,0.8043626448534424
2023-05-21,GU,Guam,95,51440,0,413,0.8028771384136858
2023-05-28,GU,Guam,0,51440,0,413,0.8028771384136858
2023-06-04,GU,Guam,53,51493,0,413,0.8020507641815392
2023-06-11,GU,Guam,24,51517,0,413,0.8016771162917096
2023-06-18,GU,Guam,32,51549,0,413,0.8011794603193078
2023-06-25,GU,Guam,74,51623,0,413,0.8000309939368112
2023-07-02,GU,Guam,52,51675,0,413,0.799225931301403
2023-07-09,GU,Guam,56,51731,2,415,0.8022269045639945
2023-07-16,GU,Guam,7,51738,0,415,0.8021183656113494
2023-07-23,GU,Guam,31,51769,0,415,0.8016380459348259
2023-07-30,GU,Guam,17,51786,0,415,0.8013748889661299
2023-08-06,GU,Guam,0,51786,0,415,0.8013748889661299
2023-08-13,GU,Guam,42,51828,1,416,0.8026549355560701
2023-08-20,GU,Guam,17,51845,0,416,0.8023917446233967
2023-08-27,GU,Guam,0,51845,0,416,0.8023917446233967
2023-09-03,GU,Guam,88,51933,0,416,0.8010320990506999
2023-09-10,GU,Guam,26,51959,0,416,0.800631266960488
2023-09-17,GU,Guam,0,51959,0,416,0.800631266960488
2023-09-24,GU,Guam,41,52000,0,416,0.8
2023-10-01,GU,Guam,17,52017,0,416,0.7997385470134764
2023-10-08,GU,Guam,15,52032,1,417,0.801429889298893
2023-10-15,GU,Guam,0,52032,0,417,0.801429889298893
2023-10-22,GU,Guam,18,52050,0,417,0.8011527377521613
2023-10-29,GU,Guam,10,52060,0,417,0.8009988474836727
2023-11-05,GU,Guam,15,52075,0,417,0.800768122899664
2023-11-12,GU,Guam,4,52079,0,417,0.8007066187906834
2023-11-19,GU,Guam,102,52181,0,417,0.799141449953048
2023-11-26,GU,Guam,6,52187,0,417,0.7990495717324239
2023-12-03,GU,Guam,0,52187,0,417,0.7990495717324239
2023-12-10,GU,Guam,0,52187,0,417,0.7990495717324239
2023-12-17,GU,Guam,0,52187,0,417,0.7990495717324239
2023-12-24,GU,Guam,60,52247,2,419,0.8019599211437977
2023-12-31,GU,Guam,40,52287,0,419,0.8013464149788667
2024-01-07,GU,Guam,0,52287,0,419,0.8013464149788667
2024-01-14,GU,Guam,0,52287,0,419,0.8013464149788667
2021-11-07,GG,Guernsey,203,2337,0,23,0.9841677364142062
2021-11-14,GG,Guernsey,341,2678,0,23,0.8588498879761016
2021-11-21,GG,Guernsey,423,3101,0,23,0.7416962270235408
2021-11-28,GG,Guernsey,646,3747,0,23,0.6138243928476115
2021-12-05,GG,Guernsey,777,4524,0,23,0.5083996463306808
2021-12-12,GG,Guernsey,560,5084,0,23,0.45239968528717545
2021-12-19,GG,Guernsey,578,5662,0,23,0.40621688449311194
2021-12-26,GG,Guernsey,984,6646,0,23,0.34607282575985554
2022-01-02,GG,Guernsey,1683,8329,1,24,0.28814983791571613
2022-01-09,GG,Guernsey,1363,9692,4,28,0.2888980602558811
2022-01-16,GG,Guernsey,679,10371,2,30,0.2892681515765114
2022-01-23,GG,Guernsey,318,10689,0,30,0.280662363177098
2022-01-30,GG,Guernsey,447,11136,0,30,0.26939655172413796
2022-02-06,GG,Guernsey,641,11777,1,31,0.2632249299482041
2022-02-13,GG,Guernsey,757,12534,0,31,0.2473272698260731
2022-02-20,GG,Guernsey,686,13220,3,34,0.25718608169440244
2022-02-27,GG,Guernsey,508,13728,1,35,0.25495337995337997
2022-03-06,GG,Guernsey,931,14659,0,35,0.23876117061191077
2022-03-13,GG,Guernsey,1196,15855,0,35,0.22075055187637968
2022-03-20,GG,Guernsey,2077,17932,1,36,0.20075842070042382
2022-03-27,GG,Guernsey,2936,20868,0,36,0.17251293847038526
2022-04-03,GG,Guernsey,1389,22257,0,36,0.16174686615446826
2022-04-10,GG,Guernsey,767,23024,3,39,0.16938846421125783
2022-04-17,GG,Guernsey,660,23684,0,39,0.16466813038338118
2022-04-24,GG,Guernsey,517,24201,0,39,0.1611503656873683
2022-05-01,GG,Guernsey,372,24573,0,39,0.15871078012452694
2022-05-08,GG,Guernsey,259,24832,2,41,0.16510953608247422
2022-05-15,GG,Guernsey,283,25115,1,42,0.16723073860242882
2022-05-22,GG,Guernsey,258,25373,1,43,0.16947148543727586
2022-05-29,GG,Guernsey,251,25624,0,43,0.16781142678738684
2022-06-05,GG,Guernsey,124,25748,0,43,0.1670032623893118
2022-06-12,GG,Guernsey,171,25919,0,43,0.1659014622477719
2022-06-19,GG,Guernsey,257,26176,0,43,0.16427261613691932
2022-06-26,GG,Guernsey,365,26541,0,43,0.16201348856486192
2022-07-03,GG,Guernsey,560,27101,1,44,0.16235563263348216
2022-07-10,GG,Guernsey,997,28098,1,45,0.1601537475976938
2022-07-17,GG,Guernsey,947,29045,1,46,0.15837493544499914
2022-07-24,GG,Guernsey,556,29601,4,50,0.16891321239147325
2022-07-31,GG,Guernsey,323,29924,0,50,0.16708996123512898
2022-08-07,GG,Guernsey,274,30198,3,53,0.17550831180872906
2022-08-14,GG,Guernsey,167,30365,2,55,0.18112958998847356
2022-08-21,GG,Guernsey,154,30519,0,55,0.18021560339460663
2022-08-28,GG,Guernsey,132,30651,0,55,0.17943949626439595
2022-09-04,GG,Guernsey,116,30767,0,55,0.1787629603146228
2022-09-11,GG,Guernsey,116,30883,0,55,0.1780915066541463
2022-09-18,GG,Guernsey,109,30992,0,55,0.17746515229736706
2022-09-25,GG,Guernsey,107,31099,0,55,0.17685456123991125
2022-10-02,GG,Guernsey,210,31309,1,56,0.1788623079625667
2022-10-09,GG,Guernsey,236,31545,0,56,0.17752417181803773
2022-10-16,GG,Guernsey,291,31836,0,56,0.1759014951627089
2022-10-23,GG,Guernsey,282,32118,0,56,0.17435705834734416
2022-10-30,GG,Guernsey,206,32324,1,57,0.17633956193540404
2022-11-06,GG,Guernsey,142,32466,0,57,0.17556828682313808
2022-11-13,GG,Guernsey,96,32562,1,58,0.17812173699404213
2022-11-20,GG,Guernsey,104,32666,0,58,0.17755464397232595
2022-11-27,GG,Guernsey,100,32766,0,58,0.17701275712628944
2022-12-04,GG,Guernsey,134,32900,0,58,0.1762917933130699
2022-12-11,GG,Guernsey,180,33080,1,59,0.17835550181378476
2022-12-18,GG,Guernsey,369,33449,0,59,0.17638793386947293
2022-12-25,GG,Guernsey,345,33794,1,60,0.17754630999585727
2023-01-01,GG,Guernsey,323,34117,1,61,0.1787964944162734
2023-01-08,GG,Guernsey,280,34397,1,62,0.1802482774660581
2023-01-15,GG,Guernsey,167,34564,0,62,0.1793773868765189
2023-01-22,GG,Guernsey,108,34672,4,66,0.1903553299492386
2023-01-29,GG,Guernsey,43,34715,0,66,0.19011954486533197
2023-02-05,GG,Guernsey,54,34769,0,66,0.18982426874514655
2023-02-12,GG,Guernsey,45,34814,0,66,0.18957890503820302
2023-02-19,GG,Guernsey,53,34867,0,66,0.1892907333581897
2023-02-26,GG,Guernsey,62,34929,0,66,0.1889547367516963
2023-03-05,GG,Guernsey,62,34991,0,66,0.1886199308393587
2023-03-12,GG,Guernsey,67,35058,0,66,0.1882594557590279
2023-03-19,GG,Guernsey,81,35139,1,67,0.19067133384558468
2023-03-26,GG,Guernsey,96,35235,0,67,0.1901518376614162
2023-04-02,GG,Guernsey,0,35235,0,67,0.1901518376614162
2023-04-09,GG,Guernsey,0,35235,0,67,0.1901518376614162
2023-04-16,GG,Guernsey,91,35326,0,67,0.18966200532185926
2023-04-23,GG,Guernsey,0,35326,0,67,0.18966200532185926
2023-04-30,GG,Guernsey,0,35326,0,67,0.18966200532185926
2023-05-07,GG,Guernsey,0,35326,0,67,0.18966200532185926
2023-05-14,GG,Guernsey,0,35326,0,67,0.18966200532185926
2023-05-21,GG,Guernsey,0,35326,0,67,0.18966200532185926
2023-05-28,GG,Guernsey,0,35326,0,67,0.18966200532185926
2023-06-04,GG,Guernsey,0,35326,0,67,0.18966200532185926
2023-06-11,GG,Guernsey,0,35326,0,67,0.18966200532185926
2023-06-18,GG,Guernsey,0,35326,0,67,0.18966200532185926
2023-06-25,GG,Guernsey,0,35326,0,67,0.18966200532185926
2023-07-02,GG,Guernsey,0,35326,0,67,0.18966200532185926
2023-07-09,GG,Guernsey,0,35326,0,67,0.18966200532185926
2023-07-16,GG,Guernsey,0,35326,0,67,0.18966200532185926
2023-07-23,GG,Guernsey,0,35326,0,67,0.18966200532185926
2023-07-30,GG,Guernsey,0,35326,0,67,0.18966200532185926
2023-08-06,GG,Guernsey,0,35326,0,67,0.18966200532185926
2023-08-13,GG,Guernsey,0,35326,0,67,0.18966200532185926
2023-08-20,GG,Guernsey,0,35326,0,67,0.18966200532185926
2023-08-27,GG,Guernsey,0,35326,0,67,0.18966200532185926
2023-09-03,GG,Guernsey,0,35326,0,67,0.18966200532185926
2023-09-10,GG,Guernsey,0,35326,0,67,0.18966200532185926
2023-09-17,GG,Guernsey,0,35326,0,67,0.18966200532185926
2023-09-24,GG,Guernsey,0,35326,0,67,0.18966200532185926
2023-10-01,GG,Guernsey,0,35326,0,67,0.18966200532185926
2023-10-08,GG,Guernsey,0,35326,0,67,0.18966200532185926
2023-10-15,GG,Guernsey,0,35326,0,67,0.18966200532185926
2023-10-22,GG,Guernsey,0,35326,0,67,0.18966200532185926
2023-10-29,GG,Guernsey,0,35326,0,67,0.18966200532185926
2023-11-05,GG,Guernsey,0,35326,0,67,0.18966200532185926
2023-11-12,GG,Guernsey,0,35326,0,67,0.18966200532185926
2023-11-19,GG,Guernsey,0,35326,0,67,0.18966200532185926
2023-11-26,GG,Guernsey,0,35326,0,67,0.18966200532185926
2023-12-03,GG,Guernsey,0,35326,0,67,0.18966200532185926
2023-12-10,GG,Guernsey,0,35326,0,67,0.18966200532185926
2023-12-17,GG,Guernsey,0,35326,0,67,0.18966200532185926
2023-12-24,GG,Guernsey,0,35326,0,67,0.18966200532185926
2023-12-31,GG,Guernsey,0,35326,0,67,0.18966200532185926
2024-01-07,GG,Guernsey,0,35326,0,67,0.18966200532185926
2024-01-14,GG,Guernsey,0,35326,0,67,0.18966200532185926
2020-04-19,GN,Guinea,227,477,4,4,0.8385744234800839
2020-04-26,GN,Guinea,617,1094,4,8,0.7312614259597806
2020-05-03,GN,Guinea,492,1586,0,8,0.5044136191677175
2020-05-10,GN,Guinea,456,2042,4,12,0.5876591576885406
2020-05-17,GN,Guinea,621,2663,4,16,0.6008261359369133
2020-05-24,GN,Guinea,513,3176,4,20,0.6297229219143577
2020-05-31,GN,Guinea,530,3706,3,23,0.62061521856449
2020-06-07,GN,Guinea,411,4117,0,23,0.5586592178770949
2020-06-14,GN,Guinea,367,4484,2,25,0.5575379125780553
2020-06-21,GN,Guinea,476,4960,2,27,0.5443548387096774
2020-06-28,GN,Guinea,331,5291,3,30,0.567000567000567
2020-07-05,GN,Guinea,279,5570,4,34,0.6104129263913823
2020-07-12,GN,Guinea,571,6141,3,37,0.6025077348965967
2020-07-19,GN,Guinea,350,6491,2,39,0.6008319211215529
2020-07-26,GN,Guinea,436,6927,3,42,0.606323083585968
2020-08-02,GN,Guinea,381,7308,4,46,0.629447181171319
2020-08-09,GN,Guinea,567,7875,4,50,0.6349206349206349
2020-08-16,GN,Guinea,468,8343,0,50,0.5993048064245475
2020-08-23,GN,Guinea,624,8967,3,53,0.5910560945689751
2020-08-30,GN,Guinea,284,9251,6,59,0.637768889849746
2020-09-06,GN,Guinea,471,9722,2,61,0.6274429129808681
2020-09-13,GN,Guinea,298,10020,2,63,0.6287425149700598
2020-09-20,GN,Guinea,266,10286,0,63,0.612482986583706
2020-09-27,GN,Guinea,262,10548,3,66,0.6257110352673493
2020-10-04,GN,Guinea,206,10754,0,66,0.6137251255346847
2020-10-11,GN,Guinea,268,11022,3,69,0.6260206859009254
2020-10-18,GN,Guinea,456,11478,1,70,0.6098623453563339
2020-10-25,GN,Guinea,191,11669,1,71,0.6084497386237039
2020-11-01,GN,Guinea,403,12072,1,72,0.5964214711729622
2020-11-08,GN,Guinea,342,12414,2,74,0.5961011760915096
2020-11-15,GN,Guinea,197,12611,1,75,0.5947188962017286
2020-11-22,GN,Guinea,215,12826,0,75,0.584749727116794
2020-11-29,GN,Guinea,213,13039,1,76,0.5828667842625969
2020-12-06,GN,Guinea,194,13233,0,76,0.5743217713292526
2020-12-13,GN,Guinea,187,13420,3,79,0.5886736214605067
2020-12-20,GN,Guinea,125,13545,1,80,0.5906238464377999
2020-12-27,GN,Guinea,129,13674,0,80,0.585051923358198
2021-01-03,GN,Guinea,110,13784,1,81,0.5876378409750436
2021-01-10,GN,Guinea,158,13942,0,81,0.5809783388323052
2021-01-17,GN,Guinea,172,14114,0,81,0.5738982570497378
2021-01-24,GN,Guinea,205,14319,0,81,0.5656819610307983
2021-01-31,GN,Guinea,213,14532,1,82,0.5642719515551885
2021-02-07,GN,Guinea,155,14687,2,84,0.5719343637230203
2021-02-14,GN,Guinea,259,14946,0,84,0.5620232838217584
2021-02-21,GN,Guinea,449,15395,2,86,0.5586229295225723
2021-02-28,GN,Guinea,597,15992,3,89,0.556528264132066
2021-03-07,GN,Guinea,833,16825,2,91,0.5408618127786033
2021-03-14,GN,Guinea,767,17592,9,100,0.5684402000909504
2021-03-21,GN,Guinea,1125,18717,10,110,0.5877010204626809
2021-03-28,GN,Guinea,953,19670,10,120,0.6100660904931368
2021-04-04,GN,Guinea,735,20405,10,130,0.6370987503062975
2021-04-11,GN,Guinea,544,20949,4,134,0.6396486705809347
2021-04-18,GN,Guinea,511,21460,4,138,0.6430568499534017
2021-04-25,GN,Guinea,493,21953,2,140,0.6377260511091878
2021-05-02,GN,Guinea,351,22304,5,145,0.6501076040172167
2021-05-09,GN,Guinea,329,22633,5,150,0.6627490831971016
2021-05-16,GN,Guinea,113,22746,1,151,0.6638529851402444
2021-05-23,GN,Guinea,242,22988,7,158,0.6873151209326606
2021-05-30,GN,Guinea,184,23172,3,161,0.6948040738822717
2021-06-06,GN,Guinea,83,23255,1,162,0.6966243818533648
2021-06-13,GN,Guinea,134,23389,5,167,0.7140108598058916
2021-06-20,GN,Guinea,61,23450,0,167,0.7121535181236675
2021-06-27,GN,Guinea,242,23692,1,168,0.7091001181833531
2021-07-04,GN,Guinea,179,23871,5,173,0.7247287503665535
2021-07-11,GN,Guinea,263,24134,6,179,0.7416922184470042
2021-07-18,GN,Guinea,577,24711,11,190,0.7688883493181174
2021-07-25,GN,Guinea,282,24993,8,198,0.7922218221101909
2021-08-01,GN,Guinea,921,25914,34,232,0.8952689665817705
2021-08-08,GN,Guinea,1055,26969,28,260,0.9640698579850939
2020-05-03,GW,Guinea-Bissau,208,260,2,2,0.7692307692307693
2020-05-10,GW,Guinea-Bissau,382,642,1,3,0.46728971962616817
2020-05-17,GW,Guinea-Bissau,271,913,0,3,0.32858707557502737
2020-05-24,GW,Guinea-Bissau,201,1114,3,6,0.5385996409335727
2020-05-31,GW,Guinea-Bissau,142,1256,2,8,0.6369426751592357
2020-06-07,GW,Guinea-Bissau,112,1368,4,12,0.8771929824561403
2020-03-22,IS,Iceland,461,653,1,1,0.1531393568147014
2020-03-29,IS,Iceland,509,1162,1,2,0.17211703958691912
2020-04-05,IS,Iceland,440,1602,4,6,0.37453183520599254
2020-04-12,IS,Iceland,135,1737,2,8,0.4605641911341394
2020-04-19,IS,Iceland,53,1790,1,9,0.5027932960893855
2020-04-26,IS,Iceland,16,1806,1,10,0.5537098560354374
2020-05-03,IS,Iceland,7,1813,0,10,0.5515719801434087
2020-05-10,IS,Iceland,2,1815,0,10,0.5509641873278237
2020-05-17,IS,Iceland,1,1816,0,10,0.5506607929515419
2020-05-24,IS,Iceland,2,1818,0,10,0.5500550055005501
2020-05-31,IS,Iceland,2,1820,0,10,0.5494505494505495
2020-06-07,IS,Iceland,1,1821,0,10,0.5491488193300385
2020-06-14,IS,Iceland,2,1823,0,10,0.5485463521667581
2020-06-21,IS,Iceland,5,1828,0,10,0.5470459518599562
2020-06-28,IS,Iceland,6,1834,0,10,0.5452562704471101
2020-07-05,IS,Iceland,9,1843,0,10,0.5425935973955507
2020-07-12,IS,Iceland,3,1846,0,10,0.5417118093174431
2020-07-19,IS,Iceland,6,1852,0,10,0.5399568034557235
2020-07-26,IS,Iceland,16,1868,0,10,0.5353319057815845
2020-08-02,IS,Iceland,59,1927,0,10,0.5189413596263622
2020-08-09,IS,Iceland,47,1974,0,10,0.5065856129685917
2020-08-16,IS,Iceland,54,2028,0,10,0.4930966469428008
2020-08-23,IS,Iceland,55,2083,0,10,0.4800768122899664
2020-08-30,IS,Iceland,41,2124,0,10,0.4708097928436911
2020-09-06,IS,Iceland,32,2156,0,10,0.463821892393321
2020-09-13,IS,Iceland,25,2181,0,10,0.4585052728106373
2020-09-20,IS,Iceland,212,2393,0,10,0.41788549937317176
2020-09-27,IS,Iceland,280,2673,0,10,0.3741114852225963
2020-10-04,IS,Iceland,321,2994,0,10,0.33400133600534404
2020-10-11,IS,Iceland,603,3597,1,11,0.3058103975535168
2020-10-18,IS,Iceland,532,4129,1,12,0.290627270525551
2020-10-25,IS,Iceland,397,4526,0,12,0.26513477684489617
2020-11-01,IS,Iceland,408,4934,5,17,0.3445480340494528
2020-11-08,IS,Iceland,174,5108,7,24,0.4698512137823023
2020-11-15,IS,Iceland,108,5216,1,25,0.47929447852760737
2020-11-22,IS,Iceland,80,5296,1,26,0.49093655589123864
2020-11-29,IS,Iceland,107,5403,0,26,0.48121414029243015
2020-12-06,IS,Iceland,105,5508,1,27,0.49019607843137253
2020-12-13,IS,Iceland,64,5572,1,28,0.5025125628140703
2020-12-20,IS,Iceland,89,5661,0,28,0.4946122593181417
2020-12-27,IS,Iceland,82,5743,0,28,0.48755006094375763
2021-01-03,IS,Iceland,73,5816,1,29,0.498624484181568
2021-01-10,IS,Iceland,102,5918,0,29,0.4900304156809733
2021-01-17,IS,Iceland,70,5988,0,29,0.48430193720774883
2021-01-24,IS,Iceland,19,6007,0,29,0.4827701015481938
2021-01-31,IS,Iceland,22,6029,0,29,0.48100845911428103
2021-02-07,IS,Iceland,12,6041,0,29,0.4800529713623572
2021-02-14,IS,Iceland,15,6056,0,29,0.47886393659180976
2021-02-21,IS,Iceland,10,6066,0,29,0.4780745136828223
2021-02-28,IS,Iceland,10,6076,0,29,0.47728768926925613
2021-03-07,IS,Iceland,11,6087,0,29,0.4764251683916544
2021-03-14,IS,Iceland,19,6106,0,29,0.4749426793318048
2021-03-21,IS,Iceland,38,6144,0,29,0.4720052083333333
2021-03-28,IS,Iceland,61,6205,0,29,0.4673650282030621
2021-04-04,IS,Iceland,50,6255,0,29,0.46362909672262187
2021-04-11,IS,Iceland,34,6289,0,29,0.46112259500715536
2021-04-18,IS,Iceland,62,6351,0,29,0.45662100456621
2021-04-25,IS,Iceland,65,6416,0,29,0.45199501246882795
2021-05-02,IS,Iceland,54,6470,0,29,0.4482225656877898
2021-05-09,IS,Iceland,35,6505,0,29,0.4458109146810146
2021-05-16,IS,Iceland,30,6535,0,29,0.4437643458301454
2021-05-23,IS,Iceland,7,6542,1,30,0.45857535921736475
2021-05-30,IS,Iceland,30,6572,0,30,0.4564820450395618
2021-06-06,IS,Iceland,28,6600,0,30,0.45454545454545453
2021-06-13,IS,Iceland,11,6611,0,30,0.4537891393132658
2021-06-20,IS,Iceland,10,6621,0,30,0.4531037607612143
2021-06-27,IS,Iceland,17,6638,0,30,0.4519433564326604
2021-07-04,IS,Iceland,16,6654,0,30,0.4508566275924256
2021-07-11,IS,Iceland,25,6679,0,30,0.44916903728103014
2021-07-18,IS,Iceland,99,6778,0,30,0.4426084390675715
2021-07-25,IS,Iceland,519,7297,0,30,0.4111278607646978
2021-08-01,IS,Iceland,815,8112,0,30,0.3698224852071006
2021-08-08,IS,Iceland,776,8888,0,30,0.33753375337533753
2021-08-15,IS,Iceland,680,9568,0,30,0.31354515050167225
2021-08-22,IS,Iceland,605,10173,0,30,0.29489826010026543
2021-08-29,IS,Iceland,525,10698,3,33,0.3084688726864835
2021-09-05,IS,Iceland,355,11053,0,33,0.29856147652221116
2021-09-12,IS,Iceland,219,11272,0,33,0.2927608232789212
2021-09-19,IS,Iceland,189,11461,0,33,0.2879329901404764
2021-09-26,IS,Iceland,251,11712,0,33,0.2817622950819672
2021-10-03,IS,Iceland,235,11947,0,33,0.2762199715409726
2021-10-10,IS,Iceland,285,12232,0,33,0.2697841726618705
2021-10-17,IS,Iceland,373,12605,0,33,0.2618008726695755
2021-10-24,IS,Iceland,525,13130,0,33,0.25133282559025133
2021-10-31,IS,Iceland,601,13731,1,34,0.24761488602432452
2021-11-07,IS,Iceland,827,14558,0,34,0.2335485643632367
2021-11-14,IS,Iceland,1175,15733,0,34,0.21610627343799657
2021-11-21,IS,Iceland,1058,16791,0,34,0.20248942886069918
2021-11-28,IS,Iceland,975,17766,1,35,0.1970055161544523
2021-12-05,IS,Iceland,868,18634,0,35,0.18782870022539444
2021-12-12,IS,Iceland,901,19535,1,36,0.18428461735346813
2021-12-19,IS,Iceland,1352,20887,1,37,0.17714367788576627
2021-12-26,IS,Iceland,3319,24206,0,37,0.1528546641328596
2022-01-02,IS,Iceland,6853,31059,1,38,0.12234778969058888
2022-01-09,IS,Iceland,8921,39980,3,41,0.10255127563781892
2022-01-16,IS,Iceland,131,40111,0,41,0.10221634962977737
2022-01-23,IS,Iceland,9874,49985,0,41,0.08202460738221466
2022-01-30,IS,Iceland,9188,59173,2,43,0.07266827776181704
2022-02-06,IS,Iceland,10475,69648,3,46,0.0660464047783138
2022-02-13,IS,Iceland,13792,83440,5,51,0.06112176414189838
2022-02-20,IS,Iceland,17366,100806,5,56,0.055552248874074964
2022-02-27,IS,Iceland,13322,114128,3,59,0.051696340950511704
2022-03-06,IS,Iceland,16895,131023,8,67,0.05113606008105447
2022-03-13,IS,Iceland,19640,150663,6,73,0.048452506587549696
2022-03-20,IS,Iceland,13313,163976,10,83,0.050617163487339606
2022-03-27,IS,Iceland,7342,171318,4,87,0.05078275487689559
2022-04-03,IS,Iceland,3024,174342,8,95,0.05449059893772011
2022-04-10,IS,Iceland,1622,175964,9,104,0.05910299834056966
2022-04-17,IS,Iceland,875,176839,1,105,0.05937604261503401
2022-04-24,IS,Iceland,866,177705,5,110,0.06190034045187248
2022-05-01,IS,Iceland,551,178256,0,110,0.06170900278251503
2022-05-08,IS,Iceland,451,178707,1,111,0.06211284392888919
2022-05-15,IS,Iceland,778,179485,0,111,0.061843608100955516
2022-05-22,IS,Iceland,863,180348,0,111,0.06154767449597445
2022-05-29,IS,Iceland,809,181157,0,111,0.06127281860485657
2022-06-05,IS,Iceland,1159,182316,0,111,0.06088330152043705
2022-06-12,IS,Iceland,1412,183728,0,111,0.0604153966733432
2022-06-19,IS,Iceland,1535,185263,2,113,0.0609943701656564
2022-06-26,IS,Iceland,2409,187672,2,115,0.06127712178694744
2022-07-03,IS,Iceland,3196,190868,2,117,0.06129890814594379
2022-07-10,IS,Iceland,3196,194064,0,117,0.060289389067524124
2022-07-17,IS,Iceland,2338,196402,0,117,0.05957169478925877
2022-07-24,IS,Iceland,1695,198097,0,117,0.05906197468916743
2022-07-31,IS,Iceland,1337,199434,0,117,0.058666024850326425
2022-08-07,IS,Iceland,803,200237,0,117,0.05843075954993333
2022-08-14,IS,Iceland,860,201097,0,117,0.058180877884801856
2022-08-21,IS,Iceland,717,201814,0,117,0.05797417423964641
2022-08-28,IS,Iceland,547,202361,0,117,0.0578174648277089
2022-09-04,IS,Iceland,424,202785,0,117,0.057696575190472665
2022-09-11,IS,Iceland,357,203142,0,117,0.057595179726496734
2022-09-18,IS,Iceland,250,203392,0,117,0.057524386406544996
2022-09-25,IS,Iceland,239,203631,0,117,0.05745687051578591
2022-10-02,IS,Iceland,240,203871,0,117,0.05738923142575452
2022-10-09,IS,Iceland,188,204059,0,117,0.057336358602168985
2022-10-16,IS,Iceland,217,204276,0,117,0.05727545086060036
2022-10-23,IS,Iceland,324,204600,0,117,0.05718475073313783
2022-10-30,IS,Iceland,295,204895,0,117,0.05710241831181825
2022-11-06,IS,Iceland,305,205200,0,117,0.05701754385964912
2022-11-13,IS,Iceland,310,205510,69,186,0.09050654469368886
2022-11-20,IS,Iceland,276,205786,0,186,0.09038515739651871
2022-11-27,IS,Iceland,274,206060,0,186,0.09026497136756284
2022-12-04,IS,Iceland,207,206267,0,186,0.09017438562639686
2022-12-11,IS,Iceland,207,206474,0,186,0.09008398151825411
2022-12-18,IS,Iceland,384,206858,0,186,0.08991675448858637
2022-12-25,IS,Iceland,355,207213,0,186,0.08976270793820851
2023-01-01,IS,Iceland,223,207436,0,186,0.0896662103010085
2023-01-08,IS,Iceland,192,207628,0,186,0.08958329319744929
2023-01-15,IS,Iceland,0,207628,0,186,0.08958329319744929
2023-01-22,IS,Iceland,76,207704,0,186,0.08955051419327505
2023-01-29,IS,Iceland,105,207809,0,186,0.08950526685562224
2023-02-05,IS,Iceland,190,207999,0,186,0.0894235068437829
2023-02-12,IS,Iceland,115,208114,0,186,0.08937409304515795
2023-02-19,IS,Iceland,101,208215,0,186,0.08933073986024062
2023-02-26,IS,Iceland,117,208332,0,186,0.08928057139565693
2023-03-05,IS,Iceland,75,208407,0,186,0.08924844175099685
2023-03-12,IS,Iceland,32,208439,0,186,0.0892347401398011
2023-03-19,IS,Iceland,44,208483,0,186,0.08921590729220129
2023-03-26,IS,Iceland,28,208511,0,186,0.08920392689114723
2023-04-02,IS,Iceland,37,208548,0,186,0.08918810058116117
2023-04-09,IS,Iceland,28,208576,0,186,0.08917612764651733
2023-04-16,IS,Iceland,16,208592,0,186,0.08916928741274834
2023-04-23,IS,Iceland,8,208600,0,186,0.08916586768935762
2023-04-30,IS,Iceland,10,208610,0,186,0.08916159340395954
2023-05-07,IS,Iceland,10,208620,0,186,0.08915731952832902
2023-05-14,IS,Iceland,10,208630,0,186,0.08915304606240713
2023-05-21,IS,Iceland,16,208646,0,186,0.08914620936897905
2023-05-28,IS,Iceland,19,208665,0,186,0.0891380921572856
2023-06-04,IS,Iceland,23,208688,0,186,0.08912826803649468
2023-06-11,IS,Iceland,19,208707,0,186,0.08912015409162126
2023-06-18,IS,Iceland,21,208728,0,186,0.08911118776589629
2023-06-25,IS,Iceland,7,208735,0,186,0.08910819939157305
2023-07-02,IS,Iceland,8,208743,0,186,0.08910478435205012
2023-07-09,IS,Iceland,8,208751,0,186,0.08910136957427749
2023-07-16,IS,Iceland,6,208757,0,186,0.08909880866270353
2023-07-23,IS,Iceland,35,208792,0,186,0.08908387294532358
2023-07-30,IS,Iceland,22,208814,0,186,0.0890744873428027
2023-08-06,IS,Iceland,31,208845,0,186,0.08906126553185377
2023-08-13,IS,Iceland,38,208883,0,186,0.08904506350444986
2023-08-20,IS,Iceland,32,208915,0,186,0.08903142426345642
2023-08-27,IS,Iceland,42,208957,0,186,0.08901352909928836
2023-09-03,IS,Iceland,41,208998,0,186,0.08899606694800907
2023-09-10,IS,Iceland,44,209042,0,186,0.08897733469829029
2023-09-17,IS,Iceland,43,209085,0,186,0.0889590357988378
2023-09-24,IS,Iceland,57,209142,0,186,0.0889347907163554
2023-10-01,IS,Iceland,54,209196,0,186,0.08891183387827682
2023-10-08,IS,Iceland,47,209243,0,186,0.08889186257126881
2023-10-15,IS,Iceland,43,209286,0,186,0.08887359880737364
2023-10-22,IS,Iceland,42,209328,0,186,0.0888557670259115
2023-10-29,IS,Iceland,0,209328,0,186,0.0888557670259115
2023-11-05,IS,Iceland,42,209370,0,186,0.08883794239862444
2023-11-12,IS,Iceland,43,209413,0,186,0.08881970078266392
2023-11-19,IS,Iceland,62,209475,0,186,0.08879341210168278
2023-11-26,IS,Iceland,59,209534,0,186,0.08876840990006395
2023-12-03,IS,Iceland,52,209586,0,186,0.08874638573187141
2023-12-10,IS,Iceland,64,209650,0,186,0.08871929406153112
2023-12-17,IS,Iceland,56,209706,0,186,0.08869560241480931
2023-12-24,IS,Iceland,48,209754,0,186,0.08867530535770474
2023-12-31,IS,Iceland,37,209791,0,186,0.08865966604859121
2024-01-07,IS,Iceland,41,209832,0,186,0.08864234244538488
2024-01-14,IS,Iceland,0,209832,0,186,0.08864234244538488
2020-03-22,IE,Ireland,593,683,3,5,0.7320644216691069
2021-12-12,IE,Ireland,31480,619488,56,5931,0.9574035332403533
2021-12-19,IE,Ireland,29191,648679,70,6001,0.925110879186778
2021-12-26,IE,Ireland,47414,696093,53,6054,0.8697113747731984
2022-01-02,IE,Ireland,97002,793095,53,6107,0.7700212458784887
2022-01-09,IE,Ireland,141823,934918,61,6168,0.6597370036730493
2022-01-16,IE,Ireland,147583,1082501,89,6257,0.5780133228514338
2022-01-23,IE,Ireland,56367,1138868,60,6317,0.5546735881594707
2022-01-30,IE,Ireland,35097,1173965,78,6395,0.5447351496850417
2022-02-06,IE,Ireland,36269,1210234,88,6483,0.5356815293571326
2022-02-13,IE,Ireland,36892,1247126,59,6542,0.5245660823365081
2022-02-20,IE,Ireland,32010,1279136,45,6587,0.5149569709553949
2022-02-27,IE,Ireland,27088,1306224,60,6647,0.5088713727507685
2022-03-06,IE,Ireland,22888,1329112,53,6700,0.504095967834163
2022-03-13,IE,Ireland,26726,1355838,65,6765,0.4989534147884924
2022-03-20,IE,Ireland,34473,1390311,68,6833,0.4914727712001128
2022-03-27,IE,Ireland,46646,1436957,84,6917,0.48136443888021696
2022-04-03,IE,Ireland,42205,1479162,99,7016,0.47432262321503665
2022-04-10,IE,Ireland,22014,1501176,103,7119,0.4742282050872116
2022-04-17,IE,Ireland,13440,1514616,106,7225,0.47701859745308384
2022-04-24,IE,Ireland,8932,1523548,81,7306,0.47953855080378166
2022-05-01,IE,Ireland,7576,1531124,57,7363,0.48088854984965296
2022-05-08,IE,Ireland,5251,1536375,56,7419,0.4828899194532585
2022-05-15,IE,Ireland,13088,1549463,28,7447,0.4806181238274163
2022-05-22,IE,Ireland,8038,1557501,28,7475,0.47993548639776157
2022-05-29,IE,Ireland,4138,1561639,23,7498,0.48013657445798935
2022-06-05,IE,Ireland,4467,1566106,19,7517,0.4799802823052846
2022-06-12,IE,Ireland,6053,1572159,16,7533,0.4791500096364299
2022-06-19,IE,Ireland,8220,1580379,24,7557,0.47817643742418753
2022-06-26,IE,Ireland,11608,1591987,29,7586,0.47651142879935576
2022-07-03,IE,Ireland,12852,1604839,44,7630,0.47543709992092664
2022-07-10,IE,Ireland,14090,1618929,31,7661,0.4732140816552178
2022-07-17,IE,Ireland,14291,1633220,50,7711,0.47213480119028667
2022-07-24,IE,Ireland,7832,1641052,58,7769,0.47341583325817826
2022-07-31,IE,Ireland,4541,1645593,40,7809,0.47454018095604444
2022-08-07,IE,Ireland,2954,1648547,39,7848,0.4760555810662359
2022-08-14,IE,Ireland,3193,1651740,41,7889,0.4776175427125335
2022-08-21,IE,Ireland,2263,1654003,30,7919,0.47877784985879707
2022-08-28,IE,Ireland,1641,1655644,19,7938,0.47945089644875344
2022-09-04,IE,Ireland,1902,1657546,20,7958,0.48010733940415534
2022-09-11,IE,Ireland,1780,1659326,15,7973,0.4804962978944463
2022-09-18,IE,Ireland,1555,1660881,13,7986,0.4808291503123945
2022-09-25,IE,Ireland,1875,1662756,16,8002,0.4812492031302248
2022-10-02,IE,Ireland,1921,1664677,24,8026,0.48213557344758173
2022-10-09,IE,Ireland,2261,1666938,32,8058,0.4834013022679907
2022-10-16,IE,Ireland,2210,1669148,26,8084,0.48431894595326475
2022-10-23,IE,Ireland,2036,1671184,36,8120,0.48588306254727187
2022-10-30,IE,Ireland,1682,1672866,32,8152,0.48730741135273237
2022-11-06,IE,Ireland,1905,1674771,33,8185,0.48872353294868376
2022-11-13,IE,Ireland,1805,1676576,35,8220,0.490284961731529
2022-11-20,IE,Ireland,1565,1678141,34,8254,0.4918537834425116
2022-11-27,IE,Ireland,1551,1679692,30,8284,0.49318565546540677
2022-12-04,IE,Ireland,1745,1681437,32,8316,0.49457696006451624
2022-12-11,IE,Ireland,2103,1683540,36,8352,0.49609750882069925
2022-12-18,IE,Ireland,2699,1686239,29,8381,0.4970232570827742
2022-12-25,IE,Ireland,3525,1689764,56,8437,0.49930049403348636
2023-01-01,IE,Ireland,3004,1692768,65,8502,0.5022542959224182
2023-01-08,IE,Ireland,3660,1696428,59,8561,0.5046485910395254
2023-01-15,IE,Ireland,2245,1698673,64,8625,0.5077492842942697
2023-01-22,IE,Ireland,1123,1699796,46,8671,0.5101200379339638
2023-01-29,IE,Ireland,897,1700693,25,8696,0.511320973273836
2023-02-05,IE,Ireland,754,1701447,33,8729,0.513033905846024
2023-02-12,IE,Ireland,668,1702115,21,8750,0.5140663233682801
2023-02-19,IE,Ireland,791,1702906,18,8768,0.5148845561645798
2023-02-26,IE,Ireland,650,1703556,17,8785,0.5156860120829606
2023-03-05,IE,Ireland,585,1704141,17,8802,0.5165065566757681
2023-03-12,IE,Ireland,749,1704890,10,8812,0.5168661907806369
2023-03-19,IE,Ireland,922,1705812,17,8829,0.5175834148194526
2023-03-26,IE,Ireland,982,1706794,20,8849,0.5184574119665291
2023-04-02,IE,Ireland,1345,1708139,19,8868,0.5191614968102714
2023-04-09,IE,Ireland,707,1708846,20,8888,0.5201170848631181
2023-04-16,IE,Ireland,588,1709434,15,8903,0.5208156617921488
2023-04-23,IE,Ireland,612,1710046,16,8919,0.5215649169671459
2023-04-30,IE,Ireland,504,1710550,26,8945,0.5229312209523252
2023-05-07,IE,Ireland,477,1711027,19,8964,0.5238958824144797
2023-05-14,IE,Ireland,492,1711519,17,8981,0.524738550959703
2023-05-21,IE,Ireland,423,1711942,29,9010,0.5263028770834526
2023-05-28,IE,Ireland,517,1712459,12,9022,0.5268447302971925
2023-06-04,IE,Ireland,435,1712894,18,9040,0.5277617879448465
2023-06-11,IE,Ireland,311,1713205,21,9061,0.52889175551087
2023-06-18,IE,Ireland,281,1713486,12,9073,0.5295053475779785
2023-06-25,IE,Ireland,223,1713709,8,9081,0.5299032682911743
2023-07-02,IE,Ireland,130,1713839,7,9088,0.5302715132518282
2023-07-09,IE,Ireland,172,1714011,11,9099,0.5308600703262698
2023-07-16,IE,Ireland,212,1714223,4,9103,0.5310277600988903
2023-07-23,IE,Ireland,261,1714484,4,9107,0.5311802268204311
2023-07-30,IE,Ireland,365,1714849,12,9119,0.531766936913979
2023-08-06,IE,Ireland,625,1715474,8,9127,0.5320395412579847
2023-08-13,IE,Ireland,691,1716165,15,9142,0.5326993616581156
2023-08-20,IE,Ireland,844,1717009,15,9157,0.5333111241699956
2023-08-27,IE,Ireland,931,1717940,24,9181,0.5344191298881218
2023-09-03,IE,Ireland,756,1718696,20,9201,0.5353477287431867
2023-09-10,IE,Ireland,801,1719497,21,9222,0.5363196330089556
2023-09-17,IE,Ireland,718,1720215,13,9235,0.536851498213886
2023-09-24,IE,Ireland,583,1720798,13,9248,0.5374250783648051
2023-10-01,IE,Ireland,741,1721539,10,9258,0.537774630722859
2023-10-08,IE,Ireland,706,1722245,17,9275,0.5385412644542443
2023-10-15,IE,Ireland,567,1722812,17,9292,0.5393507823256397
2023-10-22,IE,Ireland,609,1723421,12,9304,0.5398564831228121
2023-10-29,IE,Ireland,502,1723923,13,9317,0.5404533729174679
2023-11-05,IE,Ireland,412,1724335,13,9330,0.5410781547669102
2023-11-12,IE,Ireland,531,1724866,12,9342,0.5416072900735478
2023-11-19,IE,Ireland,484,1725350,7,9349,0.5418610716666183
2023-11-26,IE,Ireland,420,1725770,2,9351,0.5418450894383376
2023-12-03,IE,Ireland,441,1726211,17,9368,0.5426914786199369
2023-12-10,IE,Ireland,511,1726722,8,9376,0.5429941820397262
2023-12-17,IE,Ireland,711,1727433,11,9387,0.5434074722434966
2023-12-24,IE,Ireland,931,1728364,7,9394,0.5435197678266847
2023-12-31,IE,Ireland,595,1728959,4,9398,0.5435640752614723
2024-01-07,IE,Ireland,1196,1730155,5,9403,0.5434773185061454
2024-01-14,IE,Ireland,0,1730155,0,9403,0.5434773185061454
2020-04-05,IM,Isle of Man,88,120,1,1,0.8333333333333334
2021-08-01,IM,Isle of Man,952,4727,4,43,0.9096678654537761
2021-08-08,IM,Isle of Man,696,5423,3,46,0.8482389821132215
2021-08-15,IM,Isle of Man,484,5907,1,47,0.7956661587946504
2021-08-22,IM,Isle of Man,358,6265,1,48,0.7661612130885874
2021-08-29,IM,Isle of Man,310,6575,0,48,0.7300380228136882
2021-09-05,IM,Isle of Man,224,6799,0,48,0.7059861744374172
2021-09-12,IM,Isle of Man,188,6987,1,49,0.70130241877773
2021-09-19,IM,Isle of Man,148,7135,1,50,0.7007708479327259
2021-09-26,IM,Isle of Man,228,7363,1,51,0.6926524514464213
2021-10-03,IM,Isle of Man,271,7634,1,52,0.6811632171862719
2021-10-10,IM,Isle of Man,393,8027,2,54,0.6727295378098916
2021-10-17,IM,Isle of Man,478,8505,2,56,0.6584362139917695
2021-10-24,IM,Isle of Man,601,9106,1,57,0.6259609048978696
2021-10-31,IM,Isle of Man,538,9644,0,57,0.591041061800083
2021-11-07,IM,Isle of Man,297,9941,3,60,0.6035610099587567
2021-11-14,IM,Isle of Man,284,10225,4,64,0.6259168704156479
2021-11-21,IM,Isle of Man,332,10557,2,66,0.625177607274794
2021-11-28,IM,Isle of Man,528,11085,0,66,0.5953991880920162
2021-12-05,IM,Isle of Man,789,11874,1,67,0.5642580427825501
2021-12-12,IM,Isle of Man,651,12525,0,67,0.5349301397205588
2021-12-19,IM,Isle of Man,514,13039,0,67,0.5138430861262366
2021-12-26,IM,Isle of Man,874,13913,0,67,0.4815640048875153
2022-01-02,IM,Isle of Man,2394,16307,0,67,0.41086649904948797
2022-01-09,IM,Isle of Man,2474,18781,1,68,0.3620680474948086
2022-01-16,IM,Isle of Man,1156,19937,2,70,0.3511059838491247
2022-01-23,IM,Isle of Man,785,20722,0,70,0.3378052311552939
2022-01-30,IM,Isle of Man,611,21333,1,71,0.3328177002765668
2022-02-06,IM,Isle of Man,465,21798,2,73,0.33489310945958345
2022-02-13,IM,Isle of Man,258,22056,4,77,0.3491113529198404
2022-02-20,IM,Isle of Man,245,22301,2,79,0.35424420429577147
2022-02-27,IM,Isle of Man,376,22677,1,80,0.3527803501344975
2022-03-06,IM,Isle of Man,736,23413,0,80,0.34169051381711013
2022-03-13,IM,Isle of Man,903,24316,1,81,0.3331139990129956
2022-03-20,IM,Isle of Man,1814,26130,0,81,0.3099885189437428
2022-03-27,IM,Isle of Man,1637,27767,1,82,0.29531458205783845
2022-04-03,IM,Isle of Man,1123,28890,2,84,0.29075804776739356
2022-04-10,IM,Isle of Man,1279,30169,3,87,0.2883754847691339
2022-04-17,IM,Isle of Man,0,30169,0,87,0.2883754847691339
2022-04-24,IM,Isle of Man,1497,31666,11,98,0.30948019958314915
2022-05-01,IM,Isle of Man,539,32205,4,102,0.3167210060549604
2022-05-08,IM,Isle of Man,219,32424,2,104,0.32075006168270415
2022-05-15,IM,Isle of Man,176,32600,1,105,0.3220858895705522
2022-05-22,IM,Isle of Man,194,32794,0,105,0.3201805208269805
2022-05-29,IM,Isle of Man,172,32966,1,106,0.3215434083601286
2022-06-05,IM,Isle of Man,132,33098,1,107,0.32328237355731465
2022-06-12,IM,Isle of Man,153,33251,0,107,0.3217948332380981
2022-06-19,IM,Isle of Man,570,33821,0,107,0.3163714851719346
2022-06-26,IM,Isle of Man,0,33821,1,108,0.3193282280240088
2022-07-03,IM,Isle of Man,2642,36463,0,108,0.2961906590242163
2022-07-10,IM,Isle of Man,535,36998,2,110,0.29731336829017785
2022-07-17,IM,Isle of Man,241,37239,0,110,0.2953892424608609
2022-07-24,IM,Isle of Man,299,37538,1,111,0.29570035697160213
2022-07-31,IM,Isle of Man,158,37696,3,114,0.3024193548387097
2022-08-07,IM,Isle of Man,98,37794,0,114,0.3016351801873313
2022-08-14,IM,Isle of Man,0,37794,0,114,0.3016351801873313
2022-08-21,IM,Isle of Man,0,37794,1,115,0.30428110282055354
2022-08-28,IM,Isle of Man,214,38008,1,116,0.3051989054935803
2022-09-04,IM,Isle of Man,0,38008,0,116,0.3051989054935803
2022-09-11,IM,Isle of Man,0,38008,0,116,0.3051989054935803
2022-09-18,IM,Isle of Man,0,38008,0,116,0.3051989054935803
2022-09-25,IM,Isle of Man,0,38008,0,116,0.3051989054935803
2022-10-02,IM,Isle of Man,0,38008,0,116,0.3051989054935803
2022-10-09,IM,Isle of Man,0,38008,0,116,0.3051989054935803
2022-10-16,IM,Isle of Man,0,38008,0,116,0.3051989054935803
2022-10-23,IM,Isle of Man,0,38008,0,116,0.3051989054935803
2022-10-30,IM,Isle of Man,0,38008,0,116,0.3051989054935803
2022-11-06,IM,Isle of Man,0,38008,0,116,0.3051989054935803
2022-11-13,IM,Isle of Man,0,38008,0,116,0.3051989054935803
2022-11-20,IM,Isle of Man,0,38008,0,116,0.3051989054935803
2022-11-27,IM,Isle of Man,0,38008,0,116,0.3051989054935803
2022-12-04,IM,Isle of Man,0,38008,0,116,0.3051989054935803
2022-12-11,IM,Isle of Man,0,38008,0,116,0.3051989054935803
2022-12-18,IM,Isle of Man,0,38008,0,116,0.3051989054935803
2022-12-25,IM,Isle of Man,0,38008,0,116,0.3051989054935803
2023-01-01,IM,Isle of Man,0,38008,0,116,0.3051989054935803
2023-01-08,IM,Isle of Man,0,38008,0,116,0.3051989054935803
2023-01-15,IM,Isle of Man,0,38008,0,116,0.3051989054935803
2023-01-22,IM,Isle of Man,0,38008,0,116,0.3051989054935803
2023-01-29,IM,Isle of Man,0,38008,0,116,0.3051989054935803
2023-02-05,IM,Isle of Man,0,38008,0,116,0.3051989054935803
2023-02-12,IM,Isle of Man,0,38008,0,116,0.3051989054935803
2023-02-19,IM,Isle of Man,0,38008,0,116,0.3051989054935803
2023-02-26,IM,Isle of Man,0,38008,0,116,0.3051989054935803
2023-03-05,IM,Isle of Man,0,38008,0,116,0.3051989054935803
2023-03-12,IM,Isle of Man,0,38008,0,116,0.3051989054935803
2023-03-19,IM,Isle of Man,0,38008,0,116,0.3051989054935803
2023-03-26,IM,Isle of Man,0,38008,0,116,0.3051989054935803
2023-04-02,IM,Isle of Man,0,38008,0,116,0.3051989054935803
2023-04-09,IM,Isle of Man,0,38008,0,116,0.3051989054935803
2023-04-16,IM,Isle of Man,0,38008,0,116,0.3051989054935803
2023-04-23,IM,Isle of Man,0,38008,0,116,0.3051989054935803
2023-04-30,IM,Isle of Man,0,38008,0,116,0.3051989054935803
2023-05-07,IM,Isle of Man,0,38008,0,116,0.3051989054935803
2023-05-14,IM,Isle of Man,0,38008,0,116,0.3051989054935803
2023-05-21,IM,Isle of Man,0,38008,0,116,0.3051989054935803
2023-05-28,IM,Isle of Man,0,38008,0,116,0.3051989054935803
2023-06-04,IM,Isle of Man,0,38008,0,116,0.3051989054935803
2023-06-11,IM,Isle of Man,0,38008,0,116,0.3051989054935803
2023-06-18,IM,Isle of Man,0,38008,0,116,0.3051989054935803
2023-06-25,IM,Isle of Man,0,38008,0,116,0.3051989054935803
2023-07-02,IM,Isle of Man,0,38008,0,116,0.3051989054935803
2023-07-09,IM,Isle of Man,0,38008,0,116,0.3051989054935803
2023-07-16,IM,Isle of Man,0,38008,0,116,0.3051989054935803
2023-07-23,IM,Isle of Man,0,38008,0,116,0.3051989054935803
2023-07-30,IM,Isle of Man,0,38008,0,116,0.3051989054935803
2023-08-06,IM,Isle of Man,0,38008,0,116,0.3051989054935803
2023-08-13,IM,Isle of Man,0,38008,0,116,0.3051989054935803
2023-08-20,IM,Isle of Man,0,38008,0,116,0.3051989054935803
2023-08-27,IM,Isle of Man,0,38008,0,116,0.3051989054935803
2023-09-03,IM,Isle of Man,0,38008,0,116,0.3051989054935803
2023-09-10,IM,Isle of Man,0,38008,0,116,0.3051989054935803
2023-09-17,IM,Isle of Man,0,38008,0,116,0.3051989054935803
2023-09-24,IM,Isle of Man,0,38008,0,116,0.3051989054935803
2023-10-01,IM,Isle of Man,0,38008,0,116,0.3051989054935803
2023-10-08,IM,Isle of Man,0,38008,0,116,0.3051989054935803
2023-10-15,IM,Isle of Man,0,38008,0,116,0.3051989054935803
2023-10-22,IM,Isle of Man,0,38008,0,116,0.3051989054935803
2023-10-29,IM,Isle of Man,0,38008,0,116,0.3051989054935803
2023-11-05,IM,Isle of Man,0,38008,0,116,0.3051989054935803
2023-11-12,IM,Isle of Man,0,38008,0,116,0.3051989054935803
2023-11-19,IM,Isle of Man,0,38008,0,116,0.3051989054935803
2023-11-26,IM,Isle of Man,0,38008,0,116,0.3051989054935803
2023-12-03,IM,Isle of Man,0,38008,0,116,0.3051989054935803
2023-12-10,IM,Isle of Man,0,38008,0,116,0.3051989054935803
2023-12-17,IM,Isle of Man,0,38008,0,116,0.3051989054935803
2023-12-24,IM,Isle of Man,0,38008,0,116,0.3051989054935803
2023-12-31,IM,Isle of Man,0,38008,0,116,0.3051989054935803
2024-01-07,IM,Isle of Man,0,38008,0,116,0.3051989054935803
2024-01-14,IM,Isle of Man,0,38008,0,116,0.3051989054935803
2020-03-22,IL,Israel,844,1036,1,1,0.09652509652509653
2020-03-29,IL,Israel,2868,3904,12,13,0.3329918032786885
2020-04-05,IL,Israel,4259,8163,36,49,0.6002695087590347
2020-04-12,IL,Israel,2786,10949,54,103,0.94072518038177
2020-07-12,IL,Israel,8756,38055,34,375,0.9854158454867954
2020-07-19,IL,Israel,11408,49463,53,428,0.8652932494996259
2020-07-26,IL,Israel,11867,61330,68,496,0.8087396054133377
2020-08-02,IL,Israel,10932,72262,83,579,0.8012510032935707
2020-08-09,IL,Israel,10106,82368,82,661,0.802496114996115
2020-08-16,IL,Israel,9839,92207,88,749,0.8123027535870379
2020-08-23,IL,Israel,9687,101894,87,836,0.8204604785365184
2020-08-30,IL,Israel,11652,113546,88,924,0.8137671076039666
2020-09-06,IL,Israel,15508,129054,108,1032,0.7996652564042959
2020-09-13,IL,Israel,23881,152935,113,1145,0.748684081472521
2020-09-20,IL,Israel,32590,185525,145,1290,0.6953240803126264
2020-09-27,IL,Israel,43128,228653,190,1480,0.6472690058735289
2020-10-04,IL,Israel,35988,264641,241,1721,0.6503149549767421
2020-10-11,IL,Israel,25121,289762,257,1978,0.6826291922336262
2020-10-18,IL,Israel,12757,302519,245,2223,0.7348298784539153
2020-10-25,IL,Israel,6926,309445,190,2413,0.7797831601738596
2020-11-01,IL,Israel,4652,314097,156,2569,0.8179002028035925
2020-11-08,IL,Israel,4530,318627,113,2682,0.8417365759963845
2020-11-15,IL,Israel,4585,323212,60,2742,0.8483595906092595
2020-11-22,IL,Israel,5091,328303,68,2810,0.8559166379838137
2020-11-29,IL,Israel,6362,334665,58,2868,0.856976379364439
2020-12-06,IL,Israel,9033,343698,60,2928,0.8519106890351412
2020-12-13,IL,Israel,11998,355696,80,3008,0.8456659619450317
2020-12-20,IL,Israel,17326,373022,103,3111,0.8339990670791535
2020-12-27,IL,Israel,26083,399105,131,3242,0.8123175605417121
2021-01-03,IL,Israel,36643,435748,191,3433,0.7878406785573312
2021-01-10,IL,Israel,50749,486497,244,3677,0.7558114438526856
2021-01-17,IL,Israel,58256,544753,341,4018,0.7375819866985588
2021-01-24,IL,Israel,49873,594626,366,4384,0.737270149640278
2021-01-31,IL,Israel,45816,640442,381,4765,0.7440174129741647
2021-02-07,IL,Israel,46171,686613,348,5113,0.7446698504106389
2021-02-14,IL,Israel,35955,722568,248,5361,0.7419370910419504
2021-02-21,IL,Israel,25826,748394,205,5566,0.74372589839042
2021-02-28,IL,Israel,25825,774219,177,5743,0.7417797806563776
2021-03-07,IL,Israel,26152,800371,132,5875,0.7340345914582113
2021-03-14,IL,Israel,17889,818260,115,5990,0.732041160511329
2021-03-21,IL,Israel,9371,827631,101,6091,0.7359559997148488
2021-03-28,IL,Israel,4543,832174,77,6168,0.7411911451210925
2021-04-04,IL,Israel,2360,834534,81,6249,0.7488011273357347
2021-04-11,IL,Israel,1684,836218,59,6308,0.7543487463795325
2021-04-18,IL,Israel,1052,837270,43,6351,0.7585366727578917
2021-04-25,IL,Israel,984,838254,24,6375,0.7605093444230507
2021-05-02,IL,Israel,624,838878,16,6391,0.7618509485288684
2021-05-09,IL,Israel,404,839282,13,6404,0.7630331640616622
2021-05-16,IL,Israel,261,839543,8,6412,0.7637488490762236
2021-05-23,IL,Israel,209,839752,7,6419,0.7643923444064439
2021-05-30,IL,Israel,150,839902,6,6425,0.7649701989041578
2021-06-06,IL,Israel,115,840017,4,6429,0.7653416537998636
2021-06-13,IL,Israel,92,840109,3,6432,0.7656149380616086
2021-06-20,IL,Israel,184,840293,3,6435,0.7658043087351674
2021-06-27,IL,Israel,1095,841388,1,6436,0.7649265261686642
2021-07-04,IL,Israel,2005,843393,0,6436,0.7631080646863324
2021-07-11,IL,Israel,3244,846637,5,6441,0.7607746885619221
2021-07-18,IL,Israel,5222,851859,12,6453,0.7575197303779146
2021-07-25,IL,Israel,8764,860623,14,6467,0.7514323925807236
2021-08-01,IL,Israel,14859,875482,26,6493,0.741648600428107
2021-08-08,IL,Israel,23515,898997,75,6568,0.7305919819532212
2021-08-15,IL,Israel,38065,937062,124,6692,0.7141469828036993
2021-08-22,IL,Israel,51170,988232,163,6855,0.6936630264958026
2021-08-29,IL,Israel,61130,1049362,193,7048,0.6716462002626358
2021-09-05,IL,Israel,66012,1115374,208,7256,0.6505441224199238
2021-09-12,IL,Israel,55065,1170439,171,7427,0.634548233611491
2021-09-19,IL,Israel,54413,1224852,146,7573,0.6182787798036007
2021-09-26,IL,Israel,40329,1265181,143,7716,0.6098732118171234
2021-10-03,IL,Israel,24955,1290136,129,7845,0.6080754277068464
2021-10-10,IL,Israel,16145,1306281,101,7946,0.6082917840801482
2021-10-17,IL,Israel,11082,1317363,82,8028,0.6093992316468582
2021-10-24,IL,Israel,7222,1324585,45,8073,0.6094739106965578
2021-10-31,IL,Israel,4653,1329238,47,8120,0.6108763065756471
2021-11-07,IL,Israel,3775,1333013,22,8142,0.6107967439177262
2021-11-14,IL,Israel,3104,1336117,25,8167,0.611248865181717
2021-11-21,IL,Israel,3191,1339308,22,8189,0.6114351590522867
2021-11-28,IL,Israel,3564,1342872,12,8201,0.6107060092101109
2021-12-05,IL,Israel,3636,1346508,15,8216,0.6101709013240174
2021-12-12,IL,Israel,4294,1350802,16,8232,0.6094157396864973
2021-12-19,IL,Israel,4887,1355689,13,8245,0.608177834296804
2021-12-26,IL,Israel,9079,1364768,6,8251,0.6045716194986988
2022-01-02,IL,Israel,26891,1391659,11,8262,0.5936799172785863
2022-01-09,IL,Israel,112884,1504543,24,8286,0.5507320162999662
2022-01-16,IL,Israel,308975,1813518,74,8360,0.46098246612385435
2022-01-23,IL,Israel,494733,2308251,193,8553,0.3705402921952595
2022-01-30,IL,Israel,474410,2782661,336,8889,0.31944243298051755
2022-02-06,IL,Israel,382736,3165397,434,9323,0.29452861678961595
2022-02-13,IL,Israel,241078,3406475,439,9762,0.2865718961683265
2022-02-20,IL,Israel,135580,3542055,262,10024,0.28299955816609285
2022-02-27,IL,Israel,77870,3619925,192,10216,0.28221579176364153
2022-03-06,IL,Israel,53061,3672986,134,10350,0.28178708004876685
2022-03-13,IL,Israel,43758,3716744,71,10421,0.2803798163123422
2022-03-20,IL,Israel,47811,3764555,58,10479,0.2783595936305885
2022-03-27,IL,Israel,88966,3853521,50,10529,0.2732306376428207
2022-04-03,IL,Israel,86177,3939698,63,10592,0.2688530948311266
2022-04-10,IL,Israel,57296,3996994,60,10652,0.26650027495662987
2022-04-17,IL,Israel,34453,4031447,48,10700,0.26541338631017597
2022-04-24,IL,Israel,25894,4057341,46,10746,0.2648532622720151
2022-05-01,IL,Israel,21226,4078567,36,10782,0.2643575549941928
2022-05-08,IL,Israel,14419,4092986,30,10812,0.264159222631106
2022-05-15,IL,Israel,15310,4108296,20,10832,0.26366162516040714
2022-05-22,IL,Israel,14797,4123093,23,10855,0.2632732271622299
2022-05-29,IL,Israel,13249,4136342,11,10866,0.2626958795960295
2022-06-05,IL,Israel,16478,4152820,14,10880,0.26199064731917104
2022-06-12,IL,Israel,29452,4182272,13,10893,0.26045651741445797
2022-06-19,IL,Israel,47448,4229720,18,10911,0.2579603378001381
2022-06-26,IL,Israel,67821,4297541,49,10960,0.2550295622543217
2022-07-03,IL,Israel,74269,4371810,89,11049,0.25273284978075444
2022-07-10,IL,Israel,73628,4445438,96,11145,0.2507064545720804
2022-07-17,IL,Israel,60205,4505643,103,11248,0.24964250385572048
2022-07-24,IL,Israel,43530,4549173,99,11347,0.24942995133401172
2022-07-31,IL,Israel,30706,4579879,82,11429,0.24954807758021555
2022-08-07,IL,Israel,21063,4600942,70,11499,0.2499270801501084
2022-08-14,IL,Israel,13168,4614110,52,11551,0.2503408024516104
2022-08-21,IL,Israel,9188,4623298,43,11594,0.2507733656796512
2022-08-28,IL,Israel,6922,4630220,41,11635,0.25128395626989647
2022-09-04,IL,Israel,6023,4636243,26,11661,0.25151830911365086
2022-09-11,IL,Israel,6094,4642337,16,11677,0.2515327947971033
2022-09-18,IL,Israel,7637,4649974,15,11692,0.25144226612879983
2022-09-25,IL,Israel,7584,4657558,9,11701,0.2512260716882109
2022-10-02,IL,Israel,6116,4663674,13,11714,0.25117536088500186
2022-10-09,IL,Israel,4937,4668611,17,11731,0.251273879961299
2022-10-16,IL,Israel,4311,4672922,17,11748,0.25140586553766575
2022-10-23,IL,Israel,4605,4677527,18,11766,0.25154317655461955
2022-10-30,IL,Israel,5518,4683045,16,11782,0.2515884429895506
2022-11-06,IL,Israel,6333,4689378,15,11797,0.2515685449115
2022-11-13,IL,Israel,7173,4696551,16,11813,0.25152500207066847
2022-11-20,IL,Israel,8825,4705376,23,11836,0.2515420659262937
2022-11-27,IL,Israel,10228,4715604,24,11860,0.25150542751257315
2022-12-04,IL,Israel,11231,4726835,39,11899,0.25173292488525617
2022-12-11,IL,Israel,10967,4737802,44,11943,0.2520789176077852
2022-12-18,IL,Israel,10321,4748123,42,11985,0.2524155334644869
2022-12-25,IL,Israel,8581,4756704,41,12026,0.2528221222089918
2023-01-01,IL,Israel,7374,4764078,41,12067,0.25329140286955837
2023-01-08,IL,Israel,6639,4770717,46,12113,0.2539031344764319
2023-01-15,IL,Israel,5328,4776045,24,12137,0.2541223962504541
2023-01-22,IL,Israel,4576,4780621,36,12173,0.25463219108981866
2023-01-29,IL,Israel,4168,4784789,26,12199,0.2549537712112279
2023-02-05,IL,Israel,3442,4788231,26,12225,0.25531349677991727
2023-02-12,IL,Israel,2878,4791109,19,12244,0.2555566988770241
2023-02-19,IL,Israel,3097,4794206,21,12265,0.2558296410291923
2023-02-26,IL,Israel,3552,4797758,26,12291,0.2561821584164937
2023-03-05,IL,Israel,3657,4801415,25,12316,0.2565077169959273
2023-03-12,IL,Israel,3462,4804877,23,12339,0.2568015788957761
2023-03-19,IL,Israel,3838,4808715,32,12371,0.257262075211361
2023-03-26,IL,Israel,3192,4811907,22,12393,0.25754861845833676
2023-04-02,IL,Israel,2791,4814698,24,12417,0.25789779545882213
2023-04-09,IL,Israel,1969,4816667,16,12433,0.2581245496107578
2023-04-16,IL,Israel,1852,4818519,22,12455,0.25848191114323715
2023-04-23,IL,Israel,1956,4820475,25,12480,0.25889564825043176
2023-04-30,IL,Israel,1334,4821809,19,12499,0.25921806525310315
2023-05-07,IL,Israel,1540,4823349,12,12511,0.25938409184158145
2023-05-14,IL,Israel,1169,4824518,7,12518,0.2594663342534943
2023-05-21,IL,Israel,850,4825368,16,12534,0.2597522095724098
2023-05-28,IL,Israel,688,4826056,7,12541,0.25986022540973414
2023-06-04,IL,Israel,745,4826801,9,12550,0.26000657578383696
2023-06-11,IL,Israel,735,4827536,8,12558,0.260132705380136
2023-06-18,IL,Israel,601,4828137,6,12564,0.26022459594663533
2023-06-25,IL,Israel,597,4828734,3,12567,0.2602545511929214
2023-07-02,IL,Israel,514,4829248,6,12573,0.2603510940005566
2023-07-09,IL,Israel,497,4829745,6,12579,0.2604485329970837
2023-07-16,IL,Israel,539,4830284,4,12583,0.26050228102529793
2023-07-23,IL,Israel,535,4830819,6,12589,0.26059763365176797
2023-07-30,IL,Israel,563,4831382,8,12597,0.2607328503521353
2023-08-06,IL,Israel,541,4831923,10,12607,0.26091061467659976
2023-08-13,IL,Israel,601,4832524,17,12624,0.2612299494011825
2023-08-20,IL,Israel,747,4833271,9,12633,0.2613757846394295
2023-08-27,IL,Israel,866,4834137,10,12643,0.26153582325035474
2023-09-03,IL,Israel,985,4835122,9,12652,0.2616686817830036
2023-09-10,IL,Israel,1048,4836170,16,12668,0.26194281838727757
2023-09-17,IL,Israel,1269,4837439,10,12678,0.262080824171633
2023-09-24,IL,Israel,1464,4838903,9,12687,0.26218752473442847
2023-10-01,IL,Israel,1038,4839941,10,12697,0.2623379086645891
2023-10-08,IL,Israel,784,4840725,0,12697,0.26229542062397676
2023-10-15,IL,Israel,389,4841114,1,12698,0.2622950006961208
2023-10-22,IL,Israel,264,4841378,5,12703,0.2623839741495087
2023-10-29,IL,Israel,180,4841558,4,12707,0.26245683724123514
2023-11-05,IL,Israel,0,4841558,0,12707,0.26245683724123514
2023-11-12,IL,Israel,0,4841558,0,12707,0.26245683724123514
2023-11-19,IL,Israel,0,4841558,0,12707,0.26245683724123514
2023-11-26,IL,Israel,0,4841558,0,12707,0.26245683724123514
2023-12-03,IL,Israel,0,4841558,0,12707,0.26245683724123514
2023-12-10,IL,Israel,0,4841558,0,12707,0.26245683724123514
2023-12-17,IL,Israel,0,4841558,0,12707,0.26245683724123514
2023-12-24,IL,Israel,0,4841558,0,12707,0.26245683724123514
2023-12-31,IL,Israel,0,4841558,0,12707,0.26245683724123514
2024-01-07,IL,Israel,0,4841558,0,12707,0.26245683724123514
2024-01-14,IL,Israel,0,4841558,0,12707,0.26245683724123514
2022-05-08,IT,Italy,304573,16767773,910,164417,0.9805535893168401
2022-05-15,IT,Italy,262374,17030147,765,165182,0.9699387797415958
2022-05-22,IT,Italy,199116,17229263,736,165918,0.9630011452027867
2022-05-29,IT,Italy,144478,17373741,624,166542,0.9585845673651979
2022-06-05,IT,Italy,116710,17490451,380,166922,0.9543607537621528
2022-06-12,IT,Italy,143614,17634065,443,167365,0.9491005051869776
2022-06-19,IT,Italy,210840,17844905,338,167703,0.9397808506125418
2022-06-26,IT,Italy,340012,18184917,355,168058,0.9241614905363604
2022-07-03,IT,Italy,511037,18695954,430,168488,0.9012003345750638
2022-07-10,IT,Italy,661984,19357938,574,169062,0.873347150920723
2022-07-17,IT,Italy,718925,20076863,784,169846,0.845978776664462
2022-07-24,IT,Italy,531327,20608190,952,170798,0.828787001672636
2022-07-31,IT,Italy,394583,21002773,1205,172003,0.818953763867276
2022-08-07,IT,Italy,283998,21286771,1059,173062,0.8130025920793718
2022-08-14,IT,Italy,193305,21480076,920,173982,0.8099692012262899
2022-08-21,IT,Italy,150922,21630998,677,174659,0.8074477192406935
2022-08-28,IT,Italy,157864,21788862,647,175306,0.8045670306232606
2022-09-04,IT,Italy,136211,21925073,496,175802,0.801830853653258
2022-09-11,IT,Italy,110644,22035717,373,176175,0.7994974704022564
2022-09-18,IT,Italy,113218,22148935,371,176546,0.7970857289526562
2022-09-25,IT,Italy,135877,22284812,321,176867,0.7936661076611281
2022-10-02,IT,Italy,215534,22500346,263,177130,0.7872323385604827
2022-10-09,IT,Italy,280947,22781293,348,177478,0.7790514787725175
2022-10-16,IT,Italy,288452,23069745,478,177956,0.7713826052260222
2022-10-23,IT,Italy,252777,23322522,586,178542,0.7655347050374741
2022-10-30,IT,Italy,208501,23531023,559,179101,0.7611271299169611
2022-11-06,IT,Italy,165989,23697012,554,179655,0.7581335570915017
2022-11-13,IT,Italy,181181,23878193,484,180139,0.7544080073395839
2022-11-20,IT,Italy,221013,24099206,540,180679,0.7497300948421288
2022-11-27,IT,Italy,228458,24327664,592,181271,0.7451229185013407
2022-12-04,IT,Italy,227792,24555456,673,181944,0.7409514203279304
2022-12-11,IT,Italy,198433,24753889,675,182619,0.7377386236158691
2022-12-18,IT,Italy,174187,24928076,751,183370,0.7355962810768067
2022-12-25,IT,Italy,132427,25060503,798,184168,0.7348934696163122
2023-01-01,IT,Italy,132328,25192831,750,184918,0.7340104016098865
2023-01-08,IT,Italy,108312,25301143,614,185532,0.7332949345410996
2023-01-15,IT,Italy,79745,25380888,626,186158,0.7334573951864883
2023-01-22,IT,Italy,47190,25428078,443,186601,0.733838397066424
2023-01-29,IT,Italy,36722,25464800,303,186904,0.7339700292168012
2023-02-05,IT,Italy,32751,25497551,455,187359,0.7348117472144677
2023-02-12,IT,Italy,29286,25526837,259,187618,0.7349833432163961
2023-02-19,IT,Italy,29146,25555983,309,187927,0.7353542221404671
2023-02-26,IT,Italy,29177,25585160,247,188174,0.7354810366634409
2023-03-05,IT,Italy,25133,25610293,222,188396,0.7356261015834532
2023-03-12,IT,Italy,24149,25634442,198,188594,0.7357055012159032
2023-03-19,IT,Italy,23041,25657483,201,188795,0.7358282182238998
2023-03-26,IT,Italy,22665,25680148,179,188974,0.7358758212764194
2023-04-02,IT,Italy,20999,25701147,181,189155,0.7359788261590037
2023-04-09,IT,Italy,19907,25721054,148,189303,0.7359846140053203
2023-04-16,IT,Italy,24746,25745800,137,189440,0.7358093358916794
2023-04-23,IT,Italy,26659,25772459,187,189627,0.735773796361457
2023-04-30,IT,Italy,23050,25795509,159,189786,0.7357327199862581
2023-05-07,IT,Italy,19894,25815403,182,189968,0.7358707512720216
2023-05-14,IT,Italy,17110,25832513,154,190122,0.7359794999425724
2023-05-21,IT,Italy,14163,25846676,164,190286,0.7362107220286276
2023-05-28,IT,Italy,15136,25861812,154,190440,0.736375316625146
2023-06-04,IT,Italy,10983,25872795,111,190551,0.7364917474126781
2023-06-11,IT,Italy,9501,25882296,104,190655,0.7366232114801562
2023-06-18,IT,Italy,6930,25889226,81,190736,0.7367389044384718
2023-06-25,IT,Italy,5292,25894518,84,190820,0.736912731876299
2023-07-02,IT,Italy,4430,25898948,67,190887,0.7370453811483
2023-07-09,IT,Italy,3536,25902484,29,190916,0.7370567239806036
2023-07-16,IT,Italy,3405,25905889,43,190959,0.7371258326629903
2023-07-23,IT,Italy,3572,25909461,43,191002,0.7371901715747773
2023-07-30,IT,Italy,4381,25913842,17,191019,0.7371311440426317
2023-08-06,IT,Italy,6352,25920194,49,191068,0.7371395445574211
2023-08-13,IT,Italy,6071,25926265,76,191144,0.7372600719772016
2023-08-20,IT,Italy,7691,25933956,38,191182,0.737187955435723
2023-08-27,IT,Italy,12948,25946904,55,191237,0.7370320559246684
2023-09-03,IT,Italy,17113,25964017,81,191318,0.7368582450088521
2023-09-10,IT,Italy,24730,25988747,89,191407,0.7364995318935538
2023-09-17,IT,Italy,34727,26023474,109,191516,0.7359355634070993
2023-09-24,IT,Italy,37524,26060998,134,191650,0.7353901028655925
2023-10-01,IT,Italy,39802,26100800,130,191780,0.7347667504444308
2023-10-08,IT,Italy,45648,26146448,154,191934,0.734072941762491
2023-10-15,IT,Italy,38171,26184619,164,192098,0.7336291584002044
2023-10-22,IT,Italy,29933,26214552,214,192312,0.733607806839499
2023-10-29,IT,Italy,28440,26242992,167,192479,0.7334491432989043
2023-11-05,IT,Italy,24652,26267644,135,192614,0.7332747466807453
2023-11-12,IT,Italy,30915,26298559,219,192833,0.7332454983560126
2023-11-19,IT,Italy,42121,26340680,258,193091,0.7330524496710032
2023-11-26,IT,Italy,49342,26390022,284,193375,0.7327580098265928
2023-12-03,IT,Italy,56047,26446069,338,193713,0.7324831527891725
2023-12-10,IT,Italy,53207,26499276,399,194112,0.7325181261555975
2023-12-17,IT,Italy,65270,26564546,415,194527,0.7322805366220074
2023-12-24,IT,Italy,56752,26621298,334,194861,0.731974075794501
2023-12-31,IT,Italy,34013,26655311,224,195085,0.7318804121249983
2024-01-07,IT,Italy,7564,26662875,43,195128,0.7318340576550728
2024-01-14,IT,Italy,0,26662875,0,195128,0.7318340576550728
2020-08-30,JM,Jamaica,665,2011,3,19,0.9448035803083044
2020-02-23,JP,Japan,80,132,0,1,0.7575757575757576
2022-01-16,JP,Japan,114235,1879839,30,18433,0.9805626971245942
2022-01-23,JP,Japan,289814,2169653,73,18506,0.8529474528876276
2022-01-30,JP,Japan,499985,2669638,258,18764,0.7028668306339662
2022-02-06,JP,Japan,630951,3300589,560,19324,0.5854712598266552
2022-02-13,JP,Japan,611609,3912198,1035,20359,0.520397996215938
2022-02-20,JP,Japan,572555,4484753,1462,21821,0.4865596834429901
2022-02-27,JP,Japan,469867,4954620,1449,23270,0.4696626582866093
2022-03-06,JP,Japan,438913,5393533,1665,24935,0.46231292178985467
2022-03-13,JP,Japan,378863,5772396,1219,26154,0.4530874181189233
2022-03-20,JP,Japan,331694,6104090,891,27045,0.44306358523547323
2022-03-27,JP,Japan,273629,6377719,722,27767,0.4353750925683618
2022-04-03,JP,Japan,324367,6702086,519,28286,0.4220477027600064
2022-04-10,JP,Japan,337477,7039563,398,28684,0.40746847496073263
2022-04-17,JP,Japan,334688,7374251,339,29023,0.39357217431302516
2022-04-24,JP,Japan,285761,7660012,285,29308,0.3826103666678329
2022-05-01,JP,Japan,241921,7901933,293,29601,0.37460454296436074
2022-05-08,JP,Japan,197600,8099533,212,29813,0.36808294996760926
2022-05-15,JP,Japan,273523,8373056,248,30061,0.3590206490915623
2022-05-22,JP,Japan,245627,8618683,246,30307,0.351643052656653
2022-05-29,JP,Japan,192931,8811614,251,30558,0.34679231296332313
2022-06-05,JP,Japan,134170,8945784,215,30773,0.34399444475744106
2022-06-12,JP,Japan,105948,9051732,137,30910,0.3414816081607365
2022-06-19,JP,Japan,98001,9149733,135,31045,0.33929951835753025
2022-06-26,JP,Japan,103653,9253386,94,31139,0.3365146552840225
2022-07-03,JP,Japan,122586,9375972,193,31332,0.33417335290677064
2022-07-10,JP,Japan,269760,9645732,113,31445,0.3259991050964302
2022-07-17,JP,Japan,559111,10204843,165,31610,0.3097548879487906
2022-07-24,JP,Japan,969068,11173911,330,31940,0.2858444102517015
2022-07-31,JP,Japan,1379099,12553010,754,32694,0.2604474942663154
2022-08-07,JP,Japan,1496968,14049978,1131,33825,0.24074770793235406
2022-08-14,JP,Japan,1395301,15445279,1546,35371,0.229008488613252
2022-08-21,JP,Japan,1476374,16921653,1906,37277,0.22029171736354597
2022-08-28,JP,Japan,1258772,18180425,1976,39253,0.21590804395386795
2022-09-04,JP,Japan,1164787,19345212,2040,41293,0.21345333408597433
2022-09-11,JP,Japan,537181,19882393,1501,42794,0.2152356610192747
2022-09-18,JP,Japan,605919,20488312,1033,43827,0.21391220516360743
2022-09-25,JP,Japan,535502,21023814,636,44463,0.21148874319378966
2022-10-02,JP,Japan,306958,21330772,555,45018,0.2110472138561136
2022-10-09,JP,Japan,208547,21539319,493,45511,0.21129265971686476
2022-10-16,JP,Japan,218276,21757595,379,45890,0.2109148552493968
2022-10-23,JP,Japan,233682,21991277,457,46347,0.21075174488502874
2022-10-30,JP,Japan,281974,22273251,364,46711,0.20971792577563103
2022-11-06,JP,Japan,401693,22674944,428,47139,0.20789025983923046
2022-11-13,JP,Japan,503766,23178710,576,47715,0.20585701275006246
2022-11-20,JP,Japan,593075,23771785,767,48482,0.2039476631645457
2022-11-27,JP,Japan,698772,24470557,952,49434,0.20201420016716415
2022-12-04,JP,Japan,749895,25220452,1174,50608,0.20066254165468567
2022-12-11,JP,Japan,849371,26069823,1435,52043,0.19962928018345197
2022-12-18,JP,Japan,1046650,27116473,1687,53730,0.19814523813624285
2022-12-25,JP,Japan,1149932,28266405,2083,55813,0.1974534787851515
2023-01-01,JP,Japan,946130,29212535,1908,57721,0.19758983600704286
2023-01-08,JP,Japan,1070496,30283031,775,58496,0.19316428398465135
2023-01-15,JP,Japan,1025321,31308352,0,58496,0.18683832352466206
2023-01-22,JP,Japan,672526,31980878,0,58496,0.18290929973842496
2023-01-29,JP,Japan,438754,32419632,0,58496,0.18043388031054763
2023-02-05,JP,Japan,292614,32712246,10981,69477,0.21238835144489926
2023-02-12,JP,Japan,223365,32935611,1218,70695,0.214646086268143
2023-02-19,JP,Japan,141082,33076693,991,71686,0.21672662378914362
2023-02-26,JP,Japan,95874,33172567,582,72268,0.21785471109305468
2023-03-05,JP,Japan,78930,33251497,503,72771,0.21885029717609406
2023-03-12,JP,Japan,65012,33316509,428,73199,0.21970789316491712
2023-03-19,JP,Japan,51856,33368365,312,73511,0.2203014741657255
2023-03-26,JP,Japan,47096,33415461,236,73747,0.22069723952035258
2023-04-02,JP,Japan,47398,33462859,206,73953,0.22100024388232936
2023-04-09,JP,Japan,53989,33516848,143,74096,0.22107090738365376
2023-04-16,JP,Japan,56847,33573695,139,74235,0.22111060459684287
2023-04-23,JP,Japan,65510,33639205,141,74376,0.2210991609343919
2023-04-30,JP,Japan,74812,33714017,166,74542,0.22110091479161323
2023-05-07,JP,Japan,64976,33778993,112,74654,0.22100718040943376
2023-05-14,JP,Japan,24579,33803572,40,74694,0.2209648140143296
2023-05-21,JP,Japan,0,33803572,0,74694,0.2209648140143296
2023-05-28,JP,Japan,0,33803572,0,74694,0.2209648140143296
2023-06-04,JP,Japan,0,33803572,0,74694,0.2209648140143296
2023-06-11,JP,Japan,0,33803572,0,74694,0.2209648140143296
2023-06-18,JP,Japan,0,33803572,0,74694,0.2209648140143296
2023-06-25,JP,Japan,0,33803572,0,74694,0.2209648140143296
2023-07-02,JP,Japan,0,33803572,0,74694,0.2209648140143296
2023-07-09,JP,Japan,0,33803572,0,74694,0.2209648140143296
2023-07-16,JP,Japan,0,33803572,0,74694,0.2209648140143296
2023-07-23,JP,Japan,0,33803572,0,74694,0.2209648140143296
2023-07-30,JP,Japan,0,33803572,0,74694,0.2209648140143296
2023-08-06,JP,Japan,0,33803572,0,74694,0.2209648140143296
2023-08-13,JP,Japan,0,33803572,0,74694,0.2209648140143296
2023-08-20,JP,Japan,0,33803572,0,74694,0.2209648140143296
2023-08-27,JP,Japan,0,33803572,0,74694,0.2209648140143296
2023-09-03,JP,Japan,0,33803572,0,74694,0.2209648140143296
2023-09-10,JP,Japan,0,33803572,0,74694,0.2209648140143296
2023-09-17,JP,Japan,0,33803572,0,74694,0.2209648140143296
2023-09-24,JP,Japan,0,33803572,0,74694,0.2209648140143296
2023-10-01,JP,Japan,0,33803572,0,74694,0.2209648140143296
2023-10-08,JP,Japan,0,33803572,0,74694,0.2209648140143296
2023-10-15,JP,Japan,0,33803572,0,74694,0.2209648140143296
2023-10-22,JP,Japan,0,33803572,0,74694,0.2209648140143296
2023-10-29,JP,Japan,0,33803572,0,74694,0.2209648140143296
2023-11-05,JP,Japan,0,33803572,0,74694,0.2209648140143296
2023-11-12,JP,Japan,0,33803572,0,74694,0.2209648140143296
2023-11-19,JP,Japan,0,33803572,0,74694,0.2209648140143296
2023-11-26,JP,Japan,0,33803572,0,74694,0.2209648140143296
2023-12-03,JP,Japan,0,33803572,0,74694,0.2209648140143296
2023-12-10,JP,Japan,0,33803572,0,74694,0.2209648140143296
2023-12-17,JP,Japan,0,33803572,0,74694,0.2209648140143296
2023-12-24,JP,Japan,0,33803572,0,74694,0.2209648140143296
2023-12-31,JP,Japan,0,33803572,0,74694,0.2209648140143296
2024-01-07,JP,Japan,0,33803572,0,74694,0.2209648140143296
2024-01-14,JP,Japan,0,33803572,0,74694,0.2209648140143296
2021-07-25,JE,Jersey,1434,7750,0,69,0.8903225806451612
2021-08-01,JE,Jersey,620,8370,0,69,0.8243727598566308
2021-08-08,JE,Jersey,280,8650,4,73,0.8439306358381502
2021-08-15,JE,Jersey,225,8875,1,74,0.8338028169014085
2021-08-22,JE,Jersey,223,9098,1,75,0.8243570015387996
2021-08-29,JE,Jersey,166,9264,2,77,0.8311744386873922
2021-09-05,JE,Jersey,187,9451,0,77,0.8147286001481325
2021-09-12,JE,Jersey,201,9652,1,78,0.8081226688769167
2021-09-19,JE,Jersey,137,9789,0,78,0.796812749003984
2021-09-26,JE,Jersey,143,9932,0,78,0.7853403141361256
2021-10-03,JE,Jersey,117,10049,0,78,0.7761966364812419
2021-10-10,JE,Jersey,164,10213,1,79,0.7735239400763733
2021-10-17,JE,Jersey,212,10425,0,79,0.7577937649880095
2021-10-24,JE,Jersey,251,10676,1,80,0.7493443237167479
2021-10-31,JE,Jersey,393,11069,0,80,0.722739181497877
2021-11-07,JE,Jersey,423,11492,0,80,0.6961364427427775
2021-11-14,JE,Jersey,681,12173,0,80,0.6571921465538487
2021-11-21,JE,Jersey,768,12941,0,80,0.618190248048837
2021-11-28,JE,Jersey,901,13842,0,80,0.5779511631267158
2021-12-05,JE,Jersey,903,14745,1,81,0.5493387589013226
2021-12-12,JE,Jersey,776,15521,3,84,0.5412022421235745
2021-12-19,JE,Jersey,809,16330,3,87,0.5327617881200245
2021-12-26,JE,Jersey,1142,17472,2,89,0.5093864468864469
2022-01-02,JE,Jersey,2770,20242,0,89,0.43967987353028354
2022-01-09,JE,Jersey,3535,23777,1,90,0.37851705429616855
2022-01-16,JE,Jersey,2375,26152,2,92,0.35178953808504126
2022-01-23,JE,Jersey,1945,28097,4,96,0.34167348827276933
2022-01-30,JE,Jersey,2381,30478,4,100,0.32810551873482513
2022-02-06,JE,Jersey,2122,32600,4,104,0.31901840490797545
2022-02-13,JE,Jersey,1758,34358,2,106,0.3085162116537633
2022-02-20,JE,Jersey,1455,35813,3,109,0.3043587524083433
2022-02-27,JE,Jersey,1459,37272,3,112,0.30049366816913503
2022-03-06,JE,Jersey,1988,39260,2,114,0.29037187977585327
2022-03-13,JE,Jersey,2122,41382,2,116,0.280315112850998
2022-03-20,JE,Jersey,2160,43542,0,116,0.2664094437554545
2022-03-27,JE,Jersey,2069,45611,3,119,0.2609019754006709
2022-04-03,JE,Jersey,1414,47025,1,120,0.2551834130781499
2022-04-10,JE,Jersey,1103,48128,1,121,0.2514128989361702
2022-04-17,JE,Jersey,794,48922,1,122,0.24937655860349126
2022-04-24,JE,Jersey,600,49522,1,123,0.24837445983603249
2022-05-01,JE,Jersey,364,49886,3,126,0.25257587299041817
2022-05-08,JE,Jersey,213,50099,1,127,0.2534980738138486
2022-05-15,JE,Jersey,211,50310,0,127,0.2524349035976943
2022-05-22,JE,Jersey,200,50510,2,129,0.2553949712928133
2022-05-29,JE,Jersey,168,50678,0,129,0.2545483247168397
2022-06-05,JE,Jersey,180,50858,0,129,0.25364741043690275
2022-06-12,JE,Jersey,470,51328,0,129,0.251324812967581
2022-06-19,JE,Jersey,616,51944,2,131,0.2521946711843524
2022-06-26,JE,Jersey,1139,53083,0,131,0.2467833392988339
2022-07-03,JE,Jersey,1395,54478,0,131,0.24046404053012227
2022-07-10,JE,Jersey,1610,56088,0,131,0.2335615461417772
2022-07-17,JE,Jersey,1079,57167,0,131,0.22915318278027533
2022-07-24,JE,Jersey,597,57764,1,132,0.22851603074579324
2022-07-31,JE,Jersey,357,58121,1,133,0.2288329519450801
2022-08-07,JE,Jersey,302,58423,2,135,0.2310733786351266
2022-08-14,JE,Jersey,199,58622,0,135,0.2302889700112586
2022-08-21,JE,Jersey,181,58803,0,135,0.2295801234630886
2022-08-28,JE,Jersey,143,58946,1,136,0.23071964170596815
2022-09-04,JE,Jersey,202,59148,0,136,0.22993169676066816
2022-09-11,JE,Jersey,229,59377,1,137,0.23072907017868874
2022-09-18,JE,Jersey,304,59681,1,138,0.23122936948107436
2022-09-25,JE,Jersey,322,60003,0,138,0.22998850057497125
2022-10-02,JE,Jersey,384,60387,1,139,0.23018199281302268
2022-10-09,JE,Jersey,408,60795,2,141,0.231926967678263
2022-10-16,JE,Jersey,368,61163,0,141,0.23053153050046596
2022-10-23,JE,Jersey,333,61496,0,141,0.2292832054117341
2022-10-30,JE,Jersey,321,61817,0,141,0.22809259588786254
2022-11-06,JE,Jersey,307,62124,0,141,0.22696542399072822
2022-11-13,JE,Jersey,302,62426,0,141,0.22586742703360776
2022-11-20,JE,Jersey,250,62676,1,142,0.22656200140404623
2022-11-27,JE,Jersey,228,62904,0,142,0.2257408113951418
2022-12-04,JE,Jersey,348,63252,0,142,0.22449883007651933
2022-12-11,JE,Jersey,583,63835,0,142,0.22244850003916347
2022-12-18,JE,Jersey,769,64604,2,144,0.22289641508265742
2022-12-25,JE,Jersey,782,65386,2,146,0.22328938916587648
2023-01-01,JE,Jersey,416,65802,0,146,0.22187775447554786
2023-01-08,JE,Jersey,271,66073,4,150,0.22702162759372208
2023-01-15,JE,Jersey,142,66215,4,154,0.2325757003700068
2023-01-22,JE,Jersey,69,66284,1,155,0.23384225454106572
2023-01-29,JE,Jersey,94,66378,2,157,0.23652414956762785
2023-02-05,JE,Jersey,13,66391,4,161,0.24250274886656326
2023-02-12,JE,Jersey,0,66391,0,161,0.24250274886656326
2023-02-19,JE,Jersey,0,66391,0,161,0.24250274886656326
2023-02-26,JE,Jersey,0,66391,0,161,0.24250274886656326
2023-03-05,JE,Jersey,0,66391,0,161,0.24250274886656326
2023-03-12,JE,Jersey,0,66391,0,161,0.24250274886656326
2023-03-19,JE,Jersey,0,66391,0,161,0.24250274886656326
2023-03-26,JE,Jersey,0,66391,0,161,0.24250274886656326
2023-04-02,JE,Jersey,0,66391,0,161,0.24250274886656326
2023-04-09,JE,Jersey,0,66391,0,161,0.24250274886656326
2023-04-16,JE,Jersey,0,66391,0,161,0.24250274886656326
2023-04-23,JE,Jersey,0,66391,0,161,0.24250274886656326
2023-04-30,JE,Jersey,0,66391,0,161,0.24250274886656326
2023-05-07,JE,Jersey,0,66391,0,161,0.24250274886656326
2023-05-14,JE,Jersey,0,66391,0,161,0.24250274886656326
2023-05-21,JE,Jersey,0,66391,0,161,0.24250274886656326
2023-05-28,JE,Jersey,0,66391,0,161,0.24250274886656326
2023-06-04,JE,Jersey,0,66391,0,161,0.24250274886656326
2023-06-11,JE,Jersey,0,66391,0,161,0.24250274886656326
2023-06-18,JE,Jersey,0,66391,0,161,0.24250274886656326
2023-06-25,JE,Jersey,0,66391,0,161,0.24250274886656326
2023-07-02,JE,Jersey,0,66391,0,161,0.24250274886656326
2023-07-09,JE,Jersey,0,66391,0,161,0.24250274886656326
2023-07-16,JE,Jersey,0,66391,0,161,0.24250274886656326
2023-07-23,JE,Jersey,0,66391,0,161,0.24250274886656326
2023-07-30,JE,Jersey,0,66391,0,161,0.24250274886656326
2023-08-06,JE,Jersey,0,66391,0,161,0.24250274886656326
2023-08-13,JE,Jersey,0,66391,0,161,0.24250274886656326
2023-08-20,JE,Jersey,0,66391,0,161,0.24250274886656326
2023-08-27,JE,Jersey,0,66391,0,161,0.24250274886656326
2023-09-03,JE,Jersey,0,66391,0,161,0.24250274886656326
2023-09-10,JE,Jersey,0,66391,0,161,0.24250274886656326
2023-09-17,JE,Jersey,0,66391,0,161,0.24250274886656326
2023-09-24,JE,Jersey,0,66391,0,161,0.24250274886656326
2023-10-01,JE,Jersey,0,66391,0,161,0.24250274886656326
2023-10-08,JE,Jersey,0,66391,0,161,0.24250274886656326
2023-10-15,JE,Jersey,0,66391,0,161,0.24250274886656326
2023-10-22,JE,Jersey,0,66391,0,161,0.24250274886656326
2023-10-29,JE,Jersey,0,66391,0,161,0.24250274886656326
2023-11-05,JE,Jersey,0,66391,0,161,0.24250274886656326
2023-11-12,JE,Jersey,0,66391,0,161,0.24250274886656326
2023-11-19,JE,Jersey,0,66391,0,161,0.24250274886656326
2023-11-26,JE,Jersey,0,66391,0,161,0.24250274886656326
2023-12-03,JE,Jersey,0,66391,0,161,0.24250274886656326
2023-12-10,JE,Jersey,0,66391,0,161,0.24250274886656326
2023-12-17,JE,Jersey,0,66391,0,161,0.24250274886656326
2023-12-24,JE,Jersey,0,66391,0,161,0.24250274886656326
2023-12-31,JE,Jersey,0,66391,0,161,0.24250274886656326
2024-01-07,JE,Jersey,0,66391,0,161,0.24250274886656326
2024-01-14,JE,Jersey,0,66391,0,161,0.24250274886656326
2020-03-29,JO,Jordan,147,246,1,1,0.40650406504065045
2020-06-28,JO,Jordan,86,968,0,9,0.9297520661157025
2020-07-12,JO,Jordan,18,1021,0,10,0.9794319294809012
2020-07-26,JO,Jordan,96,1154,0,11,0.9532062391681109
2020-08-02,JO,Jordan,54,1208,0,11,0.9105960264900662
2020-08-09,JO,Jordan,38,1246,0,11,0.8828250401284109
2020-08-16,JO,Jordan,93,1339,0,11,0.8215085884988798
2020-08-23,JO,Jordan,237,1576,0,11,0.6979695431472082
2020-08-30,JO,Jordan,317,1893,4,15,0.7923930269413629
2020-09-06,JO,Jordan,460,2353,1,16,0.6799830004249894
2020-09-13,JO,Jordan,709,3062,6,22,0.7184846505551926
2020-09-20,JO,Jordan,1478,4540,8,30,0.6607929515418502
2020-09-27,JO,Jordan,3521,8061,13,43,0.533432576603399
2020-10-04,JO,Jordan,6688,14749,45,88,0.5966506203810428
2020-10-11,JO,Jordan,9249,23998,93,181,0.7542295191265939
2020-10-18,JO,Jordan,12055,36053,149,330,0.915319113527307
2022-02-13,JO,Jordan,136567,1450810,177,13477,0.928929356704186
2022-02-20,JO,Jordan,110012,1560822,180,13657,0.8749876667550817
2022-02-27,JO,Jordan,56356,1617178,141,13798,0.853214673956732
2022-03-06,JO,Jordan,37499,1654677,84,13882,0.8389552764678544
2022-03-13,JO,Jordan,25502,1680179,77,13959,0.8308043369188641
2022-03-20,JO,Jordan,9135,1689314,44,14003,0.8289163530285075
2022-03-27,JO,Jordan,3171,1692485,28,14031,0.8290176870105199
2022-04-03,JO,Jordan,1731,1694216,17,14048,0.8291740840601198
2022-04-10,JO,Jordan,741,1694957,7,14055,0.8292245761986882
2022-04-17,JO,Jordan,475,1695432,4,14059,0.8292281849109844
2022-04-24,JO,Jordan,313,1695745,5,14064,0.8293699819253484
2022-05-01,JO,Jordan,225,1695970,2,14066,0.8293778781464294
2022-05-08,JO,Jordan,84,1696054,0,14066,0.8293368017763585
2022-05-15,JO,Jordan,305,1696359,0,14066,0.8291876896340928
2022-05-22,JO,Jordan,309,1696668,0,14066,0.8290366765920028
2022-05-29,JO,Jordan,269,1696937,0,14066,0.8289052569423614
2022-06-05,JO,Jordan,334,1697271,2,14068,0.8288599758082238
2022-06-12,JO,Jordan,402,1697673,0,14068,0.8286637061436449
2022-06-19,JO,Jordan,643,1698316,0,14068,0.8283499654952318
2022-06-26,JO,Jordan,881,1699197,0,14068,0.8279204824396464
2022-07-03,JO,Jordan,1329,1700526,0,14068,0.8272734436286184
2022-07-10,JO,Jordan,2135,1702661,1,14069,0.8262948408403081
2022-07-17,JO,Jordan,2455,1705116,1,14070,0.8251638011724716
2022-07-24,JO,Jordan,4763,1709879,4,14074,0.8230991783629134
2022-07-31,JO,Jordan,5417,1715296,9,14083,0.8210244762420015
2022-08-07,JO,Jordan,5482,1720778,7,14090,0.8188156752352715
2022-08-14,JO,Jordan,5939,1726717,5,14095,0.8162889460172107
2022-08-21,JO,Jordan,4832,1731549,10,14105,0.8145885562580094
2022-08-28,JO,Jordan,3946,1735495,5,14110,0.8130245261438379
2022-09-04,JO,Jordan,3372,1738867,4,14114,0.8116779489173123
2022-09-11,JO,Jordan,3389,1742256,0,14114,0.8100990899156036
2022-09-18,JO,Jordan,2776,1745032,2,14116,0.8089249939256128
2022-09-25,JO,Jordan,1965,1746997,6,14122,0.8083585718807761
2022-10-02,JO,Jordan,0,1746997,0,14122,0.8083585718807761
2022-10-09,JO,Jordan,0,1746997,0,14122,0.8083585718807761
2022-10-16,JO,Jordan,0,1746997,0,14122,0.8083585718807761
2022-10-23,JO,Jordan,0,1746997,0,14122,0.8083585718807761
2022-10-30,JO,Jordan,0,1746997,0,14122,0.8083585718807761
2022-11-06,JO,Jordan,0,1746997,0,14122,0.8083585718807761
2022-11-13,JO,Jordan,0,1746997,0,14122,0.8083585718807761
2022-11-20,JO,Jordan,0,1746997,0,14122,0.8083585718807761
2022-11-27,JO,Jordan,0,1746997,0,14122,0.8083585718807761
2022-12-04,JO,Jordan,0,1746997,0,14122,0.8083585718807761
2022-12-11,JO,Jordan,0,1746997,0,14122,0.8083585718807761
2022-12-18,JO,Jordan,0,1746997,0,14122,0.8083585718807761
2022-12-25,JO,Jordan,0,1746997,0,14122,0.8083585718807761
2023-01-01,JO,Jordan,0,1746997,0,14122,0.8083585718807761
2023-01-08,JO,Jordan,0,1746997,0,14122,0.8083585718807761
2023-01-15,JO,Jordan,0,1746997,0,14122,0.8083585718807761
2023-01-22,JO,Jordan,0,1746997,0,14122,0.8083585718807761
2023-01-29,JO,Jordan,0,1746997,0,14122,0.8083585718807761
2023-02-05,JO,Jordan,0,1746997,0,14122,0.8083585718807761
2023-02-12,JO,Jordan,0,1746997,0,14122,0.8083585718807761
2023-02-19,JO,Jordan,0,1746997,0,14122,0.8083585718807761
2023-02-26,JO,Jordan,0,1746997,0,14122,0.8083585718807761
2023-03-05,JO,Jordan,0,1746997,0,14122,0.8083585718807761
2023-03-12,JO,Jordan,0,1746997,0,14122,0.8083585718807761
2023-03-19,JO,Jordan,0,1746997,0,14122,0.8083585718807761
2023-03-26,JO,Jordan,0,1746997,0,14122,0.8083585718807761
2023-04-02,JO,Jordan,0,1746997,0,14122,0.8083585718807761
2023-04-09,JO,Jordan,0,1746997,0,14122,0.8083585718807761
2023-04-16,JO,Jordan,0,1746997,0,14122,0.8083585718807761
2023-04-23,JO,Jordan,0,1746997,0,14122,0.8083585718807761
2023-04-30,JO,Jordan,0,1746997,0,14122,0.8083585718807761
2023-05-07,JO,Jordan,0,1746997,0,14122,0.8083585718807761
2023-05-14,JO,Jordan,0,1746997,0,14122,0.8083585718807761
2023-05-21,JO,Jordan,0,1746997,0,14122,0.8083585718807761
2023-05-28,JO,Jordan,0,1746997,0,14122,0.8083585718807761
2023-06-04,JO,Jordan,0,1746997,0,14122,0.8083585718807761
2023-06-11,JO,Jordan,0,1746997,0,14122,0.8083585718807761
2023-06-18,JO,Jordan,0,1746997,0,14122,0.8083585718807761
2023-06-25,JO,Jordan,0,1746997,0,14122,0.8083585718807761
2023-07-02,JO,Jordan,0,1746997,0,14122,0.8083585718807761
2023-07-09,JO,Jordan,0,1746997,0,14122,0.8083585718807761
2023-07-16,JO,Jordan,0,1746997,0,14122,0.8083585718807761
2023-07-23,JO,Jordan,0,1746997,0,14122,0.8083585718807761
2023-07-30,JO,Jordan,0,1746997,0,14122,0.8083585718807761
2023-08-06,JO,Jordan,0,1746997,0,14122,0.8083585718807761
2023-08-13,JO,Jordan,0,1746997,0,14122,0.8083585718807761
2023-08-20,JO,Jordan,0,1746997,0,14122,0.8083585718807761
2023-08-27,JO,Jordan,0,1746997,0,14122,0.8083585718807761
2023-09-03,JO,Jordan,0,1746997,0,14122,0.8083585718807761
2023-09-10,JO,Jordan,0,1746997,0,14122,0.8083585718807761
2023-09-17,JO,Jordan,0,1746997,0,14122,0.8083585718807761
2023-09-24,JO,Jordan,0,1746997,0,14122,0.8083585718807761
2023-10-01,JO,Jordan,0,1746997,0,14122,0.8083585718807761
2023-10-08,JO,Jordan,0,1746997,0,14122,0.8083585718807761
2023-10-15,JO,Jordan,0,1746997,0,14122,0.8083585718807761
2023-10-22,JO,Jordan,0,1746997,0,14122,0.8083585718807761
2023-10-29,JO,Jordan,0,1746997,0,14122,0.8083585718807761
2023-11-05,JO,Jordan,0,1746997,0,14122,0.8083585718807761
2023-11-12,JO,Jordan,0,1746997,0,14122,0.8083585718807761
2023-11-19,JO,Jordan,0,1746997,0,14122,0.8083585718807761
2023-11-26,JO,Jordan,0,1746997,0,14122,0.8083585718807761
2023-12-03,JO,Jordan,0,1746997,0,14122,0.8083585718807761
2023-12-10,JO,Jordan,0,1746997,0,14122,0.8083585718807761
2023-12-17,JO,Jordan,0,1746997,0,14122,0.8083585718807761
2023-12-24,JO,Jordan,0,1746997,0,14122,0.8083585718807761
2023-12-31,JO,Jordan,0,1746997,0,14122,0.8083585718807761
2024-01-07,JO,Jordan,0,1746997,0,14122,0.8083585718807761
2024-01-14,JO,Jordan,0,1746997,0,14122,0.8083585718807761
2020-03-29,KZ,Kazakhstan,227,284,1,1,0.35211267605633806
2020-04-05,KZ,Kazakhstan,247,531,4,5,0.9416195856873822
2020-04-26,KZ,Kazakhstan,974,2601,6,25,0.9611687812379853
2020-05-03,KZ,Kazakhstan,1276,3877,1,26,0.670621614650503
2020-05-10,KZ,Kazakhstan,1179,5056,5,31,0.613132911392405
2020-05-17,KZ,Kazakhstan,1101,6157,3,34,0.5522169887932434
2020-05-24,KZ,Kazakhstan,2165,8322,1,35,0.4205719778899303
2020-05-31,KZ,Kazakhstan,2536,10858,3,38,0.3499723706023209
2020-06-07,KZ,Kazakhstan,1836,12694,16,54,0.4253978257444462
2020-06-14,KZ,Kazakhstan,1802,14496,19,73,0.5035871964679911
2020-06-21,KZ,Kazakhstan,3345,17841,45,118,0.6613979037049492
2020-06-28,KZ,Kazakhstan,10222,28063,55,173,0.6164700851655204
2020-07-05,KZ,Kazakhstan,19108,47171,69,242,0.5130270717177927
2020-07-12,KZ,Kazakhstan,11082,58253,110,352,0.6042607247695397
2020-07-19,KZ,Kazakhstan,12086,70339,23,375,0.533132401654843
2020-07-26,KZ,Kazakhstan,11381,81720,210,585,0.7158590308370044
2020-08-02,KZ,Kazakhstan,15054,96774,238,823,0.8504350342034018
2022-02-13,KI,Kiribati,1005,2548,3,3,0.11773940345368916
2022-02-20,KI,Kiribati,285,2833,8,11,0.3882809742322626
2022-02-27,KI,Kiribati,81,2914,0,11,0.3774879890185312
2022-03-06,KI,Kiribati,71,2985,0,11,0.3685092127303182
2022-03-13,KI,Kiribati,42,3027,2,13,0.4294681202510736
2022-03-20,KI,Kiribati,22,3049,0,13,0.42636930141029844
2022-03-27,KI,Kiribati,16,3065,0,13,0.4241435562805873
2022-04-03,KI,Kiribati,2,3067,0,13,0.42386697098141507
2022-04-10,KI,Kiribati,2,3069,0,13,0.4235907461713913
2022-04-17,KI,Kiribati,0,3069,0,13,0.4235907461713913
2022-04-24,KI,Kiribati,7,3076,0,13,0.42262678803641096
2022-05-01,KI,Kiribati,8,3084,0,13,0.42153047989623865
2022-05-08,KI,Kiribati,5,3089,0,13,0.4208481709291033
2022-05-15,KI,Kiribati,4,3093,0,13,0.42030391205948914
2022-05-22,KI,Kiribati,5,3098,0,13,0.4196255648805681
2022-05-29,KI,Kiribati,0,3098,0,13,0.4196255648805681
2022-06-05,KI,Kiribati,0,3098,0,13,0.4196255648805681
2022-06-12,KI,Kiribati,111,3209,0,13,0.40511062636335304
2022-06-19,KI,Kiribati,6,3215,0,13,0.4043545878693624
2022-06-26,KI,Kiribati,21,3236,0,13,0.40173053152039556
2022-07-03,KI,Kiribati,0,3236,0,13,0.40173053152039556
2022-07-10,KI,Kiribati,0,3236,0,13,0.40173053152039556
2022-07-17,KI,Kiribati,0,3236,0,13,0.40173053152039556
2022-07-24,KI,Kiribati,194,3430,0,13,0.37900874635568516
2022-07-31,KI,Kiribati,0,3430,0,13,0.37900874635568516
2022-08-07,KI,Kiribati,0,3430,0,13,0.37900874635568516
2022-08-14,KI,Kiribati,0,3430,0,13,0.37900874635568516
2022-08-21,KI,Kiribati,0,3430,0,13,0.37900874635568516
2022-08-28,KI,Kiribati,0,3430,0,13,0.37900874635568516
2022-09-04,KI,Kiribati,0,3430,0,13,0.37900874635568516
2022-09-11,KI,Kiribati,0,3430,0,13,0.37900874635568516
2022-09-18,KI,Kiribati,0,3430,0,13,0.37900874635568516
2022-09-25,KI,Kiribati,0,3430,0,13,0.37900874635568516
2022-10-02,KI,Kiribati,0,3430,0,13,0.37900874635568516
2022-10-09,KI,Kiribati,0,3430,0,13,0.37900874635568516
2022-10-16,KI,Kiribati,0,3430,0,13,0.37900874635568516
2022-10-23,KI,Kiribati,0,3430,0,13,0.37900874635568516
2022-10-30,KI,Kiribati,0,3430,0,13,0.37900874635568516
2022-11-06,KI,Kiribati,0,3430,0,13,0.37900874635568516
2022-11-13,KI,Kiribati,0,3430,0,13,0.37900874635568516
2022-11-20,KI,Kiribati,0,3430,0,13,0.37900874635568516
2022-11-27,KI,Kiribati,0,3430,0,13,0.37900874635568516
2022-12-04,KI,Kiribati,0,3430,0,13,0.37900874635568516
2022-12-11,KI,Kiribati,0,3430,0,13,0.37900874635568516
2022-12-18,KI,Kiribati,0,3430,0,13,0.37900874635568516
2022-12-25,KI,Kiribati,0,3430,0,13,0.37900874635568516
2023-01-01,KI,Kiribati,0,3430,0,13,0.37900874635568516
2023-01-08,KI,Kiribati,0,3430,0,13,0.37900874635568516
2023-01-15,KI,Kiribati,1491,4921,0,13,0.2641739483844747
2023-01-22,KI,Kiribati,70,4991,0,13,0.2604688439190543
2023-01-29,KI,Kiribati,17,5008,0,13,0.2595846645367412
2023-02-05,KI,Kiribati,0,5008,5,18,0.35942492012779553
2023-02-12,KI,Kiribati,4,5012,0,18,0.3591380686352753
2023-02-19,KI,Kiribati,0,5012,0,18,0.3591380686352753
2023-02-26,KI,Kiribati,1,5013,0,18,0.3590664272890485
2023-03-05,KI,Kiribati,1,5014,0,18,0.35899481451934584
2023-03-12,KI,Kiribati,0,5014,0,18,0.35899481451934584
2023-03-19,KI,Kiribati,0,5014,0,18,0.35899481451934584
2023-03-26,KI,Kiribati,0,5014,0,18,0.35899481451934584
2023-04-02,KI,Kiribati,0,5014,0,18,0.35899481451934584
2023-04-09,KI,Kiribati,0,5014,0,18,0.35899481451934584
2023-04-16,KI,Kiribati,0,5014,0,18,0.35899481451934584
2023-04-23,KI,Kiribati,11,5025,6,24,0.47761194029850745
2023-04-30,KI,Kiribati,0,5025,0,24,0.47761194029850745
2023-05-07,KI,Kiribati,0,5025,0,24,0.47761194029850745
2023-05-14,KI,Kiribati,0,5025,0,24,0.47761194029850745
2023-05-21,KI,Kiribati,2,5027,0,24,0.4774219216232345
2023-05-28,KI,Kiribati,2,5029,0,24,0.4772320540862995
2023-06-04,KI,Kiribati,8,5037,0,24,0.4764740917212627
2023-06-11,KI,Kiribati,0,5037,0,24,0.4764740917212627
2023-06-18,KI,Kiribati,0,5037,0,24,0.4764740917212627
2023-06-25,KI,Kiribati,44,5081,0,24,0.4723479629994096
2023-07-02,KI,Kiribati,0,5081,0,24,0.4723479629994096
2023-07-09,KI,Kiribati,1,5082,0,24,0.47225501770956313
2023-07-16,KI,Kiribati,0,5082,0,24,0.47225501770956313
2023-07-23,KI,Kiribati,0,5082,0,24,0.47225501770956313
2023-07-30,KI,Kiribati,0,5082,0,24,0.47225501770956313
2023-08-06,KI,Kiribati,0,5082,0,24,0.47225501770956313
2023-08-13,KI,Kiribati,3,5085,0,24,0.471976401179941
2023-08-20,KI,Kiribati,0,5085,0,24,0.471976401179941
2023-08-27,KI,Kiribati,0,5085,0,24,0.471976401179941
2023-09-03,KI,Kiribati,0,5085,0,24,0.471976401179941
2023-09-10,KI,Kiribati,0,5085,0,24,0.471976401179941
2023-09-17,KI,Kiribati,0,5085,0,24,0.471976401179941
2023-09-24,KI,Kiribati,0,5085,0,24,0.471976401179941
2023-10-01,KI,Kiribati,0,5085,0,24,0.471976401179941
2023-10-08,KI,Kiribati,0,5085,0,24,0.471976401179941
2023-10-15,KI,Kiribati,0,5085,0,24,0.471976401179941
2023-10-22,KI,Kiribati,0,5085,0,24,0.471976401179941
2023-10-29,KI,Kiribati,0,5085,0,24,0.471976401179941
2023-11-05,KI,Kiribati,0,5085,0,24,0.471976401179941
2023-11-12,KI,Kiribati,0,5085,0,24,0.471976401179941
2023-11-19,KI,Kiribati,0,5085,0,24,0.471976401179941
2023-11-26,KI,Kiribati,0,5085,0,24,0.471976401179941
2023-12-03,KI,Kiribati,0,5085,0,24,0.471976401179941
2023-12-10,KI,Kiribati,0,5085,0,24,0.471976401179941
2023-12-17,KI,Kiribati,0,5085,0,24,0.471976401179941
2023-12-24,KI,Kiribati,0,5085,0,24,0.471976401179941
2023-12-31,KI,Kiribati,0,5085,0,24,0.471976401179941
2024-01-07,KI,Kiribati,0,5085,0,24,0.471976401179941
2024-01-14,KI,Kiribati,0,5085,0,24,0.471976401179941
2020-04-05,XK,Kosovo (in accordance with UN Security Council resolution 1244 (1999)),49,140,0,1,0.7142857142857143
2020-04-12,KW,Kuwait,675,1154,1,1,0.08665511265164644
2020-04-19,KW,Kuwait,597,1751,5,6,0.34266133637921187
2020-04-26,KW,Kuwait,1141,2892,13,19,0.656984785615491
2020-05-03,KW,Kuwait,1727,4619,14,33,0.7144403550552068
2020-05-10,KW,Kuwait,3004,7623,16,49,0.642791551882461
2020-05-17,KW,Kuwait,6179,13802,58,107,0.7752499637733662
2020-05-24,KW,Kuwait,6662,20464,41,148,0.7232212666145427
2020-05-31,KW,Kuwait,5728,26192,57,205,0.7826817348808796
2020-06-07,KW,Kuwait,4939,31131,49,254,0.815906973756063
2020-06-14,KW,Kuwait,4335,35466,35,289,0.8148649410703208
2020-06-21,KW,Kuwait,3679,39145,30,319,0.8149188913015711
2020-06-28,KW,Kuwait,5246,44391,25,344,0.7749318555563065
2020-07-05,KW,Kuwait,4912,49303,21,365,0.7403200616595339
2020-07-12,KW,Kuwait,4755,54058,21,386,0.7140478745051612
2020-07-19,KW,Kuwait,4846,58904,21,407,0.6909547738693468
2020-07-26,KW,Kuwait,4405,63309,22,429,0.6776287731602142
2020-08-02,KW,Kuwait,4139,67448,24,453,0.6716285138180524
2020-08-09,KW,Kuwait,3751,71199,21,474,0.6657396873551595
2020-08-16,KW,Kuwait,4498,75697,24,498,0.6578860456821274
2020-08-23,KW,Kuwait,4260,79957,15,513,0.6415948572357643
2020-08-30,KW,Kuwait,4267,84224,15,528,0.6268996960486323
2020-09-06,KW,Kuwait,4739,88963,12,540,0.6069939188201837
2020-09-13,KW,Kuwait,5248,94211,18,558,0.5922875248113277
2020-09-20,KW,Kuwait,4838,99049,23,581,0.5865783602055548
2020-09-27,KW,Kuwait,4150,103199,16,597,0.5784939776548222
2020-10-04,KW,Kuwait,3259,106458,23,620,0.5823892990662984
2020-10-11,KW,Kuwait,4110,110568,35,655,0.5923956298386513
2020-10-18,KW,Kuwait,4915,115483,39,694,0.6009542530069361
2020-10-25,KW,Kuwait,5444,120927,50,744,0.6152472152621002
2020-11-01,KW,Kuwait,4999,125926,35,779,0.6186172831663039
2020-11-08,KW,Kuwait,5279,131205,29,808,0.61583018939827
2020-11-15,KW,Kuwait,5136,136341,27,835,0.6124349975429255
2020-11-22,KW,Kuwait,3393,139734,28,863,0.6176020152575609
2020-11-29,KW,Kuwait,2461,142195,12,875,0.6153521572488484
2020-12-06,KW,Kuwait,1969,144164,14,889,0.6166588052495768
2020-12-13,KW,Kuwait,1880,146044,22,911,0.6237846128563994
2020-12-20,KW,Kuwait,1731,147775,7,918,0.6212146844865505
2020-12-27,KW,Kuwait,1674,149449,11,929,0.621616738820601
2021-01-03,KW,Kuwait,1625,151074,8,937,0.6202258495836477
2021-01-10,KW,Kuwait,2826,153900,5,942,0.6120857699805069
2021-01-17,KW,Kuwait,3499,157399,5,947,0.6016556649025725
2021-01-24,KW,Kuwait,3502,160901,5,952,0.591668168625428
2021-01-31,KW,Kuwait,3721,164622,7,959,0.5825466827034054
2021-02-07,KW,Kuwait,5414,170036,5,964,0.5669387659083959
2021-02-14,KW,Kuwait,6867,176903,34,998,0.5641509753932947
2021-02-21,KW,Kuwait,6419,183322,41,1039,0.5667623089427347
2021-02-28,KW,Kuwait,6568,189890,39,1078,0.5676970877876666
2021-03-07,KW,Kuwait,9538,199428,42,1120,0.5616061937140221
2021-03-14,KW,Kuwait,9032,208460,45,1165,0.5588602129905018
2021-03-21,KW,Kuwait,9473,217933,50,1215,0.5575107946020107
2021-03-28,KW,Kuwait,9245,227178,64,1279,0.5629946561726927
2021-04-04,KW,Kuwait,8811,235989,60,1339,0.5673993279347765
2021-04-11,KW,Kuwait,9715,245704,64,1403,0.571012274932439
2021-04-18,KW,Kuwait,10156,255860,37,1440,0.5628077855076995
2021-04-25,KW,Kuwait,9544,265404,71,1511,0.5693207336739461
2021-05-02,KW,Kuwait,9866,275270,58,1569,0.5699858320921277
2021-05-09,KW,Kuwait,8806,284076,66,1635,0.5755502048747518
2021-05-16,KW,Kuwait,6725,290801,52,1687,0.5801218015068724
2021-05-23,KW,Kuwait,7422,298223,37,1724,0.5780908917152601
2021-05-30,KW,Kuwait,8494,306717,40,1764,0.5751229961169416
2021-06-06,KW,Kuwait,9183,315900,30,1794,0.5679012345679012
2021-06-13,KW,Kuwait,10551,326451,23,1817,0.5565919540758031
2021-06-20,KW,Kuwait,10920,337371,45,1862,0.5519146577506662
2021-06-27,KW,Kuwait,12552,349923,57,1919,0.5484063636857252
2021-07-04,KW,Kuwait,12095,362018,86,2005,0.553839864316139
2021-07-11,KW,Kuwait,12086,374104,95,2100,0.5613412313153561
2021-07-18,KW,Kuwait,10469,384573,111,2211,0.5749233565538923
2021-07-25,KW,Kuwait,7208,391781,68,2279,0.581702532792555
2021-08-01,KW,Kuwait,6050,397831,41,2320,0.5831621970133046
2021-08-08,KW,Kuwait,4963,402794,46,2366,0.5873970317333426
2021-08-15,KW,Kuwait,3440,406234,20,2386,0.5873462093276289
2021-08-22,KW,Kuwait,1844,408078,17,2403,0.5888580124387984
2021-08-29,KW,Kuwait,1285,409363,13,2416,0.5901852390176934
2021-09-05,KW,Kuwait,907,410270,7,2423,0.5905866868159992
2021-09-12,KW,Kuwait,464,410734,7,2430,0.5916237759717968
2021-09-19,KW,Kuwait,390,411124,8,2438,0.5930084354112141
2021-09-26,KW,Kuwait,323,411447,7,2445,0.5942442161444852
2021-10-03,KW,Kuwait,284,411731,6,2451,0.595291586011255
2021-10-10,KW,Kuwait,317,412048,3,2454,0.5955616821341203
2021-10-17,KW,Kuwait,249,412297,2,2456,0.5956870896465412
2021-10-24,KW,Kuwait,209,412506,4,2460,0.596354962109642
2021-10-31,KW,Kuwait,147,412653,1,2461,0.5963848560412743
2021-11-07,KW,Kuwait,168,412821,1,2462,0.5963843893600375
2021-11-14,KW,Kuwait,161,412982,0,2462,0.5961518903971601
2021-11-21,KW,Kuwait,138,413120,2,2464,0.5964368706429125
2021-11-28,KW,Kuwait,146,413266,1,2465,0.5964681343251078
2021-12-05,KW,Kuwait,198,413464,0,2465,0.5961824971460635
2021-12-12,KW,Kuwait,208,413672,1,2466,0.5961244657603125
2021-12-19,KW,Kuwait,351,414023,0,2466,0.5956190839639344
2021-12-26,KW,Kuwait,888,414911,2,2468,0.5948263603519791
2022-01-02,KW,Kuwait,2812,417723,0,2468,0.5908221476911734
2022-01-09,KW,Kuwait,13197,430920,3,2471,0.573424301494477
2022-01-16,KW,Kuwait,29908,460828,4,2475,0.537076740128638
2022-01-23,KW,Kuwait,32279,493107,10,2485,0.5039474191199882
2022-01-30,KW,Kuwait,40955,534062,9,2494,0.46698697903988673
2022-02-06,KW,Kuwait,40525,574587,14,2508,0.4364874248808275
2022-02-13,KW,Kuwait,24452,599039,11,2519,0.42050684513028364
2022-02-20,KW,Kuwait,12781,611820,9,2528,0.41319342290216077
2022-02-27,KW,Kuwait,6883,618703,8,2536,0.40988972091617465
2022-03-06,KW,Kuwait,3786,622489,8,2544,0.4086819204837355
2022-03-13,KW,Kuwait,2972,625461,6,2550,0.4076992810103268
2022-03-20,KW,Kuwait,1682,627143,3,2553,0.40708418973025284
2022-03-27,KW,Kuwait,1317,628460,0,2553,0.40623110460490724
2022-04-03,KW,Kuwait,1065,629525,1,2554,0.40570271236249555
2022-04-10,KW,Kuwait,797,630322,1,2555,0.4053483774959465
2022-04-17,KW,Kuwait,624,630946,0,2555,0.40494749154444276
2022-04-24,KW,Kuwait,463,631409,0,2555,0.4046505513858687
2022-05-01,KW,Kuwait,319,631728,0,2555,0.40444621735936986
2022-05-08,KW,Kuwait,201,631929,0,2555,0.40431757365147036
2022-05-15,KW,Kuwait,440,632369,0,2555,0.4040362509863703
2022-05-22,KW,Kuwait,412,632781,0,2555,0.4037731853516462
2022-05-29,KW,Kuwait,535,633316,0,2555,0.40343209393099183
2022-06-05,KW,Kuwait,851,634167,0,2555,0.40289072121381275
2022-06-12,KW,Kuwait,1701,635868,0,2555,0.4018129548900086
2022-06-19,KW,Kuwait,2840,638708,0,2555,0.4000263030993819
2022-06-26,KW,Kuwait,3277,641985,0,2555,0.39798437658200736
2022-07-03,KW,Kuwait,3130,645115,0,2555,0.39605341683265777
2022-07-10,KW,Kuwait,2820,647935,1,2556,0.39448401460022997
2022-07-17,KW,Kuwait,2150,650085,2,2558,0.3934870055454287
2022-07-24,KW,Kuwait,2935,653020,1,2559,0.3918716118955009
2022-07-31,KW,Kuwait,1651,654671,3,2562,0.3913416051726746
2022-08-07,KW,Kuwait,1061,655732,0,2562,0.39070839916307276
2022-08-14,KW,Kuwait,724,656456,1,2563,0.3904298231716977
2022-08-21,KW,Kuwait,586,657042,0,2563,0.390081608177255
2022-08-28,KW,Kuwait,353,657395,0,2563,0.38987214688277216
2022-09-04,KW,Kuwait,350,657745,0,2563,0.3896646876829166
2022-09-11,KW,Kuwait,396,658141,0,2563,0.3894302284768765
2022-09-18,KW,Kuwait,576,658717,0,2563,0.38908970012919053
2022-09-25,KW,Kuwait,627,659344,0,2563,0.38871969715353444
2022-10-02,KW,Kuwait,579,659923,1,2564,0.38853017700549913
2022-10-09,KW,Kuwait,744,660667,0,2564,0.3880926397110798
2022-10-16,KW,Kuwait,666,661333,1,2565,0.38785301807107764
2022-10-23,KW,Kuwait,454,661787,1,2566,0.38773804864707223
2022-10-30,KW,Kuwait,336,662123,3,2569,0.3879943756673609
2022-11-06,KW,Kuwait,236,662359,0,2569,0.38785613239949934
2022-11-13,KW,Kuwait,165,662524,1,2570,0.3879104756959748
2022-11-20,KW,Kuwait,107,662631,0,2570,0.38784783688055646
2022-11-27,KW,Kuwait,96,662727,0,2570,0.3877916547839457
2022-12-04,KW,Kuwait,61,662788,0,2570,0.387755964199714
2022-12-11,KW,Kuwait,70,662858,0,2570,0.3877150158857553
2022-12-18,KW,Kuwait,0,662858,0,2570,0.3877150158857553
2022-12-25,KW,Kuwait,60,662918,0,2570,0.3876799242138545
2023-01-01,KW,Kuwait,52,662970,0,2570,0.3876495165693772
2023-01-08,KW,Kuwait,48,663018,0,2570,0.387621452207934
2023-01-15,KW,Kuwait,63,663081,0,2570,0.38758462389964426
2023-01-22,KW,Kuwait,65,663146,0,2570,0.38754663377295495
2023-01-29,KW,Kuwait,0,663146,0,2570,0.38754663377295495
2023-02-05,KW,Kuwait,0,663146,0,2570,0.38754663377295495
2023-02-12,KW,Kuwait,128,663274,0,2570,0.3874718442152112
2023-02-19,KW,Kuwait,182,663456,0,2570,0.38736555250084403
2023-02-26,KW,Kuwait,0,663456,0,2570,0.38736555250084403
2023-03-05,KW,Kuwait,403,663859,0,2570,0.3871303996782449
2023-03-12,KW,Kuwait,543,664402,0,2570,0.3868140071823986
2023-03-19,KW,Kuwait,370,664772,0,2570,0.38659871354389175
2023-03-26,KW,Kuwait,350,665122,0,2570,0.38639527785879885
2023-04-02,KW,Kuwait,264,665386,0,2570,0.3862419708259567
2023-04-09,KW,Kuwait,141,665527,0,2570,0.3861601407606303
2023-04-16,KW,Kuwait,118,665645,0,2570,0.38609168550804107
2023-04-23,KW,Kuwait,96,665741,0,2570,0.38603601100127527
2023-04-30,KW,Kuwait,61,665802,0,2570,0.3860006428337554
2023-05-07,KW,Kuwait,49,665851,0,2570,0.38597223703200867
2023-05-14,KW,Kuwait,34,665885,0,2570,0.3859525293406519
2023-05-21,KW,Kuwait,24,665909,0,2570,0.3859386192407671
2023-05-28,KW,Kuwait,22,665931,0,2570,0.3859258691966585
2023-06-04,KW,Kuwait,11,665942,0,2570,0.38591949449051116
2023-06-11,KW,Kuwait,13,665955,0,2570,0.3859119610183871
2023-06-18,KW,Kuwait,12,665967,0,2570,0.38590500730516675
2023-06-25,KW,Kuwait,7,665974,0,2570,0.3859009510881806
2023-07-02,KW,Kuwait,8,665982,0,2570,0.385896315516035
2023-07-09,KW,Kuwait,23,666005,0,2570,0.38588298886644995
2023-07-16,KW,Kuwait,6,666011,0,2570,0.3858795125005443
2023-07-23,KW,Kuwait,0,666011,0,2570,0.3858795125005443
2023-07-30,KW,Kuwait,0,666011,0,2570,0.3858795125005443
2023-08-06,KW,Kuwait,10,666021,0,2570,0.3858737186965576
2023-08-13,KW,Kuwait,22,666043,0,2570,0.38586097294018556
2023-08-20,KW,Kuwait,38,666081,0,2570,0.38583895952594355
2023-08-27,KW,Kuwait,42,666123,0,2570,0.3858146318322592
2023-09-03,KW,Kuwait,30,666153,0,2570,0.3857972567863539
2023-09-10,KW,Kuwait,53,666206,0,2570,0.38576656469620507
2023-09-17,KW,Kuwait,78,666284,0,2570,0.38572140408594535
2023-09-24,KW,Kuwait,0,666284,0,2570,0.38572140408594535
2023-10-01,KW,Kuwait,49,666333,0,2570,0.3856930393662028
2023-10-08,KW,Kuwait,58,666391,0,2570,0.38565947019092395
2023-10-15,KW,Kuwait,41,666432,0,2570,0.3856357437818112
2023-10-22,KW,Kuwait,28,666460,0,2570,0.385619542058038
2023-10-29,KW,Kuwait,26,666486,0,2570,0.38560449881918
2023-11-05,KW,Kuwait,15,666501,0,2570,0.3855958205614095
2023-11-12,KW,Kuwait,11,666512,0,2570,0.38558945675396694
2023-11-19,KW,Kuwait,8,666520,0,2570,0.3855848286623057
2023-11-26,KW,Kuwait,9,666529,0,2570,0.38557962219198266
2023-12-03,KW,Kuwait,9,666538,0,2570,0.38557441586226143
2023-12-10,KW,Kuwait,13,666551,0,2570,0.3855668958564311
2023-12-17,KW,Kuwait,0,666551,0,2570,0.3855668958564311
2023-12-24,KW,Kuwait,35,666586,0,2570,0.3855466511447885
2023-12-31,KW,Kuwait,0,666586,0,2570,0.3855466511447885
2024-01-07,KW,Kuwait,67,666653,0,2570,0.3855079029120097
2024-01-14,KW,Kuwait,103,666756,0,2570,0.3854483499211106
2021-06-27,KG,Kyrgyzstan,6331,6331,45,45,0.710788185120834
2021-07-04,KG,Kyrgyzstan,10124,16455,64,109,0.6624126405347919
2021-07-11,KG,Kyrgyzstan,8908,25363,67,176,0.69392422032094
2021-07-18,KG,Kyrgyzstan,9338,34701,73,249,0.7175585717990836
2021-07-25,KG,Kyrgyzstan,7804,42505,75,324,0.7622632631455123
2021-08-01,KG,Kyrgyzstan,6623,49128,83,407,0.8284481354828203
2021-08-08,KG,Kyrgyzstan,4757,53885,63,470,0.8722278927345272
2021-08-15,KG,Kyrgyzstan,2827,56712,44,514,0.9063337565241923
2021-08-22,KG,Kyrgyzstan,1821,58533,38,552,0.9430577622879401
2021-08-29,KG,Kyrgyzstan,1441,59974,35,587,0.9787574615666789
2021-05-09,LA,Lao People's Democratic Republic,362,1242,1,1,0.08051529790660225
2021-05-16,LA,Lao People's Democratic Republic,289,1531,1,2,0.13063357282821686
2021-05-23,LA,Lao People's Democratic Republic,210,1741,0,2,0.11487650775416428
2021-05-30,LA,Lao People's Democratic Republic,110,1851,1,3,0.1620745542949757
2021-06-06,LA,Lao People's Democratic Republic,52,1903,0,3,0.1576458223857068
2021-06-13,LA,Lao People's Democratic Republic,33,1936,0,3,0.15495867768595042
2021-06-20,LA,Lao People's Democratic Republic,57,1993,0,3,0.15052684395383845
2021-06-27,LA,Lao People's Democratic Republic,57,2050,0,3,0.14634146341463414
2021-07-04,LA,Lao People's Democratic Republic,194,2244,0,3,0.1336898395721925
2021-07-11,LA,Lao People's Democratic Republic,475,2719,0,3,0.11033468186833395
2021-07-18,LA,Lao People's Democratic Republic,707,3426,2,5,0.14594279042615294
2021-07-25,LA,Lao People's Democratic Republic,1336,4762,0,5,0.10499790004199916
2021-08-01,LA,Lao People's Democratic Republic,1804,6566,2,7,0.10660980810234541
2021-08-08,LA,Lao People's Democratic Republic,1825,8391,1,8,0.09534024550113217
2021-08-15,LA,Lao People's Democratic Republic,1701,10092,1,9,0.089179548156956
2021-08-22,LA,Lao People's Democratic Republic,2377,12469,2,11,0.08821878258080039
2021-08-29,LA,Lao People's Democratic Republic,2172,14641,1,12,0.08196161464380848
2021-09-05,LA,Lao People's Democratic Republic,1292,15933,4,16,0.10042051088934914
2021-09-12,LA,Lao People's Democratic Republic,1424,17357,0,16,0.09218182865702598
2021-09-19,LA,Lao People's Democratic Republic,1828,19185,0,16,0.0833984884023977
2021-09-26,LA,Lao People's Democratic Republic,2634,21819,0,16,0.07333058343645446
2021-10-03,LA,Lao People's Democratic Republic,3398,25217,6,22,0.08724273307689258
2021-10-10,LA,Lao People's Democratic Republic,3323,28540,4,26,0.09110021023125438
2021-10-17,LA,Lao People's Democratic Republic,3489,32029,14,40,0.12488682131818041
2021-10-24,LA,Lao People's Democratic Republic,3604,35633,12,52,0.1459321415541773
2021-10-31,LA,Lao People's Democratic Republic,4638,40271,13,65,0.16140647115790518
2021-11-07,LA,Lao People's Democratic Republic,6785,47056,17,82,0.17426045562733763
2021-11-14,LA,Lao People's Democratic Republic,7136,54192,17,99,0.18268379096545614
2021-11-21,LA,Lao People's Democratic Republic,7968,62160,33,132,0.21235521235521237
2021-11-28,LA,Lao People's Democratic Republic,9358,71518,27,159,0.22232165329008083
2021-12-05,LA,Lao People's Democratic Republic,8315,79833,48,207,0.25929127052722556
2021-12-12,LA,Lao People's Democratic Republic,9487,89320,40,247,0.27653381101656965
2021-12-19,LA,Lao People's Democratic Republic,9252,98572,26,273,0.27695491620338436
2021-12-26,LA,Lao People's Democratic Republic,7659,106231,52,325,0.30593706168632506
2022-01-02,LA,Lao People's Democratic Republic,6536,112767,55,380,0.33697801661833693
2022-01-09,LA,Lao People's Democratic Republic,6113,118880,57,437,0.36759757738896365
2022-01-16,LA,Lao People's Democratic Republic,5851,124731,58,495,0.39685402987228513
2022-01-23,LA,Lao People's Democratic Republic,5222,129953,31,526,0.4047617215454818
2022-01-30,LA,Lao People's Democratic Republic,3571,133524,18,544,0.4074173931278272
2022-02-06,LA,Lao People's Democratic Republic,2914,136438,30,574,0.42070390946803676
2022-02-13,LA,Lao People's Democratic Republic,2590,139028,20,594,0.42725206433236473
2022-02-20,LA,Lao People's Democratic Republic,2055,141083,16,610,0.4323695980380344
2022-02-27,LA,Lao People's Democratic Republic,1526,142609,11,621,0.43545638774551393
2022-03-06,LA,Lao People's Democratic Republic,1546,144155,8,629,0.4363358884534009
2022-03-13,LA,Lao People's Democratic Republic,2173,146328,11,640,0.4373735717019299
2022-03-20,LA,Lao People's Democratic Republic,6629,152957,5,645,0.42168714083042946
2022-03-27,LA,Lao People's Democratic Republic,15036,167993,16,661,0.39346877548469283
2022-04-03,LA,Lao People's Democratic Republic,15567,183560,10,671,0.36554804968402704
2022-04-10,LA,Lao People's Democratic Republic,11905,195465,0,671,0.3432839638810017
2022-04-17,LA,Lao People's Democratic Republic,4725,200190,0,671,0.3351815775013737
2022-04-24,LA,Lao People's Democratic Republic,5080,205270,0,671,0.3268865396794466
2022-05-01,LA,Lao People's Democratic Republic,2338,207608,0,671,0.3232052714731609
2022-05-08,LA,Lao People's Democratic Republic,1221,208829,0,671,0.3213155261003022
2022-05-15,LA,Lao People's Democratic Republic,605,209434,0,671,0.3203873296599406
2022-05-22,LA,Lao People's Democratic Republic,294,209728,0,671,0.3199382056759231
2022-05-29,LA,Lao People's Democratic Republic,237,209965,0,671,0.3195770723692044
2022-06-05,LA,Lao People's Democratic Republic,116,210081,0,671,0.31940061214483934
2022-06-12,LA,Lao People's Democratic Republic,66,210147,0,671,0.3193002993142895
2022-06-19,LA,Lao People's Democratic Republic,56,210203,0,671,0.3192152347968393
2022-06-26,LA,Lao People's Democratic Republic,44,210247,0,671,0.319148430179741
2022-07-03,LA,Lao People's Democratic Republic,59,210306,0,671,0.3190588951337575
2022-07-10,LA,Lao People's Democratic Republic,55,210361,0,671,0.31897547549213023
2022-07-17,LA,Lao People's Democratic Republic,149,210510,0,671,0.3187497031019904
2022-07-24,LA,Lao People's Democratic Republic,256,210766,0,671,0.3183625442433789
2022-07-31,LA,Lao People's Democratic Republic,426,211192,0,671,0.317720368195765
2022-08-07,LA,Lao People's Democratic Republic,579,211771,0,671,0.3168516935746632
2022-08-14,LA,Lao People's Democratic Republic,552,212323,0,671,0.3160279385652991
2022-08-21,LA,Lao People's Democratic Republic,834,213157,0,671,0.31479144480359544
2022-08-28,LA,Lao People's Democratic Republic,581,213738,0,671,0.3139357531183037
2022-09-04,LA,Lao People's Democratic Republic,619,214357,0,671,0.3130291989531483
2022-09-11,LA,Lao People's Democratic Republic,540,214897,0,671,0.3122426092500128
2022-09-18,LA,Lao People's Democratic Republic,494,215391,0,671,0.3115264797507788
2022-09-25,LA,Lao People's Democratic Republic,300,215691,0,671,0.3110931842311455
2022-10-02,LA,Lao People's Democratic Republic,169,215860,0,671,0.31084962475678685
2022-10-09,LA,Lao People's Democratic Republic,133,215993,0,671,0.3106582157755112
2022-10-16,LA,Lao People's Democratic Republic,95,216088,0,671,0.31052163933212396
2022-10-23,LA,Lao People's Democratic Republic,85,216173,0,671,0.310399541108279
2022-10-30,LA,Lao People's Democratic Republic,56,216229,0,671,0.31031915238011554
2022-11-06,LA,Lao People's Democratic Republic,48,216277,0,671,0.31025028088978485
2022-11-13,LA,Lao People's Democratic Republic,78,216355,0,671,0.310138429895311
2022-11-20,LA,Lao People's Democratic Republic,105,216460,0,671,0.30998798854291787
2022-11-27,LA,Lao People's Democratic Republic,132,216592,0,671,0.3097990692176996
2022-12-04,LA,Lao People's Democratic Republic,218,216810,0,671,0.30948756976154235
2022-12-11,LA,Lao People's Democratic Republic,335,217145,0,671,0.30901010845287713
2022-12-18,LA,Lao People's Democratic Republic,267,217412,0,671,0.3086306183651316
2022-12-25,LA,Lao People's Democratic Republic,230,217642,0,671,0.3083044632929306
2023-01-01,LA,Lao People's Democratic Republic,152,217794,0,671,0.30808929538922103
2023-01-08,LA,Lao People's Democratic Republic,63,217857,0,671,0.30800020196734557
2023-01-15,LA,Lao People's Democratic Republic,70,217927,0,671,0.3079012696912269
2023-01-22,LA,Lao People's Democratic Republic,15,217942,0,671,0.3078800781859394
2023-01-29,LA,Lao People's Democratic Republic,20,217962,0,671,0.3078518273827548
2023-02-05,LA,Lao People's Democratic Republic,25,217987,0,671,0.30781652116869357
2023-02-12,LA,Lao People's Democratic Republic,10,217997,0,671,0.3078024009504718
2023-02-19,LA,Lao People's Democratic Republic,9,218006,0,671,0.30778969386163685
2023-02-26,LA,Lao People's Democratic Republic,8,218014,0,671,0.30777839955232233
2023-03-05,LA,Lao People's Democratic Republic,5,218019,0,671,0.3077713410299103
2023-03-12,LA,Lao People's Democratic Republic,4,218023,0,671,0.30776569444508145
2023-03-19,LA,Lao People's Democratic Republic,3,218026,0,671,0.30776145964242796
2023-03-26,LA,Lao People's Democratic Republic,7,218033,0,671,0.30775157888943416
2023-04-02,LA,Lao People's Democratic Republic,4,218037,0,671,0.30774593302971515
2023-04-09,LA,Lao People's Democratic Republic,0,218037,0,671,0.30774593302971515
2023-04-16,LA,Lao People's Democratic Republic,11,218048,0,671,0.3077304079835632
2023-04-23,LA,Lao People's Democratic Republic,21,218069,0,671,0.3077007736083533
2023-04-30,LA,Lao People's Democratic Republic,8,218077,0,671,0.3076894858238145
2023-05-07,LA,Lao People's Democratic Republic,8,218085,0,671,0.30767819886741404
2023-05-14,LA,Lao People's Democratic Republic,13,218098,0,671,0.30765985932929235
2023-05-21,LA,Lao People's Democratic Republic,95,218193,0,671,0.30752590596398605
2023-05-28,LA,Lao People's Democratic Republic,32,218225,0,671,0.3074808110894719
2023-06-04,LA,Lao People's Democratic Republic,37,218262,0,671,0.3074286866243322
2023-06-11,LA,Lao People's Democratic Republic,57,218319,0,671,0.3073484213467449
2023-06-18,LA,Lao People's Democratic Republic,48,218367,0,671,0.3072808620350144
2023-06-25,LA,Lao People's Democratic Republic,52,218419,0,671,0.307207706289288
2023-07-02,LA,Lao People's Democratic Republic,66,218485,0,671,0.3071149049133808
2023-07-09,LA,Lao People's Democratic Republic,84,218569,0,671,0.3069968751286779
2023-07-16,LA,Lao People's Democratic Republic,78,218647,0,671,0.30688735724706945
2023-07-23,LA,Lao People's Democratic Republic,55,218702,0,671,0.30681018006236793
2023-07-30,LA,Lao People's Democratic Republic,37,218739,0,671,0.3067582827022159
2023-08-06,LA,Lao People's Democratic Republic,23,218762,0,671,0.30672603102915497
2023-08-13,LA,Lao People's Democratic Republic,15,218777,0,671,0.30670500098273584
2023-08-20,LA,Lao People's Democratic Republic,16,218793,0,671,0.3066825721115392
2023-08-27,LA,Lao People's Democratic Republic,12,218805,0,671,0.30666575261077217
2023-09-03,LA,Lao People's Democratic Republic,11,218816,0,671,0.3066503363556595
2023-09-10,LA,Lao People's Democratic Republic,21,218837,0,671,0.3066209096267999
2023-09-17,LA,Lao People's Democratic Republic,16,218853,0,671,0.30659849305241416
2023-09-24,LA,Lao People's Democratic Republic,11,218864,0,671,0.3065830835587397
2023-10-01,LA,Lao People's Democratic Republic,6,218870,0,671,0.30657467903321606
2023-10-08,LA,Lao People's Democratic Republic,6,218876,0,671,0.30656627496847527
2023-10-15,LA,Lao People's Democratic Republic,0,218876,0,671,0.30656627496847527
2023-10-22,LA,Lao People's Democratic Republic,9,218885,0,671,0.3065536697352491
2023-10-29,LA,Lao People's Democratic Republic,6,218891,0,671,0.30654526682229966
2023-11-05,LA,Lao People's Democratic Republic,0,218891,0,671,0.30654526682229966
2023-11-12,LA,Lao People's Democratic Republic,3,218894,0,671,0.30654106553857113
2023-11-19,LA,Lao People's Democratic Republic,2,218896,0,671,0.30653826474672907
2023-11-26,LA,Lao People's Democratic Republic,2,218898,0,671,0.30653546400606674
2023-12-03,LA,Lao People's Democratic Republic,3,218901,0,671,0.30653126299103245
2023-12-10,LA,Lao People's Democratic Republic,0,218901,0,671,0.30653126299103245
2023-12-17,LA,Lao People's Democratic Republic,2,218903,0,671,0.30652846237831366
2023-12-24,LA,Lao People's Democratic Republic,3,218906,0,671,0.3065242615551881
2023-12-31,LA,Lao People's Democratic Republic,0,218906,0,671,0.3065242615551881
2024-01-07,LA,Lao People's Democratic Republic,0,218906,0,671,0.3065242615551881
2024-01-14,LA,Lao People's Democratic Republic,2,218908,0,671,0.306521461070404
2020-04-05,LV,Latvia,187,534,2,2,0.37453183520599254
2022-02-20,LV,Latvia,67322,585942,122,5558,0.9485580484075216
2022-02-27,LV,Latvia,63560,649502,126,5684,0.875132024227793
2022-03-06,LV,Latvia,52036,701538,117,5801,0.8268974738360574
2022-03-13,LV,Latvia,40796,742334,110,5911,0.7962722979144158
2022-03-20,LV,Latvia,28702,771036,117,6028,0.7818052594171997
2022-03-27,LV,Latvia,19582,790618,95,6123,0.7744574497418475
2022-04-03,LV,Latvia,11914,802532,87,6210,0.7738009200879218
2022-04-10,LV,Latvia,6264,808796,58,6268,0.774979104743347
2022-04-17,LV,Latvia,4377,813173,49,6317,0.7768334659414418
2022-04-24,LV,Latvia,4140,817313,42,6359,0.7780373002754147
2022-05-01,LV,Latvia,2907,820220,27,6386,0.7785716027407281
2022-05-08,LV,Latvia,1906,822126,15,6401,0.7785911162035989
2022-05-15,LV,Latvia,1433,823559,15,6416,0.7790577238546358
2022-05-22,LV,Latvia,1157,824716,12,6428,0.779419824521411
2022-05-29,LV,Latvia,1218,825934,12,6440,0.7797233192966992
2022-06-05,LV,Latvia,1026,826960,11,6451,0.7800860984811842
2022-06-12,LV,Latvia,1227,828187,10,6461,0.7801378191157311
2022-06-19,LV,Latvia,1498,829685,12,6473,0.7801756088153938
2022-06-26,LV,Latvia,1523,831208,13,6486,0.7803101028864015
2022-07-03,LV,Latvia,3409,834617,7,6493,0.77796162790837
2022-07-10,LV,Latvia,3867,838484,9,6502,0.7754471164625681
2022-07-17,LV,Latvia,5493,843977,12,6514,0.7718219809307599
2022-07-24,LV,Latvia,8574,852551,9,6523,0.765115518015931
2022-07-31,LV,Latvia,9066,861617,25,6548,0.7599664352026481
2022-08-07,LV,Latvia,9733,871350,10,6558,0.7526252367016698
2022-08-14,LV,Latvia,9574,880924,16,6574,0.746261879571904
2022-08-21,LV,Latvia,8177,889101,22,6596,0.7418729705623995
2022-08-28,LV,Latvia,5479,894580,17,6613,0.7392295825974201
2022-09-04,LV,Latvia,4909,899489,16,6629,0.7369739930115877
2022-09-11,LV,Latvia,5623,905112,13,6642,0.7338318351761992
2022-09-18,LV,Latvia,8368,913480,23,6665,0.7296273591102158
2022-09-25,LV,Latvia,8470,921950,24,6689,0.7255274147188026
2022-10-02,LV,Latvia,7816,929766,36,6725,0.723300271251046
2022-10-09,LV,Latvia,6719,936485,32,6757,0.7215278408089826
2022-10-16,LV,Latvia,5189,941674,44,6801,0.722224464092669
2022-10-23,LV,Latvia,4373,946047,18,6819,0.7207887134571539
2022-10-30,LV,Latvia,3521,949568,21,6840,0.7203275594796792
2022-11-06,LV,Latvia,2874,952442,15,6855,0.7197288653797292
2022-11-13,LV,Latvia,2541,954983,18,6873,0.7196986752643764
2022-11-20,LV,Latvia,2312,957295,8,6881,0.7187961913516733
2022-11-27,LV,Latvia,3124,960419,16,6897,0.7181240687658199
2022-12-04,LV,Latvia,2757,963176,20,6917,0.7181449703896277
2022-12-11,LV,Latvia,2842,966018,28,6945,0.7189307031545996
2022-12-18,LV,Latvia,2310,968328,26,6971,0.7199006948058922
2022-12-25,LV,Latvia,2191,970519,40,7011,0.7223969855304223
2023-01-01,LV,Latvia,1327,971846,47,7058,0.7262467510284552
2023-01-08,LV,Latvia,393,972239,31,7089,0.7291417028117573
2023-01-15,LV,Latvia,264,972503,26,7115,0.731617280358004
2023-01-22,LV,Latvia,177,972680,21,7136,0.733643130320352
2023-01-29,LV,Latvia,154,972834,10,7146,0.7345549189275868
2023-02-05,LV,Latvia,177,973011,12,7158,0.7356545815001064
2023-02-12,LV,Latvia,194,973205,7,7165,0.7362272080394161
2023-02-19,LV,Latvia,171,973376,20,7185,0.7381525741337367
2023-02-26,LV,Latvia,158,973534,9,7194,0.7389572423767429
2023-03-05,LV,Latvia,180,973714,17,7211,0.7405665318563767
2023-03-12,LV,Latvia,153,973867,13,7224,0.7417850692137633
2023-03-19,LV,Latvia,190,974057,14,7238,0.7430776638328147
2023-03-26,LV,Latvia,219,974276,11,7249,0.7440396766419372
2023-04-02,LV,Latvia,199,974475,17,7266,0.7456322635265143
2023-04-09,LV,Latvia,229,974704,16,7282,0.7470986063461318
2023-04-16,LV,Latvia,188,974892,17,7299,0.7486983173520759
2023-04-23,LV,Latvia,182,975074,8,7307,0.7493790214896511
2023-04-30,LV,Latvia,137,975211,12,7319,0.7505042498495197
2023-05-07,LV,Latvia,114,975325,12,7331,0.7516468869351243
2023-05-14,LV,Latvia,67,975392,4,7335,0.7520053475935828
2023-05-21,LV,Latvia,64,975456,9,7344,0.7528786536758193
2023-05-28,LV,Latvia,58,975514,5,7349,0.7533464409531796
2023-06-04,LV,Latvia,59,975573,4,7353,0.753710896058009
2023-06-11,LV,Latvia,59,975632,10,7363,0.7546902930613182
2023-06-18,LV,Latvia,59,975691,3,7366,0.7549521313612609
2023-06-25,LV,Latvia,17,975708,2,7368,0.7551439570035298
2023-07-02,LV,Latvia,15,975723,2,7370,0.7553373242200911
2023-07-09,LV,Latvia,13,975736,1,7371,0.7554297473906876
2023-07-16,LV,Latvia,42,975778,1,7372,0.7554997140743078
2023-07-23,LV,Latvia,12,975790,0,7372,0.755490423144324
2023-07-30,LV,Latvia,22,975812,1,7373,0.755575869122331
2023-08-06,LV,Latvia,14,975826,1,7374,0.7556675062972292
2023-08-13,LV,Latvia,24,975850,3,7377,0.7559563457498591
2023-08-20,LV,Latvia,28,975878,1,7378,0.7560371275917686
2023-08-27,LV,Latvia,32,975910,0,7378,0.7560123372032257
2023-09-03,LV,Latvia,55,975965,0,7378,0.7559697325211457
2023-09-10,LV,Latvia,90,976055,1,7379,0.7560024793684782
2023-09-17,LV,Latvia,122,976177,2,7381,0.7561128770704494
2023-09-24,LV,Latvia,139,976316,3,7384,0.7563125053773574
2023-10-01,LV,Latvia,112,976428,4,7388,0.7566354098817323
2023-10-08,LV,Latvia,70,976498,5,7393,0.7570932044919704
2023-10-15,LV,Latvia,72,976570,2,7395,0.757242184380024
2023-10-22,LV,Latvia,90,976660,6,7401,0.7577867425716217
2023-10-29,LV,Latvia,138,976798,11,7412,0.7588058124607134
2023-11-05,LV,Latvia,183,976981,7,7419,0.7593801721834919
2023-11-12,LV,Latvia,209,977190,11,7430,0.7603434337232268
2023-11-19,LV,Latvia,241,977431,17,7447,0.7618952130636332
2023-11-26,LV,Latvia,270,977701,18,7465,0.7635258632240327
2023-12-03,LV,Latvia,0,977701,0,7465,0.7635258632240327
2023-12-10,LV,Latvia,0,977701,0,7465,0.7635258632240327
2023-12-17,LV,Latvia,0,977701,0,7465,0.7635258632240327
2023-12-24,LV,Latvia,0,977701,0,7465,0.7635258632240327
2023-12-31,LV,Latvia,0,977701,0,7465,0.7635258632240327
2024-01-07,LV,Latvia,0,977701,0,7465,0.7635258632240327
2024-01-14,LV,Latvia,0,977701,0,7465,0.7635258632240327
2020-08-30,LB,Lebanon,4084,16275,34,155,0.9523809523809524
2020-09-06,LB,Lebanon,3736,20011,32,187,0.934486032682025
2020-09-27,LB,Lebanon,6931,35228,54,340,0.9651413648234359
2020-10-04,LB,Lebanon,8252,43480,58,398,0.9153633854645814
2020-10-11,LB,Lebanon,9078,52558,57,455,0.8657102629476008
2020-10-18,LB,Lebanon,8389,60947,62,517,0.8482780120432507
2020-10-25,LB,Lebanon,9043,69990,45,562,0.8029718531218746
2020-11-01,LB,Lebanon,11238,81228,75,637,0.7842123405722166
2020-11-08,LB,Lebanon,11869,93097,76,713,0.7658678582553681
2020-11-15,LB,Lebanon,11170,104267,93,806,0.7730154315363442
2020-11-22,LB,Lebanon,10975,115242,88,894,0.7757588379236737
2020-11-29,LB,Lebanon,10395,125637,97,991,0.7887803752079403
2020-12-06,LB,Lebanon,10239,135876,99,1090,0.8022020077129146
2020-12-13,LB,Lebanon,9369,145245,100,1190,0.819305311714689
2020-12-20,LB,Lebanon,11325,156570,80,1270,0.811138787762662
2020-12-27,LB,Lebanon,12902,169472,109,1379,0.8137037386706949
2021-01-03,LB,Lebanon,16936,186408,387,1766,0.9473842324363762
2021-01-10,LB,Lebanon,29145,215553,114,1880,0.8721752886761028
2021-01-17,LB,Lebanon,33605,249158,276,2156,0.8653143788278923
2021-01-24,LB,Lebanon,27429,276587,414,2570,0.929183222638808
2022-02-13,LB,Lebanon,46417,1012044,130,9824,0.9707087834125789
2022-02-20,LB,Lebanon,30984,1043028,126,9950,0.9539532975145442
2022-02-27,LB,Lebanon,22279,1065307,119,10069,0.9451735509106765
2022-03-06,LB,Lebanon,11935,1077242,73,10142,0.9414783307743292
2022-03-13,LB,Lebanon,6872,1084114,58,10200,0.9408604630140374
2022-03-20,LB,Lebanon,3721,1087835,43,10243,0.9415950029186412
2022-03-27,LB,Lebanon,2663,1090498,35,10278,0.9425051673639017
2022-04-03,LB,Lebanon,2309,1092807,33,10311,0.943533487614922
2022-04-10,LB,Lebanon,1696,1094503,26,10337,0.9444469316210189
2022-04-17,LB,Lebanon,1015,1095518,22,10359,0.9455800817512812
2022-04-24,LB,Lebanon,802,1096320,16,10375,0.9463477816695854
2022-05-01,LB,Lebanon,635,1096955,12,10387,0.9468939017553135
2022-05-08,LB,Lebanon,537,1097492,11,10398,0.9474328742259625
2022-05-15,LB,Lebanon,464,1097956,9,10407,0.9478521907981741
2022-05-22,LB,Lebanon,548,1098504,10,10417,0.9482896739565809
2022-05-29,LB,Lebanon,561,1099065,9,10426,0.9486245126539377
2022-06-05,LB,Lebanon,680,1099745,9,10435,0.9488563257846137
2022-06-12,LB,Lebanon,1126,1100871,9,10444,0.9487033448969043
2022-06-19,LB,Lebanon,2393,1103264,8,10452,0.9473707109087218
2022-06-26,LB,Lebanon,4338,1107602,8,10460,0.9443825489661448
2022-07-03,LB,Lebanon,7212,1114814,8,10468,0.9389907195281006
2022-07-10,LB,Lebanon,9814,1124628,8,10476,0.9315080186515008
2022-07-17,LB,Lebanon,13830,1138458,11,10487,0.9211582684648884
2022-07-24,LB,Lebanon,17202,1155660,19,10506,0.9090909090909091
2022-07-31,LB,Lebanon,16609,1172269,23,10529,0.898172689032978
2022-08-07,LB,Lebanon,13136,1185405,17,10546,0.8896537470316053
2022-08-14,LB,Lebanon,10379,1195784,26,10572,0.8841061596408717
2022-08-21,LB,Lebanon,7620,1203404,27,10599,0.8807516012910046
2022-08-28,LB,Lebanon,4469,1207873,20,10619,0.8791487184497045
2022-09-04,LB,Lebanon,2693,1210566,17,10636,0.8785972842455513
2022-09-11,LB,Lebanon,1931,1212497,9,10645,0.8779403165533606
2022-09-18,LB,Lebanon,1272,1213769,12,10657,0.8780089127338069
2022-09-25,LB,Lebanon,1123,1214892,13,10670,0.8782673686220668
2022-10-02,LB,Lebanon,1033,1215925,7,10677,0.8780969220963464
2022-10-09,LB,Lebanon,713,1216638,7,10684,0.8781576771397901
2022-10-16,LB,Lebanon,361,1216999,4,10688,0.8782258654279913
2022-10-23,LB,Lebanon,1083,1218082,11,10699,0.8783480915077966
2022-10-30,LB,Lebanon,548,1218630,6,10705,0.8784454674511541
2022-11-06,LB,Lebanon,511,1219141,8,10713,0.8787334688932616
2022-11-13,LB,Lebanon,432,1219573,7,10720,0.8789961732508017
2022-11-20,LB,Lebanon,470,1220043,7,10727,0.8792313057818455
2022-11-27,LB,Lebanon,342,1220385,7,10734,0.8795584999815632
2022-12-04,LB,Lebanon,329,1220714,5,10739,0.8797310426520871
2022-12-11,LB,Lebanon,430,1221144,2,10741,0.8795850448431962
2022-12-18,LB,Lebanon,496,1221640,1,10742,0.8793097802953407
2022-12-25,LB,Lebanon,486,1222126,2,10744,0.8791237564702822
2023-01-01,LB,Lebanon,682,1222808,3,10747,0.8788787773714271
2023-01-08,LB,Lebanon,907,1223715,6,10753,0.8787176752756973
2023-01-15,LB,Lebanon,1536,1225251,7,10760,0.8781874081310685
2023-01-22,LB,Lebanon,1490,1226741,13,10773,0.8781804798241845
2023-01-29,LB,Lebanon,1521,1228262,13,10786,0.8781514041792386
2023-02-05,LB,Lebanon,1128,1229390,9,10795,0.87807774587397
2023-02-12,LB,Lebanon,751,1230141,8,10803,0.8781920121351943
2023-02-19,LB,Lebanon,694,1230835,12,10815,0.8786717959759025
2023-02-26,LB,Lebanon,878,1231713,10,10825,0.8788573312127094
2023-03-05,LB,Lebanon,689,1232402,12,10837,0.8793396959758261
2023-03-12,LB,Lebanon,619,1233021,6,10843,0.8793848604362781
2023-03-19,LB,Lebanon,626,1233647,10,10853,0.8797492313441365
2023-03-26,LB,Lebanon,648,1234295,9,10862,0.8800165276534377
2023-04-02,LB,Lebanon,601,1234896,8,10870,0.8802360684624455
2023-04-09,LB,Lebanon,464,1235360,9,10879,0.8806339852350732
2023-04-16,LB,Lebanon,444,1235804,6,10885,0.8808031046994507
2023-04-23,LB,Lebanon,532,1236336,10,10895,0.8812329334420416
2023-04-30,LB,Lebanon,420,1236756,6,10901,0.8814188085604598
2023-05-07,LB,Lebanon,371,1237127,5,10906,0.8815586435345765
2023-05-14,LB,Lebanon,429,1237556,8,10914,0.8818994857606445
2023-05-21,LB,Lebanon,0,1237556,0,10914,0.8818994857606445
2023-05-28,LB,Lebanon,0,1237556,0,10914,0.8818994857606445
2023-06-04,LB,Lebanon,0,1237556,0,10914,0.8818994857606445
2023-06-11,LB,Lebanon,808,1238364,16,10930,0.8826160967211579
2023-06-18,LB,Lebanon,47,1238411,2,10932,0.8827440970727811
2023-06-25,LB,Lebanon,141,1238552,4,10936,0.8829665609518212
2023-07-02,LB,Lebanon,0,1238552,0,10936,0.8829665609518212
2023-07-09,LB,Lebanon,0,1238552,0,10936,0.8829665609518212
2023-07-16,LB,Lebanon,0,1238552,0,10936,0.8829665609518212
2023-07-23,LB,Lebanon,0,1238552,0,10936,0.8829665609518212
2023-07-30,LB,Lebanon,0,1238552,0,10936,0.8829665609518212
2023-08-06,LB,Lebanon,0,1238552,0,10936,0.8829665609518212
2023-08-13,LB,Lebanon,0,1238552,0,10936,0.8829665609518212
2023-08-20,LB,Lebanon,1352,1239904,11,10947,0.8828909334916252
2023-08-27,LB,Lebanon,0,1239904,0,10947,0.8828909334916252
2023-09-03,LB,Lebanon,0,1239904,0,10947,0.8828909334916252
2023-09-10,LB,Lebanon,0,1239904,0,10947,0.8828909334916252
2023-09-17,LB,Lebanon,0,1239904,0,10947,0.8828909334916252
2023-09-24,LB,Lebanon,0,1239904,0,10947,0.8828909334916252
2023-10-01,LB,Lebanon,0,1239904,0,10947,0.8828909334916252
2023-10-08,LB,Lebanon,0,1239904,0,10947,0.8828909334916252
2023-10-15,LB,Lebanon,0,1239904,0,10947,0.8828909334916252
2023-10-22,LB,Lebanon,0,1239904,0,10947,0.8828909334916252
2023-10-29,LB,Lebanon,0,1239904,0,10947,0.8828909334916252
2023-11-05,LB,Lebanon,0,1239904,0,10947,0.8828909334916252
2023-11-12,LB,Lebanon,0,1239904,0,10947,0.8828909334916252
2023-11-19,LB,Lebanon,0,1239904,0,10947,0.8828909334916252
2023-11-26,LB,Lebanon,0,1239904,0,10947,0.8828909334916252
2023-12-03,LB,Lebanon,0,1239904,0,10947,0.8828909334916252
2023-12-10,LB,Lebanon,0,1239904,0,10947,0.8828909334916252
2023-12-17,LB,Lebanon,0,1239904,0,10947,0.8828909334916252
2023-12-24,LB,Lebanon,0,1239904,0,10947,0.8828909334916252
2023-12-31,LB,Lebanon,0,1239904,0,10947,0.8828909334916252
2024-01-07,LB,Lebanon,0,1239904,0,10947,0.8828909334916252
2024-01-14,LB,Lebanon,0,1239904,0,10947,0.8828909334916252
2020-08-30,LI,Liechtenstein,7,108,0,1,0.9259259259259258
2020-09-06,LI,Liechtenstein,0,108,0,1,0.9259259259259258
2020-09-13,LI,Liechtenstein,3,111,0,1,0.9009009009009009
2020-09-20,LI,Liechtenstein,3,114,0,1,0.8771929824561403
2020-09-27,LI,Liechtenstein,5,119,0,1,0.8403361344537815
2020-10-04,LI,Liechtenstein,9,128,0,1,0.78125
2020-10-11,LI,Liechtenstein,22,150,0,1,0.6666666666666667
2020-10-18,LI,Liechtenstein,77,227,0,1,0.4405286343612335
2020-10-25,LI,Liechtenstein,186,413,0,1,0.24213075060532688
2020-11-01,LI,Liechtenstein,190,603,2,3,0.4975124378109453
2020-11-08,LI,Liechtenstein,217,820,0,3,0.3658536585365854
2020-11-15,LI,Liechtenstein,193,1013,3,6,0.5923000987166831
2020-11-22,LI,Liechtenstein,141,1154,4,10,0.8665511265164645
2022-01-16,LI,Liechtenstein,545,7377,1,70,0.9488952148569879
2022-01-23,LI,Liechtenstein,757,8134,1,71,0.8728792721908041
2022-01-30,LI,Liechtenstein,910,9044,0,71,0.7850508624502434
2022-02-06,LI,Liechtenstein,810,9854,0,71,0.7205195859549421
2022-02-13,LI,Liechtenstein,846,10700,0,71,0.6635514018691588
2022-02-20,LI,Liechtenstein,615,11315,3,74,0.6539991162174105
2022-02-27,LI,Liechtenstein,648,11963,1,75,0.6269330435509488
2022-03-06,LI,Liechtenstein,1143,13106,1,76,0.5798870746223104
2022-03-13,LI,Liechtenstein,1126,14232,2,78,0.5480607082630692
2022-03-20,LI,Liechtenstein,1149,15381,2,80,0.52012222872375
2022-03-27,LI,Liechtenstein,710,16091,2,82,0.5096016406686968
2022-04-03,LI,Liechtenstein,406,16497,0,82,0.4970600715281566
2022-04-10,LI,Liechtenstein,266,16763,0,82,0.48917258247330425
2022-04-17,LI,Liechtenstein,204,16967,0,82,0.48329109447751517
2022-04-24,LI,Liechtenstein,112,17079,0,82,0.4801217869898706
2022-05-01,LI,Liechtenstein,95,17174,1,83,0.4832886922091534
2022-05-08,LI,Liechtenstein,80,17254,0,83,0.48104787295699547
2022-05-15,LI,Liechtenstein,67,17321,0,83,0.479187113907973
2022-05-22,LI,Liechtenstein,57,17378,0,83,0.47761537576245827
2022-05-29,LI,Liechtenstein,53,17431,0,83,0.4761631575927945
2022-06-05,LI,Liechtenstein,95,17526,0,83,0.473582106584503
2022-06-12,LI,Liechtenstein,76,17602,1,84,0.47721849789796617
2022-06-19,LI,Liechtenstein,95,17697,0,84,0.47465672147821664
2022-06-26,LI,Liechtenstein,124,17821,0,84,0.47135402053756803
2022-07-03,LI,Liechtenstein,158,17979,1,85,0.472773791645809
2022-07-10,LI,Liechtenstein,209,18188,0,85,0.46734110402463164
2022-07-17,LI,Liechtenstein,205,18393,0,85,0.46213233295275374
2022-07-24,LI,Liechtenstein,164,18557,0,85,0.4580481758904995
2022-07-31,LI,Liechtenstein,148,18705,1,86,0.45977011494252873
2022-08-07,LI,Liechtenstein,113,18818,0,86,0.4570092464661495
2022-08-14,LI,Liechtenstein,109,18927,0,86,0.45437734453426326
2022-08-21,LI,Liechtenstein,70,18997,0,86,0.4527030583776385
2022-08-28,LI,Liechtenstein,105,19102,0,86,0.4502146372107632
2022-09-04,LI,Liechtenstein,118,19220,0,86,0.4474505723204995
2022-09-11,LI,Liechtenstein,105,19325,0,86,0.4450194049159121
2022-09-18,LI,Liechtenstein,111,19436,0,86,0.4424778761061947
2022-09-25,LI,Liechtenstein,151,19587,0,86,0.4390667279317915
2022-10-02,LI,Liechtenstein,271,19858,0,86,0.43307483130224594
2022-10-09,LI,Liechtenstein,304,20162,0,86,0.4265449856165063
2022-10-16,LI,Liechtenstein,243,20405,0,86,0.4214653271257045
2022-10-23,LI,Liechtenstein,152,20557,0,86,0.4183489808824245
2022-10-30,LI,Liechtenstein,87,20644,0,86,0.4165859329587289
2022-11-06,LI,Liechtenstein,85,20729,0,86,0.41487770755945774
2022-11-13,LI,Liechtenstein,56,20785,0,86,0.4137599230214096
2022-11-20,LI,Liechtenstein,61,20846,0,86,0.4125491701045764
2022-11-27,LI,Liechtenstein,60,20906,0,86,0.41136515832775283
2022-12-04,LI,Liechtenstein,119,21025,0,86,0.4090368608799049
2022-12-11,LI,Liechtenstein,91,21116,1,87,0.4120098503504452
2022-12-18,LI,Liechtenstein,96,21212,0,87,0.41014520082971906
2022-12-25,LI,Liechtenstein,69,21281,0,87,0.40881537521733
2023-01-01,LI,Liechtenstein,23,21304,0,87,0.4083740142696207
2023-01-08,LI,Liechtenstein,20,21324,0,87,0.40799099606077655
2023-01-15,LI,Liechtenstein,15,21339,0,87,0.4077042035709265
2023-01-22,LI,Liechtenstein,1,21340,0,87,0.40768509840674794
2023-01-29,LI,Liechtenstein,10,21350,0,87,0.4074941451990633
2023-02-05,LI,Liechtenstein,9,21359,0,87,0.40732244018914743
2023-02-12,LI,Liechtenstein,13,21372,0,87,0.40707467714766987
2023-02-19,LI,Liechtenstein,15,21387,0,87,0.4067891709917239
2023-02-26,LI,Liechtenstein,17,21404,0,87,0.4064660811063352
2023-03-05,LI,Liechtenstein,28,21432,0,87,0.4059350503919373
2023-03-12,LI,Liechtenstein,16,21448,0,87,0.4056322267810519
2023-03-19,LI,Liechtenstein,6,21454,0,87,0.405518784375874
2023-03-26,LI,Liechtenstein,4,21458,0,87,0.40544319135054524
2023-04-02,LI,Liechtenstein,0,21458,0,87,0.40544319135054524
2023-04-09,LI,Liechtenstein,2,21460,0,87,0.40540540540540543
2023-04-16,LI,Liechtenstein,0,21460,0,87,0.40540540540540543
2023-04-23,LI,Liechtenstein,2,21462,0,87,0.4053676265026559
2023-04-30,LI,Liechtenstein,2,21464,0,87,0.40532985464032795
2023-05-07,LI,Liechtenstein,1,21465,0,87,0.40531097134870714
2023-05-14,LI,Liechtenstein,3,21468,0,87,0.4052543320290665
2023-05-21,LI,Liechtenstein,0,21468,0,87,0.4052543320290665
2023-05-28,LI,Liechtenstein,1,21469,0,87,0.4052354557734407
2023-06-04,LI,Liechtenstein,1,21470,0,87,0.4052165812761993
2023-06-11,LI,Liechtenstein,1,21471,0,87,0.4051977085370966
2023-06-18,LI,Liechtenstein,0,21471,0,87,0.4051977085370966
2023-06-25,LI,Liechtenstein,1,21472,0,87,0.40517883755588674
2023-07-02,LI,Liechtenstein,1,21473,0,87,0.4051599683323243
2023-07-09,LI,Liechtenstein,0,21473,0,87,0.4051599683323243
2023-07-16,LI,Liechtenstein,0,21473,0,87,0.4051599683323243
2023-07-23,LI,Liechtenstein,0,21473,0,87,0.4051599683323243
2023-07-30,LI,Liechtenstein,0,21473,0,87,0.4051599683323243
2023-08-06,LI,Liechtenstein,0,21473,0,87,0.4051599683323243
2023-08-13,LI,Liechtenstein,0,21473,0,87,0.4051599683323243
2023-08-20,LI,Liechtenstein,1,21474,0,87,0.4051411008661637
2023-08-27,LI,Liechtenstein,1,21475,0,87,0.4051222351571595
2023-09-03,LI,Liechtenstein,2,21477,0,87,0.40508450900963827
2023-09-10,LI,Liechtenstein,2,21479,0,87,0.4050467898877974
2023-09-17,LI,Liechtenstein,7,21486,0,87,0.40491482826026254
2023-09-24,LI,Liechtenstein,2,21488,0,87,0.4048771407297096
2023-10-01,LI,Liechtenstein,3,21491,0,87,0.40482062258619883
2023-10-08,LI,Liechtenstein,3,21494,0,87,0.4047641202195962
2023-10-15,LI,Liechtenstein,3,21497,0,87,0.40470763362329626
2023-10-22,LI,Liechtenstein,7,21504,0,87,0.4045758928571429
2023-10-29,LI,Liechtenstein,3,21507,0,87,0.40451945878086204
2023-11-05,LI,Liechtenstein,7,21514,0,87,0.4043878404759692
2023-11-12,LI,Liechtenstein,5,21519,0,87,0.4042938798271295
2023-11-19,LI,Liechtenstein,8,21527,0,87,0.4041436335764389
2023-11-26,LI,Liechtenstein,10,21537,0,87,0.4039559827273994
2023-12-03,LI,Liechtenstein,8,21545,0,87,0.40380598746809004
2023-12-10,LI,Liechtenstein,0,21545,0,87,0.40380598746809004
2023-12-17,LI,Liechtenstein,13,21558,0,87,0.4035624826050654
2023-12-24,LI,Liechtenstein,6,21564,0,87,0.4034501947690595
2023-12-31,LI,Liechtenstein,3,21567,0,87,0.4033940742801502
2024-01-07,LI,Liechtenstein,2,21569,0,87,0.403356669293894
2024-01-14,LI,Liechtenstein,0,21569,0,87,0.403356669293894
2020-11-01,LT,Lithuania,6039,16878,33,155,0.9183552553620097
2020-11-08,LT,Lithuania,8245,25123,49,204,0.8120049357162759
2020-11-15,LT,Lithuania,10357,35480,91,295,0.8314543404735062
2020-11-22,LT,Lithuania,12436,47916,144,439,0.9161866599883128
2020-11-29,LT,Lithuania,13381,61297,153,592,0.9657895166158214
2022-02-13,LT,Lithuania,77802,863959,131,8122,0.940090907091656
2022-02-20,LT,Lithuania,54157,918116,132,8254,0.8990149392887173
2022-02-27,LT,Lithuania,45304,963420,161,8415,0.8734508314130909
2022-03-06,LT,Lithuania,37052,1000472,120,8535,0.8530973380564374
2022-03-13,LT,Lithuania,35485,1035957,106,8641,0.8341079793852447
2022-03-20,LT,Lithuania,35886,1071843,96,8737,0.8151380379402581
2022-03-27,LT,Lithuania,27270,1099113,103,8840,0.8042849097408546
2022-04-03,LT,Lithuania,18874,1117987,76,8916,0.7975048010397258
2022-04-10,LT,Lithuania,12314,1130301,56,8972,0.7937708628055713
2022-04-17,LT,Lithuania,9337,1139638,51,9023,0.7917426410842742
2022-04-24,LT,Lithuania,6163,1145801,47,9070,0.7915859734805608
2022-05-01,LT,Lithuania,4462,1150263,33,9103,0.7913842312584166
2022-05-08,LT,Lithuania,1303,1151566,20,9123,0.7922255433036405
2022-05-15,LT,Lithuania,1181,1152747,9,9132,0.7921946446184636
2022-05-22,LT,Lithuania,1039,1153786,4,9136,0.7918279472969858
2022-05-29,LT,Lithuania,909,1154695,8,9144,0.7918974274591992
2022-06-05,LT,Lithuania,877,1155572,5,9149,0.7917291177010174
2022-06-12,LT,Lithuania,1101,1156673,4,9153,0.7913213155317017
2022-06-19,LT,Lithuania,1304,1157977,5,9158,0.7908619946682879
2022-06-26,LT,Lithuania,1559,1159536,9,9167,0.7905748506299071
2022-07-03,LT,Lithuania,2628,1162164,8,9175,0.7894754957131696
2022-07-10,LT,Lithuania,2930,1165094,5,9180,0.7879192580169497
2022-07-17,LT,Lithuania,4578,1169672,9,9189,0.7856048533264026
2022-07-24,LT,Lithuania,6345,1176017,10,9199,0.7822165836038085
2022-07-31,LT,Lithuania,7583,1183600,9,9208,0.7779655288948969
2022-08-07,LT,Lithuania,8553,1192153,12,9220,0.7733906637822494
2022-08-14,LT,Lithuania,8562,1200715,17,9237,0.7692916304035512
2022-08-21,LT,Lithuania,8234,1208949,21,9258,0.7657891275810642
2022-08-28,LT,Lithuania,6725,1215674,24,9282,0.7635270639990656
2022-09-04,LT,Lithuania,5172,1220846,12,9294,0.76127537789369
2022-09-11,LT,Lithuania,5775,1226621,2,9296,0.7578543005541238
2022-09-18,LT,Lithuania,8935,1235556,11,9307,0.753264117530893
2022-09-25,LT,Lithuania,8787,1244343,10,9317,0.7487485363762242
2022-10-02,LT,Lithuania,7189,1251532,7,9324,0.745006919519437
2022-10-09,LT,Lithuania,5598,1257130,18,9342,0.7431212364671911
2022-10-16,LT,Lithuania,4520,1261650,21,9363,0.7421234098204732
2022-10-23,LT,Lithuania,3522,1265172,17,9380,0.7414011691690932
2022-10-30,LT,Lithuania,2868,1268040,13,9393,0.740749503170247
2022-11-06,LT,Lithuania,1765,1269805,9,9402,0.7404286484932726
2022-11-13,LT,Lithuania,1724,1271529,11,9413,0.7402898400272427
2022-11-20,LT,Lithuania,1551,1273080,4,9417,0.7397021396927137
2022-11-27,LT,Lithuania,1837,1274917,13,9430,0.7396559932921124
2022-12-04,LT,Lithuania,2699,1277616,6,9436,0.7385630737248124
2022-12-11,LT,Lithuania,3034,1280650,5,9441,0.7372037637137391
2022-12-18,LT,Lithuania,2822,1283472,13,9454,0.7365957340713315
2022-12-25,LT,Lithuania,2750,1286222,15,9469,0.7361870656853949
2023-01-01,LT,Lithuania,2258,1288480,14,9483,0.7359834844157457
2023-01-08,LT,Lithuania,2485,1290965,19,9502,0.7360385448095029
2023-01-15,LT,Lithuania,1627,1292592,18,9520,0.7365046356468243
2023-01-22,LT,Lithuania,1648,1294240,8,9528,0.7361849425145258
2023-01-29,LT,Lithuania,1730,1295970,9,9537,0.7358966642746361
2023-02-05,LT,Lithuania,1947,1297917,14,9551,0.7358714000972327
2023-02-12,LT,Lithuania,2095,1300012,7,9558,0.7352239825478534
2023-02-19,LT,Lithuania,1907,1301919,16,9574,0.7353760103355124
2023-02-26,LT,Lithuania,2194,1304113,11,9585,0.7349823213172478
2023-03-05,LT,Lithuania,2250,1306363,8,9593,0.7343288197843937
2023-03-12,LT,Lithuania,2181,1308544,9,9602,0.7337926733835469
2023-03-19,LT,Lithuania,2312,1310856,10,9612,0.7332613193211154
2023-03-26,LT,Lithuania,2091,1312947,16,9628,0.7333121595921237
2023-04-02,LT,Lithuania,1675,1314622,8,9636,0.7329863641411751
2023-04-09,LT,Lithuania,1473,1316095,7,9643,0.7326978675551538
2023-04-16,LT,Lithuania,968,1317063,10,9653,0.7329186227234384
2023-04-23,LT,Lithuania,801,1317864,5,9658,0.7328525553471376
2023-04-30,LT,Lithuania,610,1318474,7,9665,0.7330444134658703
2023-05-07,LT,Lithuania,505,1318979,7,9672,0.7332944648853393
2023-05-14,LT,Lithuania,504,1319483,1,9673,0.7330901572812988
2023-05-21,LT,Lithuania,439,1319922,7,9680,0.7333766692274241
2023-05-28,LT,Lithuania,393,1320315,2,9682,0.7333098540878502
2023-06-04,LT,Lithuania,334,1320649,3,9685,0.7333515566967453
2023-06-11,LT,Lithuania,273,1320922,2,9687,0.7333514015210588
2023-06-18,LT,Lithuania,219,1321141,3,9690,0.7334569133801766
2023-06-25,LT,Lithuania,154,1321295,0,9690,0.7333714272740002
2023-07-02,LT,Lithuania,152,1321447,1,9691,0.733362745535765
2023-07-09,LT,Lithuania,93,1321540,0,9691,0.7333111370068254
2023-07-16,LT,Lithuania,111,1321651,1,9692,0.7333252121777988
2023-07-23,LT,Lithuania,110,1321761,1,9693,0.7333398398046244
2023-07-30,LT,Lithuania,117,1321878,1,9694,0.7333505815211389
2023-08-06,LT,Lithuania,144,1322022,0,9694,0.7332707020004205
2023-08-13,LT,Lithuania,162,1322184,1,9695,0.7332564907758677
2023-08-20,LT,Lithuania,263,1322447,0,9695,0.7331106653045453
2023-08-27,LT,Lithuania,428,1322875,2,9697,0.7330246621940848
2023-09-03,LT,Lithuania,524,1323399,4,9701,0.7330366729912898
2023-09-10,LT,Lithuania,924,1324323,2,9703,0.7326762428803245
2023-09-17,LT,Lithuania,1734,1326057,1,9704,0.7317935805172779
2023-09-24,LT,Lithuania,1988,1328045,2,9706,0.730848728770486
2023-10-01,LT,Lithuania,1893,1329938,4,9710,0.7301092231367177
2023-10-08,LT,Lithuania,1620,1331558,4,9714,0.7295213576877613
2023-10-15,LT,Lithuania,1707,1333265,4,9718,0.7288873554769681
2023-10-22,LT,Lithuania,2308,1335573,11,9729,0.7284513837880819
2023-10-29,LT,Lithuania,2891,1338464,5,9734,0.7272515360891291
2023-11-05,LT,Lithuania,2502,1340966,5,9739,0.7262674818004334
2023-11-12,LT,Lithuania,3869,1344835,11,9750,0.7249960032271616
2023-11-19,LT,Lithuania,4146,1348981,9,9759,0.7234349483054247
2023-11-26,LT,Lithuania,1561,1350542,2,9761,0.7227468675539154
2023-12-03,LT,Lithuania,0,1350542,0,9761,0.7227468675539154
2023-12-10,LT,Lithuania,4782,1355324,8,9769,0.7207870590353302
2023-12-17,LT,Lithuania,3906,1359230,4,9773,0.7190100277362919
2023-12-24,LT,Lithuania,0,1359230,0,9773,0.7190100277362919
2023-12-31,LT,Lithuania,0,1359230,0,9773,0.7190100277362919
2024-01-07,LT,Lithuania,0,1359230,0,9773,0.7190100277362919
2024-01-14,LT,Lithuania,0,1359230,0,9773,0.7190100277362919
2020-11-01,LU,Luxembourg,3089,15463,11,137,0.8859859018301752
2020-11-08,LU,Luxembourg,2634,18097,12,149,0.823340885229596
2020-11-15,LU,Luxembourg,2835,20932,11,160,0.764379896808714
2020-11-22,LU,Luxembourg,3255,24187,21,181,0.7483358829123082
2020-11-29,LU,Luxembourg,3410,27597,17,198,0.7174692901402326
2020-12-06,LU,Luxembourg,3633,31230,20,218,0.6980467499199488
2020-12-13,LU,Luxembourg,3241,34471,32,250,0.7252473093324824
2020-12-20,LU,Luxembourg,2623,37094,16,266,0.7170971046530437
2020-12-27,LU,Luxembourg,1289,38383,19,285,0.7425162181173957
2021-01-03,LU,Luxembourg,1111,39494,10,295,0.7469489036309312
2021-01-10,LU,Luxembourg,1035,40529,6,301,0.7426780823607787
2021-01-17,LU,Luxembourg,857,41386,9,310,0.7490455709660272
2021-01-24,LU,Luxembourg,853,42239,13,323,0.7646961339046852
2021-01-31,LU,Luxembourg,1049,43288,14,337,0.7785067455183885
2021-02-07,LU,Luxembourg,1187,44475,14,351,0.7892074198988196
2021-02-14,LU,Luxembourg,1131,45606,16,367,0.8047186773670131
2021-02-21,LU,Luxembourg,1295,46901,11,378,0.8059529647555489
2021-02-28,LU,Luxembourg,1360,48261,28,406,0.8412589875883218
2021-03-07,LU,Luxembourg,1251,49512,33,439,0.8866537405073517
2021-03-14,LU,Luxembourg,1303,50815,23,462,0.9091803601298829
2021-03-21,LU,Luxembourg,1637,52452,21,483,0.920841912605811
2021-03-28,LU,Luxembourg,1760,54212,13,496,0.9149265845200325
2021-04-04,LU,Luxembourg,1626,55838,10,506,0.9061929152190266
2021-04-11,LU,Luxembourg,1374,57212,14,520,0.9089002307208278
2021-04-18,LU,Luxembourg,1332,58544,5,525,0.8967614102213719
2021-04-25,LU,Luxembourg,1243,59787,2,527,0.8814625252981416
2021-05-02,LU,Luxembourg,1137,60924,4,531,0.8715777033681309
2021-05-09,LU,Luxembourg,954,61878,4,535,0.8646045444261289
2021-05-16,LU,Luxembourg,758,62636,2,537,0.8573344402579987
2021-05-23,LU,Luxembourg,526,63162,1,538,0.8517779677654287
2021-05-30,LU,Luxembourg,372,63534,0,538,0.8467906947461202
2021-06-06,LU,Luxembourg,338,63872,1,539,0.8438752505010021
2021-06-13,LU,Luxembourg,200,64072,0,539,0.841241103758272
2021-06-20,LU,Luxembourg,103,64175,0,539,0.83989092325672
2021-06-27,LU,Luxembourg,125,64300,0,539,0.838258164852255
2021-07-04,LU,Luxembourg,846,65146,0,539,0.8273723636140361
2021-07-11,LU,Luxembourg,910,66056,1,540,0.817488191837229
2021-07-18,LU,Luxembourg,800,66856,1,541,0.8092018666985761
2021-07-25,LU,Luxembourg,651,67507,3,544,0.8058423570888944
2021-08-01,LU,Luxembourg,509,68016,1,545,0.8012820512820512
2021-08-08,LU,Luxembourg,485,68501,1,546,0.7970686559320301
2021-08-15,LU,Luxembourg,370,68871,1,547,0.7942385038695533
2021-08-22,LU,Luxembourg,503,69374,1,548,0.7899212961628276
2021-08-29,LU,Luxembourg,634,70008,2,550,0.7856245000571364
2021-09-05,LU,Luxembourg,655,70663,2,552,0.78117260801268
2021-09-12,LU,Luxembourg,605,71268,0,552,0.7745411685468934
2021-09-19,LU,Luxembourg,580,71848,3,555,0.772464090858479
2021-09-26,LU,Luxembourg,621,72469,0,555,0.7658447060122259
2021-10-03,LU,Luxembourg,626,73095,1,556,0.7606539434981874
2021-10-10,LU,Luxembourg,728,73823,3,559,0.7572165856169486
2021-10-17,LU,Luxembourg,854,74677,5,564,0.755252621289018
2021-10-24,LU,Luxembourg,1046,75723,5,569,0.7514229494341217
2021-10-31,LU,Luxembourg,1176,76899,6,575,0.7477340407547562
2021-11-07,LU,Luxembourg,1306,78205,5,580,0.7416405600664919
2021-11-14,LU,Luxembourg,1564,79769,3,583,0.7308603592874425
2021-11-21,LU,Luxembourg,1999,81768,8,591,0.7227766363369533
2021-11-28,LU,Luxembourg,2549,84317,13,604,0.7163442722108234
2021-12-05,LU,Luxembourg,2880,87197,13,617,0.7075931511405209
2021-12-12,LU,Luxembourg,2725,89922,4,621,0.6905985187162208
2021-12-19,LU,Luxembourg,2933,92855,8,629,0.6774002476980238
2021-12-26,LU,Luxembourg,3033,95888,6,635,0.6622309360921075
2022-01-02,LU,Luxembourg,6642,102530,5,640,0.6242075490100458
2022-01-09,LU,Luxembourg,12803,115333,11,651,0.5644524984176255
2022-01-16,LU,Luxembourg,13715,129048,7,658,0.5098877936891699
2022-01-23,LU,Luxembourg,18413,147461,15,673,0.4563918595425231
2022-01-30,LU,Luxembourg,17703,165164,18,691,0.4183720423336805
2022-02-06,LU,Luxembourg,13029,178193,22,713,0.4001279511540857
2022-02-13,LU,Luxembourg,6852,185045,15,728,0.3934178172876868
2022-02-20,LU,Luxembourg,4237,189282,6,734,0.38778119419701823
2022-02-27,LU,Luxembourg,5666,194948,8,742,0.3806143176641976
2022-03-06,LU,Luxembourg,5764,200712,9,751,0.3741679620550839
2022-03-13,LU,Luxembourg,7190,207902,15,766,0.36844282402285694
2022-03-20,LU,Luxembourg,9459,217361,12,778,0.3579298954274226
2022-03-27,LU,Luxembourg,11570,228931,13,791,0.3455189554931399
2022-04-03,LU,Luxembourg,9821,238752,14,805,0.3371699504087924
2022-04-10,LU,Luxembourg,7285,246037,11,816,0.33165743363803
2022-04-17,LU,Luxembourg,6395,252432,13,829,0.32840527349939785
2022-04-24,LU,Luxembourg,5108,257540,5,834,0.3238331909606275
2022-05-01,LU,Luxembourg,4363,261903,7,841,0.32111125111205296
2022-05-08,LU,Luxembourg,3978,265881,11,852,0.3204441084545342
2022-05-15,LU,Luxembourg,3233,269114,2,854,0.31733763386520214
2022-05-22,LU,Luxembourg,2283,271397,5,859,0.31651049937913833
2022-05-29,LU,Luxembourg,1433,272830,4,863,0.31631418832239855
2022-06-05,LU,Luxembourg,2482,275312,4,867,0.31491544139013194
2022-06-12,LU,Luxembourg,3668,278980,4,871,0.31220876048462254
2022-06-19,LU,Luxembourg,5283,284263,2,873,0.30710996506756066
2022-06-26,LU,Luxembourg,5981,290244,7,880,0.303193175397252
2022-07-03,LU,Luxembourg,7840,298084,4,884,0.29656070101045345
2022-07-10,LU,Luxembourg,7799,305883,5,889,0.29063400058192185
2022-07-17,LU,Luxembourg,6680,312563,1,890,0.28474259589266804
2022-07-24,LU,Luxembourg,4808,317371,3,893,0.28137416462121617
2022-07-31,LU,Luxembourg,2769,320140,3,896,0.27987755357031296
2022-08-07,LU,Luxembourg,1782,321922,3,899,0.2792601934630128
2022-08-14,LU,Luxembourg,1244,323166,0,899,0.27818520512677697
2022-08-21,LU,Luxembourg,1082,324248,2,901,0.2778737262835854
2022-08-28,LU,Luxembourg,1112,325360,0,901,0.2769240226210966
2022-09-04,LU,Luxembourg,1046,326406,2,903,0.27664932629914896
2022-09-11,LU,Luxembourg,1105,327511,0,903,0.2757159301519644
2022-09-18,LU,Luxembourg,1453,328964,2,905,0.27510609063605745
2022-09-25,LU,Luxembourg,1951,330915,1,906,0.2737863197497847
2022-10-02,LU,Luxembourg,3246,334161,1,907,0.27142604912003493
2022-10-09,LU,Luxembourg,4358,338519,2,909,0.26852259400506323
2022-10-16,LU,Luxembourg,4038,342557,4,913,0.26652498708244177
2022-10-23,LU,Luxembourg,3416,345973,5,918,0.265338624690366
2022-10-30,LU,Luxembourg,2323,348296,2,920,0.26414314261432803
2022-11-06,LU,Luxembourg,1362,349658,4,924,0.2642582180301895
2022-11-13,LU,Luxembourg,1461,351119,3,927,0.2640130554028691
2022-11-20,LU,Luxembourg,1705,352824,4,931,0.2638709384849103
2022-11-27,LU,Luxembourg,1938,354762,2,933,0.26299321798839786
2022-12-04,LU,Luxembourg,2026,356788,8,941,0.26374205410495866
2022-12-11,LU,Luxembourg,2517,359305,2,943,0.2624511209139867
2022-12-18,LU,Luxembourg,2689,361994,4,947,0.2616065459648502
2022-12-25,LU,Luxembourg,2873,364867,8,955,0.26173920908166537
2023-01-01,LU,Luxembourg,1373,366240,6,961,0.2623962429008301
2023-01-08,LU,Luxembourg,1053,367293,7,968,0.2635498090080671
2023-01-15,LU,Luxembourg,672,367965,4,972,0.26415555827320536
2023-01-22,LU,Luxembourg,551,368516,5,977,0.26511738974698523
2023-01-29,LU,Luxembourg,646,369162,3,980,0.26546610972960377
2023-02-05,LU,Luxembourg,849,370011,2,982,0.2653975152090073
2023-02-12,LU,Luxembourg,940,370951,2,984,0.2652641453992576
2023-02-19,LU,Luxembourg,884,371835,1,985,0.26490244328801754
2023-02-26,LU,Luxembourg,1428,373263,5,990,0.26522853859075235
2023-03-05,LU,Luxembourg,1638,374901,1,991,0.26433645148986
2023-03-12,LU,Luxembourg,1818,376719,1,992,0.2633262458224831
2023-03-19,LU,Luxembourg,1798,378517,2,994,0.2626037932246108
2023-03-26,LU,Luxembourg,1575,380092,6,1000,0.26309419824674024
2023-04-02,LU,Luxembourg,1012,381104,0,1000,0.2623955665645073
2023-04-09,LU,Luxembourg,313,381417,0,1000,0.2621802384267088
2023-04-16,LU,Luxembourg,232,381649,0,1000,0.2620208621010405
2023-04-23,LU,Luxembourg,244,381893,0,1000,0.26185345109755875
2023-04-30,LU,Luxembourg,208,382101,0,1000,0.2617109088958155
2023-05-07,LU,Luxembourg,198,382299,0,1000,0.2615753637859372
2023-05-14,LU,Luxembourg,152,382451,0,1000,0.26147140417988185
2023-05-21,LU,Luxembourg,100,382551,0,1000,0.2614030547560979
2023-05-28,LU,Luxembourg,106,382657,0,1000,0.2613306433699109
2023-06-04,LU,Luxembourg,44,382701,0,1000,0.26130059759446667
2023-06-11,LU,Luxembourg,44,382745,0,1000,0.2612705587270898
2023-06-18,LU,Luxembourg,40,382785,0,1000,0.2612432566584375
2023-06-25,LU,Luxembourg,28,382813,0,1000,0.26122414860519366
2023-07-02,LU,Luxembourg,30,382843,0,1000,0.26120367879261214
2023-07-09,LU,Luxembourg,36,382879,0,1000,0.26117911925177406
2023-07-16,LU,Luxembourg,34,382913,0,1000,0.26115592837015195
2023-07-23,LU,Luxembourg,33,382946,0,1000,0.2611334235114089
2023-07-30,LU,Luxembourg,74,383020,0,1000,0.2610829721685552
2023-08-06,LU,Luxembourg,59,383079,0,1000,0.26104276141474736
2023-08-13,LU,Luxembourg,67,383146,0,1000,0.2609971133719261
2023-08-20,LU,Luxembourg,119,383265,0,1000,0.26091607634404396
2023-08-27,LU,Luxembourg,135,383400,0,1000,0.2608242044861763
2023-09-03,LU,Luxembourg,189,383589,0,1000,0.2606956925250724
2023-09-10,LU,Luxembourg,246,383835,0,1000,0.26052861255487386
2023-09-17,LU,Luxembourg,267,384102,0,1000,0.26034751185882915
2023-09-24,LU,Luxembourg,308,384410,0,1000,0.2601389141801722
2023-10-01,LU,Luxembourg,355,384765,0,1000,0.25989889932816135
2023-10-08,LU,Luxembourg,372,385137,0,1000,0.25964786556472114
2023-10-15,LU,Luxembourg,350,385487,0,1000,0.25941212025308247
2023-10-22,LU,Luxembourg,259,385746,0,1000,0.2592379441394078
2023-10-29,LU,Luxembourg,284,386030,0,1000,0.2590472243089915
2023-11-05,LU,Luxembourg,195,386225,0,1000,0.2589164347206939
2023-11-12,LU,Luxembourg,294,386519,0,1000,0.25871949373769465
2023-11-19,LU,Luxembourg,259,386778,0,1000,0.2585462461670519
2023-11-26,LU,Luxembourg,319,387097,0,1000,0.25833318263897675
2023-12-03,LU,Luxembourg,460,387557,0,1000,0.2580265612542155
2023-12-10,LU,Luxembourg,658,388215,0,1000,0.257589222466932
2023-12-17,LU,Luxembourg,790,389005,0,1000,0.2570661045487847
2023-12-24,LU,Luxembourg,686,389691,0,1000,0.2566135733183471
2023-12-31,LU,Luxembourg,338,390029,0,1000,0.2563911914242274
2024-01-07,LU,Luxembourg,240,390269,0,1000,0.25623352098168184
2024-01-14,LU,Luxembourg,0,390269,0,1000,0.25623352098168184
2020-05-03,MG,Madagascar,25,149,1,1,0.6711409395973155
2020-05-10,MG,Madagascar,20,169,0,1,0.591715976331361
2020-05-17,MG,Madagascar,114,283,0,1,0.35335689045936397
2020-05-24,MG,Madagascar,205,488,2,3,0.6147540983606558
2020-05-31,MG,Madagascar,270,758,3,6,0.79155672823219
2020-06-07,MG,Madagascar,268,1026,2,8,0.7797270955165692
2020-06-14,MG,Madagascar,226,1252,2,10,0.7987220447284344
2020-06-21,MG,Madagascar,251,1503,3,13,0.8649367930805056
2020-06-28,MG,Madagascar,502,2005,3,16,0.798004987531172
2020-07-05,MG,Madagascar,936,2941,13,29,0.986059163549813
2020-07-12,MG,Madagascar,1637,4578,5,34,0.7426823940585409
2020-07-19,MG,Madagascar,2271,6849,21,55,0.8030369396992261
2020-07-26,MG,Madagascar,2017,8866,23,78,0.8797653958944283
2020-08-02,MG,Madagascar,2407,11273,29,107,0.9491705845826311
2020-06-07,MW,Malawi,130,409,0,4,0.9779951100244498
2020-06-14,MW,Malawi,120,529,1,5,0.945179584120983
2020-03-22,MY,Malaysia,945,1183,10,10,0.84530853761623
2020-10-18,MY,Malaysia,4531,19627,25,180,0.9171039894023539
2020-10-25,MY,Malaysia,6115,25742,41,221,0.8585191515810737
2020-11-01,MY,Malaysia,5806,31548,28,249,0.7892734880182578
2020-11-08,MY,Malaysia,7809,39357,33,282,0.7165180272886653
2020-11-15,MY,Malaysia,6852,46209,24,306,0.6622086606505226
2020-11-22,MY,Malaysia,7470,53679,26,332,0.6184914025969187
2020-11-29,MY,Malaysia,9497,63176,22,354,0.5603393693807776
2020-12-06,MY,Malaysia,8183,71359,26,380,0.5325186731876849
2020-12-13,MY,Malaysia,10887,82246,31,411,0.49972035114169683
2020-12-20,MY,Malaysia,9723,91969,22,433,0.4708108166882319
2020-12-27,MY,Malaysia,11931,103900,18,451,0.4340712223291627
2021-01-03,MY,Malaysia,15177,119077,32,483,0.4056198930104051
2021-01-10,MY,Malaysia,16915,135992,59,542,0.3985528560503559
2021-01-17,MY,Malaysia,22442,158434,52,594,0.3749195248494641
2021-01-24,MY,Malaysia,25367,183801,73,667,0.36289247610187103
2021-01-31,MY,Malaysia,31158,214959,79,746,0.34704292446466534
2021-02-07,MY,Malaysia,27493,242452,111,857,0.35347202745285666
2021-02-14,MY,Malaysia,21817,264269,101,958,0.36250941275745546
2021-02-21,MY,Malaysia,19300,283569,93,1051,0.37063289710793496
2021-02-28,MY,Malaysia,17183,300752,70,1121,0.37273235090705964
2021-03-07,MY,Malaysia,12708,313460,45,1166,0.3719772857780897
2021-03-14,MY,Malaysia,10303,323763,40,1206,0.3724946951937065
2021-03-21,MY,Malaysia,9277,333040,23,1229,0.36902474177276
2021-03-28,MY,Malaysia,8904,341944,22,1251,0.36584937884565893
2021-04-04,MY,Malaysia,9015,350959,35,1286,0.3664245681119447
2021-04-11,MY,Malaysia,9897,360856,35,1321,0.3660740018178997
2021-04-18,MY,Malaysia,14198,375054,49,1370,0.3652807329077946
2021-04-25,MY,Malaysia,17888,392942,56,1426,0.3629034310407134
2021-05-02,MY,Malaysia,22070,415012,107,1533,0.3693869092941891
2021-05-09,MY,Malaysia,25665,440677,150,1683,0.3819123757309775
2021-05-16,MY,Malaysia,29433,470110,219,1902,0.40458616068579695
2021-05-23,MY,Malaysia,41981,512091,346,2248,0.4389844773682802
2021-05-30,MY,Malaysia,53442,565533,481,2729,0.48255362640199595
2021-06-06,MY,Malaysia,51282,616815,649,3378,0.5476520512633447
2021-06-13,MY,Malaysia,40693,657508,530,3908,0.5943653917518874
2021-06-20,MY,Malaysia,38900,696408,500,4408,0.6329622864757442
2021-06-27,MY,Malaysia,37640,734048,536,4944,0.6735254370286412
2021-07-04,MY,Malaysia,44604,778652,553,5497,0.7059636397260908
2021-07-11,MY,Malaysia,57644,836296,661,6158,0.7363421563656887
2021-07-18,MY,Malaysia,80265,916561,861,7019,0.765797366460061
2021-07-25,MY,Malaysia,96877,1013438,975,7994,0.7888001041997635
2021-08-01,MY,Malaysia,116984,1130422,1190,9184,0.8124399560518106
2021-08-08,MY,Malaysia,132118,1262540,1565,10749,0.8513789662109715
2021-08-15,MY,Malaysia,142359,1404899,1761,12510,0.8904554704644247
2021-08-22,MY,Malaysia,150194,1555093,1658,14168,0.9110709134437619
2021-08-29,MY,Malaysia,150996,1706089,1919,16087,0.942916811491077
2021-09-05,MY,Malaysia,138746,1844835,2132,18219,0.9875679938856321
2022-02-27,MY,Malaysia,197956,3419636,327,32674,0.955481811514442
2022-03-06,MY,Malaysia,202971,3622607,554,33228,0.9172399876663409
2022-03-13,MY,Malaysia,200964,3823571,579,33807,0.8841734598363676
2022-03-20,MY,Malaysia,169553,3993124,593,34400,0.8614808856424193
2022-03-27,MY,Malaysia,145743,4138867,388,34788,0.840519881407158
2022-04-03,MY,Malaysia,107600,4246467,311,35099,0.8265459262959067
2022-04-10,MY,Malaysia,79351,4325818,193,35292,0.8158456966982893
2022-04-17,MY,Malaysia,63207,4389025,129,35421,0.8070357311703625
2022-04-24,MY,Malaysia,42048,4431073,78,35499,0.8011377831058075
2022-05-01,MY,Malaysia,18434,4449507,51,35550,0.7989649190348505
2022-05-08,MY,Malaysia,9382,4458889,33,35583,0.7980239023667106
2022-05-15,MY,Malaysia,19223,4478112,32,35615,0.7953128461280111
2022-05-22,MY,Malaysia,13208,4491320,28,35643,0.7935974279276472
2022-05-29,MY,Malaysia,12414,4503734,22,35665,0.791898455814664
2022-06-05,MY,Malaysia,11255,4514989,25,35690,0.790478116336496
2022-06-12,MY,Malaysia,11309,4526298,26,35716,0.7890775198628106
2022-06-19,MY,Malaysia,14314,4540612,19,35735,0.7870084473194362
2022-06-26,MY,Malaysia,16052,4556664,19,35754,0.784652982971753
2022-07-03,MY,Malaysia,14691,4571355,30,35784,0.7827875979879051
2022-07-10,MY,Malaysia,21355,4592710,32,35816,0.7798445797796943
2022-07-17,MY,Malaysia,26315,4619025,46,35862,0.7763976163800802
2022-07-24,MY,Malaysia,29906,4648931,61,35923,0.77271527583438
2022-07-31,MY,Malaysia,28339,4677270,54,35977,0.769188009244709
2022-08-07,MY,Malaysia,28554,4705824,55,36032,0.7656894945497325
2022-08-14,MY,Malaysia,26678,4732502,61,36093,0.7626621182621793
2022-08-21,MY,Malaysia,22786,4755288,62,36155,0.7603114679910029
2022-08-28,MY,Malaysia,18715,4774003,51,36206,0.7583991882703047
2022-09-04,MY,Malaysia,15549,4789552,43,36249,0.7568348772494797
2022-09-11,MY,Malaysia,14072,4803624,36,36285,0.755367197765687
2022-09-18,MY,Malaysia,13627,4817251,32,36317,0.7538947005252581
2022-09-25,MY,Malaysia,12963,4830214,40,36357,0.7526995698327238
2022-10-02,MY,Malaysia,12291,4842505,23,36380,0.7512640668414384
2022-10-09,MY,Malaysia,11018,4853523,23,36403,0.7500325021638921
2022-10-16,MY,Malaysia,11957,4865480,20,36423,0.7486003436454368
2022-10-23,MY,Malaysia,14525,4880005,24,36447,0.7468639888688638
2022-10-30,MY,Malaysia,16750,4896755,28,36475,0.7448810487761793
2022-11-06,MY,Malaysia,26783,4923538,20,36495,0.7412352661846014
2022-11-13,MY,Malaysia,23045,4946583,59,36554,0.738974762982851
2022-11-20,MY,Malaysia,19083,4965666,55,36609,0.7372424967768674
2022-11-27,MY,Malaysia,18606,4984272,48,36657,0.7354534423482506
2022-12-04,MY,Malaysia,14558,4998830,59,36716,0.7344918710978369
2022-12-11,MY,Malaysia,10937,5009767,53,36769,0.7339463092794535
2022-12-18,MY,Malaysia,7249,5017016,39,36808,0.7336631974065859
2022-12-25,MY,Malaysia,6290,5023306,27,36835,0.733282025821242
2023-01-01,MY,Malaysia,3371,5026677,23,36858,0.733247829530324
2023-01-08,MY,Malaysia,3231,5029908,8,36866,0.7329358707952511
2023-01-15,MY,Malaysia,2525,5032433,0,36866,0.7325681236093953
2023-01-22,MY,Malaysia,2088,5034521,0,36866,0.7322643008143178
2023-01-29,MY,Malaysia,1350,5035871,0,36866,0.7320679977703957
2023-02-05,MY,Malaysia,1913,5037784,77,36943,0.733318459068511
2023-02-12,MY,Malaysia,1542,5039326,8,36951,0.7332528199207593
2023-02-19,MY,Malaysia,1495,5040821,5,36956,0.7331345429643306
2023-02-26,MY,Malaysia,1367,5042188,1,36957,0.7329556137137291
2023-03-05,MY,Malaysia,1438,5043626,9,36966,0.7329250820738888
2023-03-12,MY,Malaysia,1566,5045192,1,36967,0.7327174069886736
2023-03-19,MY,Malaysia,1848,5047040,0,36967,0.7324491186913518
2023-03-26,MY,Malaysia,2228,5049268,12,36979,0.7323635822063713
2023-04-02,MY,Malaysia,3069,5052337,0,36979,0.7319187140525265
2023-04-09,MY,Malaysia,4574,5056911,3,36982,0.7313160148557094
2023-04-16,MY,Malaysia,4268,5061179,12,36994,0.7309364082953793
2023-04-23,MY,Malaysia,5698,5066877,17,37011,0.7304499398742065
2023-04-30,MY,Malaysia,4817,5071694,9,37020,0.7299336276991475
2023-05-07,MY,Malaysia,146,5071840,8,37028,0.7300703492223729
2023-05-14,MY,Malaysia,7596,5079436,0,37028,0.7289785716366936
2023-05-21,MY,Malaysia,12209,5091645,42,37070,0.7280554712671445
2023-05-28,MY,Malaysia,6439,5098084,31,37101,0.7277439916643194
2023-06-04,MY,Malaysia,5801,5103885,15,37116,0.7272107424050502
2023-06-11,MY,Malaysia,4523,5108408,10,37126,0.7267626235022732
2023-06-18,MY,Malaysia,760,5109168,10,37136,0.726850242544383
2023-06-25,MY,Malaysia,3433,5112601,11,37147,0.7265773331421717
2023-07-02,MY,Malaysia,0,5112601,2,37149,0.7266164521737566
2023-07-09,MY,Malaysia,2698,5115299,7,37156,0.7263700518777103
2023-07-16,MY,Malaysia,1548,5116847,2,37158,0.7261893896768851
2023-07-23,MY,Malaysia,1222,5118069,3,37161,0.7260746191581239
2023-07-30,MY,Malaysia,1202,5119271,1,37162,0.7259236715540162
2023-08-06,MY,Malaysia,958,5120229,2,37164,0.7258269112572895
2023-08-13,MY,Malaysia,934,5121163,0,37164,0.7256945346203587
2023-08-20,MY,Malaysia,695,5121858,0,37164,0.7255960629912036
2023-08-27,MY,Malaysia,710,5122568,0,37164,0.7254954936664579
2023-09-03,MY,Malaysia,1233,5123801,3,37167,0.7253794595067217
2023-09-10,MY,Malaysia,680,5124481,4,37171,0.725361260974526
2023-09-17,MY,Malaysia,728,5125209,1,37172,0.7252777398931438
2023-09-24,MY,Malaysia,691,5125900,0,37172,0.7251799683957939
2023-10-01,MY,Malaysia,783,5126683,2,37174,0.7251082229972089
2023-10-08,MY,Malaysia,933,5127616,5,37179,0.7250737964777394
2023-10-15,MY,Malaysia,1052,5128668,2,37181,0.7249640647435163
2023-10-22,MY,Malaysia,1132,5129800,3,37184,0.7248625677414324
2023-10-29,MY,Malaysia,1339,5131139,0,37184,0.724673410718361
2023-11-05,MY,Malaysia,1692,5132831,6,37190,0.7245514220125306
2023-11-12,MY,Malaysia,1801,5134632,1,37191,0.7243167572671225
2023-11-19,MY,Malaysia,2305,5136937,3,37194,0.7240501489506296
2023-11-26,MY,Malaysia,3626,5140563,7,37201,0.7236755974005182
2023-12-03,MY,Malaysia,6796,5147359,6,37207,0.722836701306437
2023-12-10,MY,Malaysia,12757,5160116,11,37218,0.7212628553311592
2023-12-17,MY,Malaysia,20696,5180812,28,37246,0.7189220531453371
2023-12-24,MY,Malaysia,25912,5206724,22,37268,0.7157667662046231
2023-12-31,MY,Malaysia,20598,5227322,25,37293,0.7134245795457024
2024-01-07,MY,Malaysia,0,5227322,22,37315,0.713845445143804
2024-01-14,MY,Malaysia,17256,5244578,0,37315,0.7114967114608649
2020-05-03,MV,Maldives,339,527,1,1,0.18975332068311196
2020-05-10,MV,Maldives,308,835,2,3,0.3592814371257485
2020-05-17,MV,Maldives,259,1094,1,4,0.3656307129798903
2020-05-24,MV,Maldives,277,1371,0,4,0.29175784099197666
2020-05-31,MV,Maldives,301,1672,1,5,0.29904306220095694
2020-06-07,MV,Maldives,231,1903,3,8,0.42038885969521805
2020-06-14,MV,Maldives,132,2035,0,8,0.3931203931203931
2020-06-21,MV,Maldives,168,2203,0,8,0.3631411711302769
2020-06-28,MV,Maldives,121,2324,0,8,0.34423407917383825
2020-07-05,MV,Maldives,144,2468,3,11,0.44570502431118314
2020-07-12,MV,Maldives,263,2731,2,13,0.4760161113145368
2020-07-19,MV,Maldives,235,2966,2,15,0.5057316250842886
2020-07-26,MV,Maldives,336,3302,0,15,0.4542701393095093
2020-08-02,MV,Maldives,862,4164,3,18,0.43227665706051877
2020-08-09,MV,Maldives,877,5041,1,19,0.3769093433842492
2020-08-16,MV,Maldives,744,5785,3,22,0.3802938634399309
2020-08-23,MV,Maldives,994,6779,4,26,0.38353739489600236
2020-08-30,MV,Maldives,888,7667,2,28,0.36520151297769665
2020-09-06,MV,Maldives,917,8584,1,29,0.33783783783783783
2020-09-13,MV,Maldives,589,9173,3,32,0.34884988553363133
2020-09-20,MV,Maldives,551,9724,1,33,0.3393665158371041
2020-09-27,MV,Maldives,374,10098,1,34,0.33670033670033667
2020-10-04,MV,Maldives,432,10530,0,34,0.3228869895536562
2020-10-11,MV,Maldives,364,10894,1,35,0.3212777675784836
2020-10-18,MV,Maldives,316,11210,2,37,0.3300624442462088
2020-10-25,MV,Maldives,295,11505,0,37,0.32159930465015213
2020-11-01,MV,Maldives,196,11701,1,38,0.32475856764379113
2020-11-08,MV,Maldives,285,11986,2,40,0.3337226764558652
2020-11-15,MV,Maldives,218,12204,3,43,0.3523434939364143
2020-11-22,MV,Maldives,404,12608,3,46,0.36484771573604063
2020-11-29,MV,Maldives,386,12994,0,46,0.3540095428659381
2020-12-06,MV,Maldives,204,13198,1,47,0.35611456281254733
2020-12-13,MV,Maldives,170,13368,1,48,0.3590664272890485
2020-12-20,MV,Maldives,125,13493,0,48,0.35574001334025046
2020-12-27,MV,Maldives,151,13644,0,48,0.3518029903254178
2021-01-03,MV,Maldives,223,13867,0,48,0.34614552534794835
2021-01-10,MV,Maldives,242,14109,1,49,0.3472960521652846
2021-01-17,MV,Maldives,404,14513,0,49,0.3376283332184937
2021-01-24,MV,Maldives,480,14993,2,51,0.3401587407456813
2021-01-31,MV,Maldives,848,15841,1,52,0.3282621046651095
2021-02-07,MV,Maldives,942,16783,3,55,0.32771256628731454
2021-02-14,MV,Maldives,1045,17828,3,58,0.3253309400942338
2021-02-21,MV,Maldives,941,18769,2,60,0.3196760615909212
2021-02-28,MV,Maldives,1024,19793,2,62,0.3132420552720659
2021-03-07,MV,Maldives,1001,20794,2,64,0.30778109069924015
2021-03-14,MV,Maldives,778,21572,0,64,0.2966808826256258
2021-03-21,MV,Maldives,941,22513,2,66,0.29316394971794074
2021-03-28,MV,Maldives,1011,23524,0,66,0.28056452984186364
2021-04-04,MV,Maldives,1259,24783,1,67,0.27034660856232096
2021-04-11,MV,Maldives,834,25617,0,67,0.26154506772846153
2021-04-18,MV,Maldives,731,26348,3,70,0.2656748140276302
2021-04-25,MV,Maldives,1526,27874,1,71,0.2547176580325751
2021-05-02,MV,Maldives,2871,30745,3,74,0.2406895430151244
2021-05-09,MV,Maldives,5070,35815,10,84,0.23453860114477174
2021-05-16,MV,Maldives,8708,44523,13,97,0.2178649237472767
2021-05-23,MV,Maldives,11401,55924,32,129,0.23067019526500251
2021-05-30,MV,Maldives,7762,63686,29,158,0.24809220236786736
2021-06-06,MV,Maldives,4264,67950,27,185,0.27225901398086827
2021-06-13,MV,Maldives,2351,70301,12,197,0.2802236099059757
2021-06-20,MV,Maldives,1595,71896,9,206,0.2865249805274285
2021-06-27,MV,Maldives,1431,73327,3,209,0.2850246157622704
2021-07-04,MV,Maldives,1024,74351,4,213,0.28647899826498635
2021-07-11,MV,Maldives,720,75071,1,214,0.28506347324532777
2021-07-18,MV,Maldives,808,75879,2,216,0.2846637409559957
2021-07-25,MV,Maldives,871,76750,3,219,0.2853420195439739
2021-08-01,MV,Maldives,797,77547,2,221,0.28498845861219646
2021-08-08,MV,Maldives,809,78356,1,222,0.2833222727040686
2021-08-15,MV,Maldives,781,79137,0,222,0.28052617612494785
2021-08-22,MV,Maldives,822,79959,1,223,0.2788929326279718
2021-08-29,MV,Maldives,832,80791,3,226,0.2797341288014754
2021-09-05,MV,Maldives,1188,81979,0,226,0.27568035716463973
2021-09-12,MV,Maldives,843,82822,1,227,0.2740817657144237
2021-09-19,MV,Maldives,754,83576,2,229,0.27400210586771323
2021-09-26,MV,Maldives,786,84362,2,231,0.2738199663355539
2021-10-03,MV,Maldives,680,85042,0,231,0.27163048846452337
2021-10-10,MV,Maldives,506,85548,3,234,0.2735306494599523
2021-10-17,MV,Maldives,617,86165,4,238,0.2762142401206986
2021-10-24,MV,Maldives,757,86922,2,240,0.27610961551736035
2021-10-31,MV,Maldives,862,87784,3,243,0.27681582065068805
2021-11-07,MV,Maldives,1033,88817,2,245,0.2758480921445219
2021-11-14,MV,Maldives,1023,89840,2,247,0.27493321460374
2021-11-21,MV,Maldives,885,90725,1,248,0.27335354092036374
2021-11-28,MV,Maldives,739,91464,0,248,0.2711449313391061
2021-12-05,MV,Maldives,747,92211,6,254,0.2754552059949464
2021-12-12,MV,Maldives,908,93119,4,258,0.2770648310226699
2021-12-19,MV,Maldives,838,93957,1,259,0.2756580137722575
2021-12-26,MV,Maldives,907,94864,2,261,0.27513071344240175
2022-01-02,MV,Maldives,1188,96052,1,262,0.27276891683671345
2022-01-09,MV,Maldives,2000,98052,2,264,0.2692448904662832
2022-01-16,MV,Maldives,5529,103581,1,265,0.2558384259661521
2022-01-23,MV,Maldives,13880,117461,5,270,0.22986352917138456
2022-01-30,MV,Maldives,18665,136126,5,275,0.20201871795248522
2022-02-06,MV,Maldives,14211,150337,8,283,0.18824374571795366
2022-02-13,MV,Maldives,8724,159061,6,289,0.18169130082169735
2022-02-20,MV,Maldives,6012,165073,2,291,0.17628564332143962
2022-02-27,MV,Maldives,4559,169632,6,297,0.1750848896434635
2022-03-06,MV,Maldives,2944,172576,0,297,0.1720980901168181
2022-03-13,MV,Maldives,2082,174658,0,297,0.1700466053659151
2022-03-20,MV,Maldives,1341,175999,0,297,0.16875095881226598
2022-03-27,MV,Maldives,1104,177103,1,298,0.16826366577641258
2022-04-03,MV,Maldives,656,177759,0,298,0.16764270726095443
2022-04-10,MV,Maldives,718,178477,0,298,0.16696829283325024
2022-04-17,MV,Maldives,441,178918,0,298,0.16655674666607048
2022-04-24,MV,Maldives,282,179200,0,298,0.16629464285714285
2022-05-01,MV,Maldives,179,179379,0,298,0.16612869956906884
2022-05-08,MV,Maldives,123,179502,0,298,0.166014863344141
2022-05-15,MV,Maldives,67,179569,0,298,0.16595292060433592
2022-05-22,MV,Maldives,101,179670,0,298,0.16585963154672453
2022-05-29,MV,Maldives,95,179765,0,298,0.1657719800851111
2022-06-05,MV,Maldives,90,179855,1,299,0.16624503071919045
2022-06-12,MV,Maldives,160,180015,0,299,0.16609726967197178
2022-06-19,MV,Maldives,528,180543,1,300,0.16616540104019542
2022-06-26,MV,Maldives,1043,181586,5,305,0.16796449065456587
2022-07-03,MV,Maldives,1134,182720,1,306,0.1674693520140105
2022-07-10,MV,Maldives,771,183491,1,307,0.16731065828841743
2022-07-17,MV,Maldives,417,183908,0,307,0.16693129173282292
2022-07-24,MV,Maldives,394,184302,0,307,0.1665744267560851
2022-07-31,MV,Maldives,183,184485,0,307,0.16640919315933544
2022-08-07,MV,Maldives,106,184591,0,307,0.16631363392581436
2022-08-14,MV,Maldives,98,184689,0,307,0.16622538429467917
2022-08-21,MV,Maldives,99,184788,0,307,0.16613632919886573
2022-08-28,MV,Maldives,68,184856,1,308,0.16661617691608605
2022-09-04,MV,Maldives,68,184924,0,308,0.16655490904371525
2022-09-11,MV,Maldives,42,184966,0,308,0.16651708962728284
2022-09-18,MV,Maldives,38,185004,0,308,0.1664828868565004
2022-09-25,MV,Maldives,38,185042,0,308,0.16644869813339674
2022-10-02,MV,Maldives,40,185082,0,308,0.166412725170465
2022-10-09,MV,Maldives,43,185125,0,308,0.1663740715732613
2022-10-16,MV,Maldives,69,185194,0,308,0.16631208354482327
2022-10-23,MV,Maldives,86,185280,0,308,0.1662348877374784
2022-10-30,MV,Maldives,84,185364,0,308,0.16615955633240545
2022-11-06,MV,Maldives,90,185454,1,309,0.16661813711216797
2022-11-13,MV,Maldives,95,185549,1,310,0.1670717707990881
2022-11-20,MV,Maldives,35,185584,1,311,0.16757910164669368
2022-11-27,MV,Maldives,34,185618,0,311,0.16754840586581043
2022-12-04,MV,Maldives,14,185632,0,311,0.1675357696948802
2022-12-11,MV,Maldives,19,185651,0,311,0.1675186236540606
2022-12-18,MV,Maldives,15,185666,0,311,0.16750508978488252
2022-12-25,MV,Maldives,12,185678,0,311,0.16749426426394082
2023-01-01,MV,Maldives,15,185693,0,311,0.1674807343303194
2023-01-08,MV,Maldives,9,185702,0,311,0.1674726174193062
2023-01-15,MV,Maldives,6,185708,0,311,0.16746720658237663
2023-01-22,MV,Maldives,5,185713,0,311,0.1674626978186772
2023-01-29,MV,Maldives,2,185715,0,311,0.16746089438117545
2023-02-05,MV,Maldives,6,185721,0,311,0.16745548430172139
2023-02-12,MV,Maldives,2,185723,0,311,0.1674536810195829
2023-02-19,MV,Maldives,6,185729,0,311,0.1674482714061886
2023-02-26,MV,Maldives,3,185732,0,311,0.16744556673055802
2023-03-05,MV,Maldives,6,185738,0,311,0.16744015764140885
2023-03-12,MV,Maldives,6,185744,0,311,0.1674347489017142
2023-03-19,MV,Maldives,11,185755,0,311,0.16742483378643913
2023-03-26,MV,Maldives,16,185771,0,311,0.16741041389667927
2023-04-02,MV,Maldives,39,185810,0,311,0.1673752758193854
2023-04-09,MV,Maldives,84,185894,0,311,0.16729964388307314
2023-04-16,MV,Maldives,148,186042,0,311,0.1671665537889294
2023-04-23,MV,Maldives,199,186241,2,313,0.16806181238288026
2023-04-30,MV,Maldives,194,186435,0,313,0.16788693110199265
2023-05-07,MV,Maldives,91,186526,1,314,0.16834114278974513
2023-05-14,MV,Maldives,63,186589,0,314,0.16828430400505925
2023-05-21,MV,Maldives,36,186625,1,315,0.16878767582049564
2023-05-28,MV,Maldives,26,186651,0,315,0.1687641641352042
2023-06-04,MV,Maldives,21,186672,1,316,0.16928087768920888
2023-06-11,MV,Maldives,11,186683,0,316,0.16927090308169462
2023-06-18,MV,Maldives,0,186683,0,316,0.16927090308169462
2023-06-25,MV,Maldives,0,186683,0,316,0.16927090308169462
2023-07-02,MV,Maldives,4,186687,0,316,0.16926727624312352
2023-07-09,MV,Maldives,0,186687,0,316,0.16926727624312352
2023-07-16,MV,Maldives,0,186687,0,316,0.16926727624312352
2023-07-23,MV,Maldives,0,186687,0,316,0.16926727624312352
2023-07-30,MV,Maldives,0,186687,0,316,0.16926727624312352
2023-08-06,MV,Maldives,7,186694,0,316,0.16926092964958703
2023-08-13,MV,Maldives,0,186694,0,316,0.16926092964958703
2023-08-20,MV,Maldives,0,186694,0,316,0.16926092964958703
2023-08-27,MV,Maldives,0,186694,0,316,0.16926092964958703
2023-09-03,MV,Maldives,0,186694,0,316,0.16926092964958703
2023-09-10,MV,Maldives,0,186694,0,316,0.16926092964958703
2023-09-17,MV,Maldives,0,186694,0,316,0.16926092964958703
2023-09-24,MV,Maldives,0,186694,0,316,0.16926092964958703
2023-10-01,MV,Maldives,0,186694,0,316,0.16926092964958703
2023-10-08,MV,Maldives,0,186694,0,316,0.16926092964958703
2023-10-15,MV,Maldives,0,186694,0,316,0.16926092964958703
2023-10-22,MV,Maldives,0,186694,0,316,0.16926092964958703
2023-10-29,MV,Maldives,0,186694,0,316,0.16926092964958703
2023-11-05,MV,Maldives,0,186694,0,316,0.16926092964958703
2023-11-12,MV,Maldives,0,186694,0,316,0.16926092964958703
2023-11-19,MV,Maldives,0,186694,0,316,0.16926092964958703
2023-11-26,MV,Maldives,0,186694,0,316,0.16926092964958703
2023-12-03,MV,Maldives,0,186694,0,316,0.16926092964958703
2023-12-10,MV,Maldives,0,186694,0,316,0.16926092964958703
2023-12-17,MV,Maldives,0,186694,0,316,0.16926092964958703
2023-12-24,MV,Maldives,0,186694,0,316,0.16926092964958703
2023-12-31,MV,Maldives,0,186694,0,316,0.16926092964958703
2024-01-07,MV,Maldives,0,186694,0,316,0.16926092964958703
2024-01-14,MV,Maldives,0,186694,0,316,0.16926092964958703
2020-04-12,MT,Malta,149,387,3,3,0.7751937984496124
2020-04-19,MT,Malta,44,431,0,3,0.6960556844547563
2020-04-26,MT,Malta,20,451,1,4,0.8869179600886918
2020-05-03,MT,Malta,30,481,0,4,0.8316008316008316
2020-05-24,MT,Malta,56,614,0,6,0.9771986970684038
2020-08-09,MT,Malta,243,1114,0,9,0.807899461400359
2020-08-16,MT,Malta,368,1482,0,9,0.6072874493927125
2020-08-23,MT,Malta,295,1777,1,10,0.5627462014631401
2020-08-30,MT,Malta,249,2026,2,12,0.5923000987166831
2020-09-06,MT,Malta,233,2259,3,15,0.6640106241699867
2020-09-13,MT,Malta,326,2585,1,16,0.6189555125725338
2020-09-20,MT,Malta,376,2961,6,22,0.7429922323539345
2020-10-18,MT,Malta,891,4921,2,46,0.9347693558219874
2020-10-25,MT,Malta,841,5762,8,54,0.9371745921555016
2022-01-02,MT,Malta,8118,55554,5,498,0.8964250999027973
2022-01-09,MT,Malta,5468,61022,11,509,0.8341253973976599
2022-01-16,MT,Malta,2968,63990,18,527,0.8235661822159712
2022-01-23,MT,Malta,2073,66063,26,553,0.8370797572014593
2022-01-30,MT,Malta,1641,67704,15,568,0.8389460002363229
2022-02-06,MT,Malta,1428,69132,22,590,0.8534397963316555
2022-02-13,MT,Malta,823,69955,20,610,0.8719891358730614
2022-02-20,MT,Malta,637,70592,7,617,0.8740367180417045
2022-02-27,MT,Malta,540,71132,8,625,0.8786481471067874
2022-03-06,MT,Malta,664,71796,4,629,0.876093375675525
2022-03-13,MT,Malta,962,72758,6,635,0.8727562604799473
2022-03-20,MT,Malta,1906,74664,8,643,0.8611914711239687
2022-03-27,MT,Malta,2570,77234,9,652,0.8441877929409327
2022-04-03,MT,Malta,4491,81725,10,662,0.8100336494340776
2022-04-10,MT,Malta,4557,86282,21,683,0.7915903664727288
2022-04-17,MT,Malta,2664,88946,13,696,0.7824972455197535
2022-04-24,MT,Malta,1764,90710,13,709,0.7816117296880167
2022-05-01,MT,Malta,1250,91960,10,719,0.7818616789908657
2022-05-08,MT,Malta,984,92944,11,730,0.7854191771389223
2022-05-15,MT,Malta,658,93602,4,734,0.7841712783914873
2022-05-22,MT,Malta,537,94139,4,738,0.7839471419921605
2022-05-29,MT,Malta,532,94671,4,742,0.7837669402456929
2022-06-05,MT,Malta,615,95286,2,744,0.7808072539512625
2022-06-12,MT,Malta,934,96220,3,747,0.7763458740386614
2022-06-19,MT,Malta,1720,97940,4,751,0.7667959975495201
2022-06-26,MT,Malta,3160,101100,10,761,0.7527200791295747
2022-07-03,MT,Malta,3860,104960,8,769,0.7326600609756098
2022-07-10,MT,Malta,3765,108725,11,780,0.7174063002989193
2022-07-17,MT,Malta,2275,111000,13,793,0.7144144144144144
2022-07-24,MT,Malta,1249,112249,13,806,0.7180464859375139
2022-07-31,MT,Malta,608,112857,9,815,0.7221528128516618
2022-08-07,MT,Malta,417,113274,1,816,0.7203771386196303
2022-08-14,MT,Malta,287,113561,2,818,0.7203177147083947
2022-08-21,MT,Malta,242,113803,2,820,0.7205433951653296
2022-08-28,MT,Malta,189,113992,2,822,0.721103235314759
2022-09-04,MT,Malta,139,114131,1,823,0.7211011907369602
2022-09-11,MT,Malta,130,114261,0,823,0.7202807607145045
2022-09-18,MT,Malta,149,114410,2,825,0.7210908137400577
2022-09-25,MT,Malta,156,114566,0,825,0.7201089328422045
2022-10-02,MT,Malta,155,114721,2,827,0.7208793507727443
2022-10-09,MT,Malta,146,114867,0,827,0.7199630877449572
2022-10-16,MT,Malta,147,115014,0,827,0.7190428991253239
2022-10-23,MT,Malta,184,115198,2,829,0.7196305491414782
2022-10-30,MT,Malta,141,115339,0,829,0.7187508128213353
2022-11-06,MT,Malta,123,115462,0,829,0.7179851379674698
2022-11-13,MT,Malta,128,115590,0,829,0.7171900683450125
2022-11-20,MT,Malta,98,115688,0,829,0.7165825323283314
2022-11-27,MT,Malta,81,115769,1,830,0.716944950720832
2022-12-04,MT,Malta,91,115860,0,830,0.7163818401519074
2022-12-11,MT,Malta,103,115963,0,830,0.7157455395255383
2022-12-18,MT,Malta,141,116104,2,832,0.7165989113208847
2022-12-25,MT,Malta,133,116237,2,834,0.7174995913521511
2023-01-01,MT,Malta,167,116404,4,838,0.7199065324215662
2023-01-08,MT,Malta,241,116645,4,842,0.7218483432637489
2023-01-15,MT,Malta,165,116810,1,843,0.7216847872613646
2023-01-22,MT,Malta,133,116943,2,845,0.7225742455726294
2023-01-29,MT,Malta,109,117052,0,845,0.7219013771657041
2023-02-05,MT,Malta,104,117156,2,847,0.7229676670422343
2023-02-12,MT,Malta,82,117238,0,847,0.722462000375305
2023-02-19,MT,Malta,90,117328,1,848,0.7227601254602481
2023-02-26,MT,Malta,139,117467,0,848,0.7219048754118178
2023-03-05,MT,Malta,133,117600,1,849,0.721938775510204
2023-03-12,MT,Malta,139,117739,0,849,0.7210864709229736
2023-03-19,MT,Malta,148,117887,2,851,0.7218777303689126
2023-03-26,MT,Malta,106,117993,1,852,0.7220767333655387
2023-04-02,MT,Malta,129,118122,0,852,0.7212881596992939
2023-04-09,MT,Malta,81,118203,1,853,0.7216398906965137
2023-04-16,MT,Malta,103,118306,1,854,0.7218568796172637
2023-04-23,MT,Malta,124,118430,1,855,0.721945453010217
2023-04-30,MT,Malta,83,118513,0,855,0.7214398420426451
2023-05-07,MT,Malta,50,118563,0,855,0.721135598795577
2023-05-14,MT,Malta,57,118620,0,855,0.7207890743550834
2023-05-21,MT,Malta,46,118666,1,856,0.7213523671481301
2023-05-28,MT,Malta,79,118745,1,857,0.7217145985094109
2023-06-04,MT,Malta,59,118804,2,859,0.7230396282953436
2023-06-11,MT,Malta,43,118847,1,860,0.7236194434861629
2023-06-18,MT,Malta,60,118907,1,861,0.7240953013699782
2023-06-25,MT,Malta,59,118966,0,861,0.7237361935342871
2023-07-02,MT,Malta,86,119052,3,864,0.725733293014817
2023-07-09,MT,Malta,60,119112,1,865,0.7262072671099469
2023-07-16,MT,Malta,102,119214,3,868,0.7281024040800577
2023-07-23,MT,Malta,74,119288,1,869,0.7284890349406479
2023-07-30,MT,Malta,135,119423,3,872,0.730177603979133
2023-08-06,MT,Malta,151,119574,1,873,0.730091825982237
2023-08-13,MT,Malta,150,119724,2,875,0.7308476161838896
2023-08-20,MT,Malta,140,119864,1,876,0.7308282720416472
2023-08-27,MT,Malta,180,120044,1,877,0.7305654593315785
2023-09-03,MT,Malta,134,120178,1,878,0.7305829685965818
2023-09-10,MT,Malta,107,120285,2,880,0.7315957933241883
2023-09-17,MT,Malta,62,120347,1,881,0.7320498225963256
2023-09-24,MT,Malta,75,120422,1,882,0.732424307850725
2023-10-01,MT,Malta,79,120501,0,882,0.7319441332437076
2023-10-08,MT,Malta,63,120564,1,883,0.7323910951859594
2023-10-15,MT,Malta,68,120632,0,883,0.7319782478944227
2023-10-22,MT,Malta,43,120675,2,885,0.7333747669359851
2023-10-29,MT,Malta,30,120705,0,885,0.7331924940971791
2023-11-05,MT,Malta,21,120726,0,885,0.733064957010089
2023-11-12,MT,Malta,21,120747,1,886,0.7337656422105725
2023-11-19,MT,Malta,13,120760,0,886,0.7336866512090096
2023-11-26,MT,Malta,22,120782,0,886,0.7335530128661555
2023-12-03,MT,Malta,12,120794,0,886,0.7334801397420402
2023-12-10,MT,Malta,28,120822,0,886,0.7333101587459238
2023-12-17,MT,Malta,40,120862,1,887,0.7338948552895037
2023-12-24,MT,Malta,61,120923,1,888,0.7343516121829594
2023-12-31,MT,Malta,99,121022,3,891,0.7362297764042901
2024-01-07,MT,Malta,110,121132,2,893,0.7372122973285341
2024-01-14,MT,Malta,0,121132,0,893,0.7372122973285341
2022-08-14,MH,Marshall Islands,758,826,5,5,0.6053268765133172
2022-08-21,MH,Marshall Islands,9086,9912,9,14,0.14124293785310735
2022-08-28,MH,Marshall Islands,4885,14797,2,16,0.10813002635669391
2022-09-04,MH,Marshall Islands,266,15063,1,17,0.11285932417181173
2022-09-11,MH,Marshall Islands,9,15072,0,17,0.11279193205944799
2022-09-18,MH,Marshall Islands,141,15213,0,17,0.11174653257082759
2022-09-25,MH,Marshall Islands,62,15275,0,17,0.11129296235679213
2022-10-02,MH,Marshall Islands,30,15305,0,17,0.11107481215289121
2022-10-09,MH,Marshall Islands,0,15305,0,17,0.11107481215289121
2022-10-16,MH,Marshall Islands,57,15362,0,17,0.11066267413097253
2022-10-23,MH,Marshall Islands,0,15362,0,17,0.11066267413097253
2022-10-30,MH,Marshall Islands,13,15375,0,17,0.11056910569105692
2022-11-06,MH,Marshall Islands,7,15382,0,17,0.11051878819399298
2022-11-13,MH,Marshall Islands,4,15386,0,17,0.11049005589496945
2022-11-20,MH,Marshall Islands,115,15501,0,17,0.10967034384878395
2022-11-27,MH,Marshall Islands,40,15541,0,17,0.10938807026574866
2022-12-04,MH,Marshall Islands,3,15544,0,17,0.10936695831188882
2022-12-11,MH,Marshall Islands,0,15544,0,17,0.10936695831188882
2022-12-18,MH,Marshall Islands,0,15544,0,17,0.10936695831188882
2022-12-25,MH,Marshall Islands,0,15544,0,17,0.10936695831188882
2023-01-01,MH,Marshall Islands,0,15544,0,17,0.10936695831188882
2023-01-08,MH,Marshall Islands,0,15544,0,17,0.10936695831188882
2023-01-15,MH,Marshall Islands,0,15544,0,17,0.10936695831188882
2023-01-22,MH,Marshall Islands,0,15544,0,17,0.10936695831188882
2023-01-29,MH,Marshall Islands,40,15584,0,17,0.10908624229979465
2023-02-05,MH,Marshall Islands,0,15584,0,17,0.10908624229979465
2023-02-12,MH,Marshall Islands,6,15590,0,17,0.10904425914047466
2023-02-19,MH,Marshall Islands,11,15601,0,17,0.10896737388628934
2023-02-26,MH,Marshall Islands,17,15618,0,17,0.10884876424638239
2023-03-05,MH,Marshall Islands,31,15649,0,17,0.10863313949773148
2023-03-12,MH,Marshall Islands,0,15649,0,17,0.10863313949773148
2023-03-19,MH,Marshall Islands,74,15723,0,17,0.10812185969598677
2023-03-26,MH,Marshall Islands,0,15723,0,17,0.10812185969598677
2023-04-02,MH,Marshall Islands,290,16013,0,17,0.10616374195965778
2023-04-09,MH,Marshall Islands,68,16081,0,17,0.10571481873017848
2023-04-16,MH,Marshall Islands,0,16081,0,17,0.10571481873017848
2023-04-23,MH,Marshall Islands,0,16081,0,17,0.10571481873017848
2023-04-30,MH,Marshall Islands,0,16081,0,17,0.10571481873017848
2023-05-07,MH,Marshall Islands,0,16081,0,17,0.10571481873017848
2023-05-14,MH,Marshall Islands,0,16081,0,17,0.10571481873017848
2023-05-21,MH,Marshall Islands,0,16081,0,17,0.10571481873017848
2023-05-28,MH,Marshall Islands,0,16081,0,17,0.10571481873017848
2023-06-04,MH,Marshall Islands,0,16081,0,17,0.10571481873017848
2023-06-11,MH,Marshall Islands,17,16098,0,17,0.10560318051931916
2023-06-18,MH,Marshall Islands,0,16098,0,17,0.10560318051931916
2023-06-25,MH,Marshall Islands,0,16098,0,17,0.10560318051931916
2023-07-02,MH,Marshall Islands,0,16098,0,17,0.10560318051931916
2023-07-09,MH,Marshall Islands,0,16098,0,17,0.10560318051931916
2023-07-16,MH,Marshall Islands,0,16098,0,17,0.10560318051931916
2023-07-23,MH,Marshall Islands,0,16098,0,17,0.10560318051931916
2023-07-30,MH,Marshall Islands,0,16098,0,17,0.10560318051931916
2023-08-06,MH,Marshall Islands,0,16098,0,17,0.10560318051931916
2023-08-13,MH,Marshall Islands,0,16098,0,17,0.10560318051931916
2023-08-20,MH,Marshall Islands,0,16098,0,17,0.10560318051931916
2023-08-27,MH,Marshall Islands,0,16098,0,17,0.10560318051931916
2023-09-03,MH,Marshall Islands,21,16119,0,17,0.10546559960295304
2023-09-10,MH,Marshall Islands,14,16133,0,17,0.10537407797681769
2023-09-17,MH,Marshall Islands,0,16133,0,17,0.10537407797681769
2023-09-24,MH,Marshall Islands,0,16133,0,17,0.10537407797681769
2023-10-01,MH,Marshall Islands,0,16133,0,17,0.10537407797681769
2023-10-08,MH,Marshall Islands,5,16138,0,17,0.10534143016482836
2023-10-15,MH,Marshall Islands,0,16138,0,17,0.10534143016482836
2023-10-22,MH,Marshall Islands,0,16138,0,17,0.10534143016482836
2023-10-29,MH,Marshall Islands,0,16138,0,17,0.10534143016482836
2023-11-05,MH,Marshall Islands,0,16138,0,17,0.10534143016482836
2023-11-12,MH,Marshall Islands,0,16138,0,17,0.10534143016482836
2023-11-19,MH,Marshall Islands,0,16138,0,17,0.10534143016482836
2023-11-26,MH,Marshall Islands,0,16138,0,17,0.10534143016482836
2023-12-03,MH,Marshall Islands,0,16138,0,17,0.10534143016482836
2023-12-10,MH,Marshall Islands,0,16138,0,17,0.10534143016482836
2023-12-17,MH,Marshall Islands,0,16138,0,17,0.10534143016482836
2023-12-24,MH,Marshall Islands,0,16138,0,17,0.10534143016482836
2023-12-31,MH,Marshall Islands,0,16138,0,17,0.10534143016482836
2024-01-07,MH,Marshall Islands,0,16138,0,17,0.10534143016482836
2024-01-14,MH,Marshall Islands,0,16138,0,17,0.10534143016482836
2020-10-25,MQ,Martinique,534,2800,2,27,0.9642857142857142
2020-11-01,MQ,Martinique,1018,3818,4,31,0.8119434258774227
2020-11-08,MQ,Martinique,397,4215,2,33,0.7829181494661922
2020-11-15,MQ,Martinique,517,4732,4,37,0.7819103972950128
2020-11-22,MQ,Martinique,359,5091,2,39,0.7660577489687684
2020-11-29,MQ,Martinique,322,5413,1,40,0.7389617587289857
2020-12-06,MQ,Martinique,107,5520,1,41,0.7427536231884058
2020-12-13,MQ,Martinique,33,5553,0,41,0.738339636232667
2020-12-20,MQ,Martinique,81,5634,1,42,0.7454739084132056
2020-12-27,MQ,Martinique,438,6072,0,42,0.691699604743083
2021-01-03,MQ,Martinique,19,6091,1,43,0.7059596125430964
2021-01-10,MQ,Martinique,26,6117,0,43,0.7029589668137977
2021-01-17,MQ,Martinique,110,6227,0,43,0.6905411915850329
2021-01-24,MQ,Martinique,143,6370,1,44,0.6907378335949764
2021-01-31,MQ,Martinique,0,6370,0,44,0.6907378335949764
2021-02-07,MQ,Martinique,72,6442,1,45,0.6985408258304874
2021-02-14,MQ,Martinique,151,6593,0,45,0.6825420900955559
2021-02-21,MQ,Martinique,0,6593,0,45,0.6825420900955559
2021-02-28,MQ,Martinique,153,6746,0,45,0.6670619626445301
2021-03-07,MQ,Martinique,140,6886,2,47,0.6825442927679349
2021-03-14,MQ,Martinique,151,7037,0,47,0.6678982520960637
2021-03-21,MQ,Martinique,227,7264,0,47,0.6470264317180616
2021-03-28,MQ,Martinique,285,7549,3,50,0.6623393826996954
2021-04-04,MQ,Martinique,614,8163,4,54,0.6615214994487321
2021-04-11,MQ,Martinique,724,8887,5,59,0.6638910768538314
2021-04-18,MQ,Martinique,871,9758,7,66,0.6763681082188974
2021-04-25,MQ,Martinique,733,10491,4,70,0.6672385854541989
2021-05-02,MQ,Martinique,648,11139,9,79,0.7092198581560284
2021-05-09,MQ,Martinique,351,11490,8,87,0.7571801566579635
2021-05-16,MQ,Martinique,179,11669,3,90,0.7712743165652584
2021-05-23,MQ,Martinique,120,11789,3,93,0.7888709814233609
2021-05-30,MQ,Martinique,190,11979,2,95,0.7930545120627766
2021-06-06,MQ,Martinique,81,12060,2,97,0.8043117744610282
2021-06-13,MQ,Martinique,70,12130,1,98,0.8079142621599341
2021-06-20,MQ,Martinique,69,12199,0,98,0.8033445364374128
2021-06-27,MQ,Martinique,87,12286,0,98,0.7976558684681753
2021-07-04,MQ,Martinique,110,12396,0,98,0.7905776056792513
2021-07-11,MQ,Martinique,411,12807,0,98,0.7652065276801748
2021-07-18,MQ,Martinique,2157,14964,4,102,0.681635926222935
2021-07-25,MQ,Martinique,2251,17215,2,104,0.6041243101945978
2021-08-01,MQ,Martinique,5224,22439,25,129,0.5748919292303579
2021-08-08,MQ,Martinique,4308,26747,38,167,0.6243690881220324
2021-08-15,MQ,Martinique,3500,30247,54,221,0.7306509736502794
2021-08-22,MQ,Martinique,3574,33821,57,278,0.8219745128766152
2022-01-30,MQ,Martinique,10559,87634,11,832,0.9494031996713604
2022-02-06,MQ,Martinique,8985,96619,10,842,0.8714642047630384
2022-02-13,MQ,Martinique,8478,105097,15,857,0.8154371675690077
2022-02-20,MQ,Martinique,5637,110734,4,861,0.777538967254863
2022-02-27,MQ,Martinique,3734,114468,33,894,0.7810042981444596
2022-03-06,MQ,Martinique,3216,117684,1,895,0.7605111994833622
2022-03-13,MQ,Martinique,13686,131370,9,904,0.6881327548146456
2022-03-20,MQ,Martinique,6669,138039,5,909,0.6585095516484472
2022-03-27,MQ,Martinique,5136,143175,3,912,0.6369827134625459
2022-04-03,MQ,Martinique,2791,145966,4,916,0.6275434005179288
2022-04-10,MQ,Martinique,2082,148048,2,918,0.6200691667567275
2022-04-17,MQ,Martinique,1211,149259,0,918,0.615038289148393
2022-04-24,MQ,Martinique,818,150077,0,918,0.6116860011860579
2022-05-01,MQ,Martinique,1895,151972,0,918,0.6040586423814913
2022-05-08,MQ,Martinique,2022,153994,0,918,0.5961271218359157
2022-05-15,MQ,Martinique,3298,157292,0,918,0.5836279022455051
2022-05-22,MQ,Martinique,4871,162163,0,918,0.5660970751651117
2022-05-29,MQ,Martinique,5353,167516,20,938,0.5599465125719334
2022-06-05,MQ,Martinique,5367,172883,4,942,0.5448771712661165
2022-06-12,MQ,Martinique,8000,180883,8,950,0.5252013732633801
2022-06-19,MQ,Martinique,8076,188959,7,957,0.5064590731322668
2022-06-26,MQ,Martinique,6953,195912,8,965,0.4925680917963167
2022-07-03,MQ,Martinique,5299,201211,6,971,0.4825779902689216
2022-07-10,MQ,Martinique,4050,205261,10,981,0.4779281012954239
2022-07-17,MQ,Martinique,2742,208003,5,986,0.4740316245438768
2022-07-24,MQ,Martinique,1855,209858,6,992,0.47270058801665893
2022-07-31,MQ,Martinique,1714,211572,6,998,0.47170703117614804
2022-08-07,MQ,Martinique,1330,212902,7,1005,0.47204817239856833
2022-08-14,MQ,Martinique,987,213889,4,1009,0.47174001468051185
2022-08-21,MQ,Martinique,836,214725,9,1018,0.47409477238328096
2022-08-28,MQ,Martinique,857,215582,4,1022,0.4740655527826998
2022-09-04,MQ,Martinique,0,215582,0,1022,0.4740655527826998
2022-09-11,MQ,Martinique,3947,219529,14,1036,0.4719194275016057
2022-09-18,MQ,Martinique,0,219529,0,1036,0.4719194275016057
2022-09-25,MQ,Martinique,663,220192,6,1042,0.4732233686964104
2022-10-02,MQ,Martinique,2140,222332,5,1047,0.47091736682079055
2022-10-09,MQ,Martinique,498,222830,0,1047,0.46986491944531705
2022-10-16,MQ,Martinique,462,223292,0,1047,0.4688927503000555
2022-10-23,MQ,Martinique,436,223728,0,1047,0.4679789744689981
2022-10-30,MQ,Martinique,0,223728,0,1047,0.4679789744689981
2022-11-06,MQ,Martinique,68,223796,7,1054,0.4709646285009562
2022-11-13,MQ,Martinique,81,223877,3,1057,0.47213425229032013
2022-11-20,MQ,Martinique,771,224648,0,1057,0.47051387058865424
2022-11-27,MQ,Martinique,0,224648,0,1057,0.47051387058865424
2022-12-04,MQ,Martinique,621,225269,3,1060,0.4705485441849522
2022-12-11,MQ,Martinique,634,225903,16,1076,0.47631062889824394
2022-12-18,MQ,Martinique,817,226720,3,1079,0.47591743119266056
2022-12-25,MQ,Martinique,670,227390,0,1079,0.47451515018250584
2023-01-01,MQ,Martinique,414,227804,5,1084,0.47584765851345895
2023-01-08,MQ,Martinique,367,228171,1,1085,0.47552055256803016
2023-01-15,MQ,Martinique,194,228365,1,1086,0.475554485144396
2023-01-22,MQ,Martinique,147,228512,3,1089,0.476561405965551
2023-01-29,MQ,Martinique,135,228647,0,1089,0.4762800299151093
2023-02-05,MQ,Martinique,109,228756,2,1091,0.47692738113972966
2023-02-12,MQ,Martinique,68,228824,1,1092,0.4772226689508094
2023-02-19,MQ,Martinique,51,228875,0,1092,0.4771163298743856
2023-02-26,MQ,Martinique,68,228943,0,1092,0.476974618136392
2023-03-05,MQ,Martinique,77,229020,0,1092,0.47681425203039035
2023-03-12,MQ,Martinique,141,229161,0,1092,0.47652087397070175
2023-03-19,MQ,Martinique,204,229365,1,1093,0.47653303686264253
2023-03-26,MQ,Martinique,114,229479,2,1095,0.4771678454237643
2023-04-02,MQ,Martinique,0,229479,0,1095,0.4771678454237643
2023-04-09,MQ,Martinique,0,229479,0,1095,0.4771678454237643
2023-04-16,MQ,Martinique,195,229674,2,1097,0.4776335153304248
2023-04-23,MQ,Martinique,110,229784,0,1097,0.47740486717961217
2023-04-30,MQ,Martinique,116,229900,3,1100,0.4784688995215311
2023-05-07,MQ,Martinique,0,229900,0,1100,0.4784688995215311
2023-05-14,MQ,Martinique,0,229900,0,1100,0.4784688995215311
2023-05-21,MQ,Martinique,75,229975,2,1102,0.479182519839113
2023-05-28,MQ,Martinique,0,229975,0,1102,0.479182519839113
2023-06-04,MQ,Martinique,0,229975,0,1102,0.479182519839113
2023-06-11,MQ,Martinique,0,229975,0,1102,0.479182519839113
2023-06-18,MQ,Martinique,0,229975,0,1102,0.479182519839113
2023-06-25,MQ,Martinique,379,230354,2,1104,0.4792623527266729
2023-07-02,MQ,Martinique,0,230354,0,1104,0.4792623527266729
2023-07-09,MQ,Martinique,0,230354,0,1104,0.4792623527266729
2023-07-16,MQ,Martinique,0,230354,0,1104,0.4792623527266729
2023-07-23,MQ,Martinique,0,230354,0,1104,0.4792623527266729
2023-07-30,MQ,Martinique,0,230354,0,1104,0.4792623527266729
2023-08-06,MQ,Martinique,0,230354,0,1104,0.4792623527266729
2023-08-13,MQ,Martinique,0,230354,0,1104,0.4792623527266729
2023-08-20,MQ,Martinique,0,230354,0,1104,0.4792623527266729
2023-08-27,MQ,Martinique,0,230354,0,1104,0.4792623527266729
2023-09-03,MQ,Martinique,0,230354,0,1104,0.4792623527266729
2023-09-10,MQ,Martinique,0,230354,0,1104,0.4792623527266729
2023-09-17,MQ,Martinique,0,230354,0,1104,0.4792623527266729
2023-09-24,MQ,Martinique,0,230354,0,1104,0.4792623527266729
2023-10-01,MQ,Martinique,0,230354,0,1104,0.4792623527266729
2023-10-08,MQ,Martinique,0,230354,0,1104,0.4792623527266729
2023-10-15,MQ,Martinique,0,230354,0,1104,0.4792623527266729
2023-10-22,MQ,Martinique,0,230354,0,1104,0.4792623527266729
2023-10-29,MQ,Martinique,0,230354,0,1104,0.4792623527266729
2023-11-05,MQ,Martinique,0,230354,0,1104,0.4792623527266729
2023-11-12,MQ,Martinique,0,230354,0,1104,0.4792623527266729
2023-11-19,MQ,Martinique,0,230354,0,1104,0.4792623527266729
2023-11-26,MQ,Martinique,0,230354,0,1104,0.4792623527266729
2023-12-03,MQ,Martinique,0,230354,0,1104,0.4792623527266729
2023-12-10,MQ,Martinique,0,230354,0,1104,0.4792623527266729
2023-12-17,MQ,Martinique,0,230354,0,1104,0.4792623527266729
2023-12-24,MQ,Martinique,0,230354,0,1104,0.4792623527266729
2023-12-31,MQ,Martinique,0,230354,0,1104,0.4792623527266729
2024-01-07,MQ,Martinique,0,230354,0,1104,0.4792623527266729
2024-01-14,MQ,Martinique,0,230354,0,1104,0.4792623527266729
2021-06-27,MU,Mauritius,107,1880,0,18,0.9574468085106382
2021-07-04,MU,Mauritius,104,1984,0,18,0.9072580645161291
2021-07-11,MU,Mauritius,147,2131,0,18,0.8446738620366024
2021-07-18,MU,Mauritius,404,2535,1,19,0.7495069033530571
2021-07-25,MU,Mauritius,1194,3729,0,19,0.5095199785465273
2021-08-01,MU,Mauritius,485,4214,1,20,0.47460844803037494
2021-08-08,MU,Mauritius,796,5010,0,20,0.39920159680638717
2021-08-15,MU,Mauritius,955,5965,1,21,0.3520536462699078
2021-08-22,MU,Mauritius,1849,7814,2,23,0.2943434860506783
2021-08-29,MU,Mauritius,2382,10196,6,29,0.2844252648097293
2021-09-05,MU,Mauritius,1840,12036,5,34,0.2824858757062147
2021-09-12,MU,Mauritius,1253,13289,9,43,0.32357588983369706
2021-09-19,MU,Mauritius,4012,17301,11,54,0.3121206866655107
2021-09-26,MU,Mauritius,4422,21723,25,79,0.36366984302352345
2021-10-03,MU,Mauritius,4076,25799,11,90,0.3488507306484747
2021-10-10,MU,Mauritius,3364,29163,20,110,0.377190275348901
2021-10-17,MU,Mauritius,3859,33022,24,134,0.40579007934104533
2021-10-24,MU,Mauritius,4618,37640,19,153,0.40648246546227423
2021-10-31,MU,Mauritius,6128,43768,23,176,0.4021202705172729
2021-11-07,MU,Mauritius,7193,50961,37,213,0.4179666804026609
2021-11-14,MU,Mauritius,11906,62867,54,267,0.4247061256302989
2021-11-21,MU,Mauritius,9474,72341,105,372,0.5142312105168576
2021-11-28,MU,Mauritius,7272,79613,96,468,0.5878436938690917
2021-12-05,MU,Mauritius,4470,84083,126,594,0.7064448223778885
2021-12-12,MU,Mauritius,2950,87033,72,666,0.765226982868567
2021-12-19,MU,Mauritius,1841,88874,80,746,0.8393905979251526
2021-12-26,MU,Mauritius,1216,90090,16,762,0.8458208458208459
2022-01-02,MU,Mauritius,1387,91477,24,786,0.8592323753511811
2022-01-09,MU,Mauritius,1895,93372,12,798,0.8546459323994344
2022-01-16,MU,Mauritius,2438,95810,15,813,0.848554430643983
2022-01-23,MU,Mauritius,3165,98975,9,822,0.8305127557464006
2022-01-30,MU,Mauritius,5827,104802,0,822,0.7843361767905193
2022-02-06,MU,Mauritius,9768,114570,0,822,0.717465305053679
2022-02-13,MU,Mauritius,14875,129445,19,841,0.6496967824172428
2022-02-20,MU,Mauritius,19687,149132,37,878,0.5887401764879435
2022-02-27,MU,Mauritius,16531,165663,17,895,0.5402534060109982
2022-03-06,MU,Mauritius,13983,179646,9,904,0.5032118722376229
2022-03-13,MU,Mauritius,11458,191104,30,934,0.48873911587407903
2022-03-20,MU,Mauritius,10686,201790,0,934,0.4628574260369691
2022-03-27,MU,Mauritius,7759,209549,34,968,0.4619444616772211
2022-04-03,MU,Mauritius,4876,214425,0,968,0.4514398974000233
2022-04-10,MU,Mauritius,3450,217875,17,985,0.4520940906483075
2022-04-17,MU,Mauritius,2239,220114,5,990,0.4497669389498169
2022-04-24,MU,Mauritius,1502,221616,0,990,0.44671864847303444
2022-05-01,MU,Mauritius,1107,222723,6,996,0.44719225225953313
2022-05-08,MU,Mauritius,965,223688,0,996,0.4452630449554737
2022-05-15,MU,Mauritius,901,224589,0,996,0.4434767508649132
2022-05-22,MU,Mauritius,1133,225722,0,996,0.441250742063246
2022-05-29,MU,Mauritius,1039,226761,0,996,0.4392289679442232
2022-06-05,MU,Mauritius,739,227500,2,998,0.4386813186813187
2022-06-12,MU,Mauritius,743,228243,2,1000,0.43812953737902144
2022-06-19,MU,Mauritius,1066,229309,1,1001,0.436528875883633
2022-06-26,MU,Mauritius,1416,230725,1,1002,0.434283237620544
2022-07-03,MU,Mauritius,2080,232805,4,1006,0.43212130323661435
2022-07-10,MU,Mauritius,2745,235550,1,1007,0.4275100827849714
2022-07-17,MU,Mauritius,4294,239844,1,1008,0.4202731775654175
2022-07-24,MU,Mauritius,4551,244395,0,1008,0.4124470631559566
2022-07-31,MU,Mauritius,3932,248327,6,1014,0.4083325615015685
2022-08-07,MU,Mauritius,3080,251407,2,1016,0.4041255812288441
2022-08-14,MU,Mauritius,2464,253871,4,1020,0.40177885619074255
2022-08-21,MU,Mauritius,2314,256185,0,1020,0.3981497745769658
2022-08-28,MU,Mauritius,1937,258122,3,1023,0.3963242187802667
2022-09-04,MU,Mauritius,1470,259592,0,1023,0.3940799408302259
2022-09-11,MU,Mauritius,1234,260826,1,1024,0.3925988973491906
2022-09-18,MU,Mauritius,1077,261903,1,1025,0.3913662691912655
2022-09-25,MU,Mauritius,680,262583,1,1026,0.3907335966151655
2022-10-02,MU,Mauritius,534,263117,1,1027,0.390320655829916
2022-10-09,MU,Mauritius,587,263704,4,1031,0.39096866183296425
2022-10-16,MU,Mauritius,680,264384,1,1032,0.3903413217138707
2022-10-23,MU,Mauritius,831,265215,0,1032,0.38911826254171145
2022-10-30,MU,Mauritius,1120,266335,0,1032,0.3874819306512475
2022-11-06,MU,Mauritius,1787,268122,1,1033,0.3852723760079367
2022-11-13,MU,Mauritius,3282,271404,0,1033,0.38061340289752543
2022-11-20,MU,Mauritius,4504,275908,1,1034,0.37476260202676254
2022-11-27,MU,Mauritius,4740,280648,1,1035,0.3687893731649611
2022-12-04,MU,Mauritius,3899,284547,2,1037,0.36443891518800053
2022-12-11,MU,Mauritius,3183,287730,1,1038,0.36075487436138043
2022-12-18,MU,Mauritius,2098,289828,0,1038,0.3581434505982859
2022-12-25,MU,Mauritius,1378,291206,1,1039,0.3567920990638929
2023-01-01,MU,Mauritius,1090,292296,2,1041,0.3561458247803596
2023-01-08,MU,Mauritius,985,293281,1,1042,0.3552906598108981
2023-01-15,MU,Mauritius,734,294015,1,1043,0.3547438055881503
2023-01-22,MU,Mauritius,539,294554,0,1043,0.3540946651547764
2023-01-29,MU,Mauritius,320,294874,0,1043,0.3537103983396298
2023-02-05,MU,Mauritius,258,295132,1,1044,0.3537400214141469
2023-02-12,MU,Mauritius,271,295403,0,1044,0.3534155035663145
2023-02-19,MU,Mauritius,316,295719,0,1044,0.35303785012122996
2023-02-26,MU,Mauritius,34,295753,0,1044,0.35299726460931924
2023-03-05,MU,Mauritius,575,296328,0,1044,0.35231230258362356
2023-03-12,MU,Mauritius,399,296727,0,1044,0.35183855867514585
2023-03-19,MU,Mauritius,143,296870,0,1044,0.35166908074241254
2023-03-26,MU,Mauritius,392,297262,0,1044,0.3512053340151112
2023-04-02,MU,Mauritius,498,297760,0,1044,0.3506179473401397
2023-04-09,MU,Mauritius,339,298099,0,1044,0.350219222473071
2023-04-16,MU,Mauritius,715,298814,0,1044,0.34938122042474584
2023-04-23,MU,Mauritius,962,299776,0,1044,0.3482600341588386
2023-04-30,MU,Mauritius,1320,301096,2,1046,0.3473975077716077
2023-05-07,MU,Mauritius,1599,302695,2,1048,0.34622309585556416
2023-05-14,MU,Mauritius,1538,304233,2,1050,0.34513021269881966
2023-05-21,MU,Mauritius,1230,305463,0,1050,0.34374048575441213
2023-05-28,MU,Mauritius,860,306323,0,1050,0.3427754363857758
2023-06-04,MU,Mauritius,646,306969,1,1051,0.34237984943105004
2023-06-11,MU,Mauritius,516,307485,1,1052,0.3421305104314032
2023-06-18,MU,Mauritius,333,307818,0,1052,0.3417603908803254
2023-06-25,MU,Mauritius,226,308044,0,1052,0.3415096544649466
2023-07-02,MU,Mauritius,165,308209,1,1053,0.3416512820845595
2023-07-09,MU,Mauritius,136,308345,0,1053,0.34150059186949683
2023-07-16,MU,Mauritius,138,308483,0,1053,0.3413478214358652
2023-07-23,MU,Mauritius,146,308629,0,1053,0.34118634347387966
2023-07-30,MU,Mauritius,110,308739,0,1053,0.3410647828748555
2023-08-06,MU,Mauritius,85,308824,0,1053,0.3409709089967101
2023-08-13,MU,Mauritius,644,309468,1,1054,0.34058448692595034
2023-08-20,MU,Mauritius,67,309535,0,1054,0.3405107661492238
2023-08-27,MU,Mauritius,79,309614,0,1054,0.34042388264096585
2023-09-03,MU,Mauritius,63,309677,0,1054,0.34035462756355817
2023-09-10,MU,Mauritius,64,309741,0,1054,0.3402843020459029
2023-09-17,MU,Mauritius,45,309786,0,1054,0.3402348718147366
2023-09-24,MU,Mauritius,44,309830,0,1054,0.34018655391666397
2023-10-01,MU,Mauritius,39,309869,0,1054,0.3401437381603194
2023-10-08,MU,Mauritius,48,309917,0,1054,0.3400910566377449
2023-10-15,MU,Mauritius,66,309983,0,1054,0.340018646183823
2023-10-22,MU,Mauritius,72,310055,0,1054,0.3399396881198497
2023-10-29,MU,Mauritius,127,310182,0,1054,0.33980050422010305
2023-11-05,MU,Mauritius,158,310340,0,1054,0.33962750531674935
2023-11-12,MU,Mauritius,317,310657,1,1055,0.33960284171932387
2023-11-19,MU,Mauritius,808,311465,0,1055,0.3387218467564574
2023-11-26,MU,Mauritius,1507,312972,1,1056,0.3374103753690426
2023-12-03,MU,Mauritius,2128,315100,0,1056,0.3351317042208823
2023-12-10,MU,Mauritius,3091,318191,1,1057,0.33219041393376936
2023-12-17,MU,Mauritius,3228,321419,1,1058,0.3291653573684194
2023-12-24,MU,Mauritius,0,321419,0,1058,0.3291653573684194
2023-12-31,MU,Mauritius,0,321419,0,1058,0.3291653573684194
2024-01-07,MU,Mauritius,0,321419,0,1058,0.3291653573684194
2024-01-14,MU,Mauritius,0,321419,0,1058,0.3291653573684194
2020-11-08,YT,Mayotte,184,4550,1,45,0.9890109890109889
2020-11-15,YT,Mayotte,371,4921,1,46,0.9347693558219874
2020-11-22,YT,Mayotte,115,5036,2,48,0.9531374106433679
2020-11-29,YT,Mayotte,145,5181,1,49,0.9457633661455318
2020-12-06,YT,Mayotte,0,5181,0,49,0.9457633661455318
2020-12-13,YT,Mayotte,370,5551,3,52,0.936768149882904
2020-12-20,YT,Mayotte,157,5708,1,53,0.9285213735108621
2020-12-27,YT,Mayotte,59,5767,1,54,0.936362059996532
2021-01-03,YT,Mayotte,123,5890,1,55,0.9337860780984719
2021-01-10,YT,Mayotte,342,6232,1,56,0.8985879332477535
2021-01-17,YT,Mayotte,379,6611,2,58,0.8773256693389804
2021-01-24,YT,Mayotte,933,7544,1,59,0.7820784729586426
2021-01-31,YT,Mayotte,687,8231,2,61,0.7411007168023327
2021-02-07,YT,Mayotte,2524,10755,3,64,0.595072059507206
2021-02-14,YT,Mayotte,2780,13535,14,78,0.5762837089028445
2021-02-21,YT,Mayotte,2257,15792,14,92,0.5825734549138805
2021-02-28,YT,Mayotte,1069,16861,10,102,0.6049463258406974
2021-03-07,YT,Mayotte,1279,18140,23,125,0.6890848952590959
2021-03-14,YT,Mayotte,502,18642,4,129,0.6919858384293531
2021-03-21,YT,Mayotte,364,19006,22,151,0.7944859518046932
2021-03-28,YT,Mayotte,300,19306,3,154,0.7976794778825236
2021-04-04,YT,Mayotte,184,19490,8,162,0.8311954848640328
2021-04-11,YT,Mayotte,153,19643,5,167,0.8501756350862902
2021-04-18,YT,Mayotte,146,19789,1,168,0.8489564909798374
2021-04-25,YT,Mayotte,107,19896,1,169,0.849416968234821
2021-05-02,YT,Mayotte,198,20094,1,170,0.8460236886632826
2021-05-09,YT,Mayotte,40,20134,0,170,0.8443429025528957
2021-05-16,YT,Mayotte,42,20176,1,171,0.8475416336241078
2021-05-23,YT,Mayotte,-875,19301,0,171,0.885964457800114
2021-05-30,YT,Mayotte,24,19325,2,173,0.8952134540750324
2021-06-06,YT,Mayotte,22,19347,0,173,0.8941954825037475
2021-06-13,YT,Mayotte,26,19373,0,173,0.8929954059773912
2021-06-20,YT,Mayotte,16,19389,1,174,0.8974160606529477
2021-06-27,YT,Mayotte,16,19405,0,174,0.8966761144035043
2021-07-04,YT,Mayotte,7,19412,0,174,0.8963527714815577
2021-07-11,YT,Mayotte,13,19425,0,174,0.8957528957528959
2021-07-18,YT,Mayotte,26,19451,0,174,0.8945555498431959
2021-07-25,YT,Mayotte,14,19465,0,174,0.8939121500128436
2021-08-01,YT,Mayotte,29,19494,0,174,0.8925823330255463
2021-08-08,YT,Mayotte,24,19518,0,174,0.8914847832769751
2021-08-15,YT,Mayotte,49,19567,1,175,0.8943629580416007
2021-08-22,YT,Mayotte,97,19664,0,175,0.8899511798209927
2021-08-29,YT,Mayotte,75,19739,0,175,0.8865697350423021
2021-09-05,YT,Mayotte,136,19875,0,175,0.8805031446540881
2021-09-12,YT,Mayotte,140,20015,0,175,0.8743442418186359
2021-09-19,YT,Mayotte,92,20107,1,176,0.8753170537623713
2021-09-26,YT,Mayotte,112,20219,2,178,0.880360057371779
2021-10-03,YT,Mayotte,104,20323,2,180,0.8856960094474241
2021-10-10,YT,Mayotte,62,20385,0,180,0.8830022075055187
2021-10-17,YT,Mayotte,54,20439,1,181,0.8855619159450071
2021-10-24,YT,Mayotte,46,20485,1,182,0.8884549670490602
2021-10-31,YT,Mayotte,70,20555,3,185,0.9000243249817562
2021-11-07,YT,Mayotte,96,20651,0,185,0.8958403951382499
2021-11-14,YT,Mayotte,118,20769,0,185,0.8907506379700515
2021-11-21,YT,Mayotte,91,20860,0,185,0.8868648130393098
2021-11-28,YT,Mayotte,78,20938,0,185,0.8835609895883084
2021-12-05,YT,Mayotte,35,20973,0,185,0.8820864921565823
2021-12-12,YT,Mayotte,115,21088,0,185,0.8772761760242793
2021-12-19,YT,Mayotte,92,21180,0,185,0.8734655335221907
2021-12-26,YT,Mayotte,108,21288,0,185,0.8690341976700489
2022-01-02,YT,Mayotte,623,21911,0,185,0.8443247683811784
2022-01-09,YT,Mayotte,2760,24671,1,186,0.7539216083660979
2022-01-16,YT,Mayotte,9086,33757,0,186,0.5509968302870516
2022-01-23,YT,Mayotte,1934,35691,1,187,0.5239416099296741
2022-01-30,YT,Mayotte,591,36282,0,187,0.5154070889146133
2022-02-06,YT,Mayotte,192,36474,0,187,0.5126939737895487
2022-02-13,YT,Mayotte,98,36572,0,187,0.5113201356228809
2022-02-20,YT,Mayotte,0,36572,0,187,0.5113201356228809
2022-02-27,YT,Mayotte,59,36631,0,187,0.5104965739401054
2022-03-06,YT,Mayotte,72,36703,0,187,0.5094951366373321
2022-03-13,YT,Mayotte,42,36745,0,187,0.5089127772486052
2022-03-20,YT,Mayotte,0,36745,0,187,0.5089127772486052
2022-03-27,YT,Mayotte,94,36839,0,187,0.5076142131979695
2022-04-03,YT,Mayotte,0,36839,0,187,0.5076142131979695
2022-04-10,YT,Mayotte,119,36958,0,187,0.5059797608095675
2022-04-17,YT,Mayotte,80,37038,0,187,0.5048868729413035
2022-04-24,YT,Mayotte,0,37038,0,187,0.5048868729413035
2022-05-01,YT,Mayotte,325,37363,0,187,0.500495142253031
2022-05-08,YT,Mayotte,0,37363,0,187,0.500495142253031
2022-05-15,YT,Mayotte,0,37363,0,187,0.500495142253031
2022-05-22,YT,Mayotte,160,37523,0,187,0.49836100525011323
2022-05-29,YT,Mayotte,0,37523,0,187,0.49836100525011323
2022-06-05,YT,Mayotte,134,37657,0,187,0.4965876198316382
2022-06-12,YT,Mayotte,94,37751,0,187,0.49535111652671454
2022-06-19,YT,Mayotte,69,37820,0,187,0.49444738233738766
2022-06-26,YT,Mayotte,57,37877,0,187,0.4937033027958919
2022-07-03,YT,Mayotte,81,37958,0,187,0.49264977079930444
2022-07-10,YT,Mayotte,181,38139,0,187,0.49031175437216495
2022-07-17,YT,Mayotte,262,38401,0,187,0.48696648524778
2022-07-24,YT,Mayotte,245,38646,0,187,0.4838793148061895
2022-07-31,YT,Mayotte,313,38959,0,187,0.4799917862368131
2022-08-07,YT,Mayotte,433,39392,0,187,0.4747156783103168
2022-08-14,YT,Mayotte,312,39704,0,187,0.4709852911545436
2022-08-21,YT,Mayotte,191,39895,0,187,0.468730417345532
2022-08-28,YT,Mayotte,109,40004,0,187,0.4674532546745326
2022-09-04,YT,Mayotte,91,40095,0,187,0.4663923182441701
2022-09-11,YT,Mayotte,66,40161,0,187,0.46562585592988226
2022-09-18,YT,Mayotte,43,40204,0,187,0.4651278479753258
2022-09-25,YT,Mayotte,39,40243,0,187,0.4646770866983078
2022-10-02,YT,Mayotte,18,40261,0,187,0.4644693375723405
2022-10-09,YT,Mayotte,16,40277,0,187,0.46428482756908407
2022-10-16,YT,Mayotte,20,40297,0,187,0.4640543961088915
2022-10-23,YT,Mayotte,23,40320,0,187,0.46378968253968256
2022-10-30,YT,Mayotte,0,40320,0,187,0.46378968253968256
2022-11-06,YT,Mayotte,19,40339,0,187,0.46357123379359927
2022-11-13,YT,Mayotte,76,40415,0,187,0.46269949276258815
2022-11-20,YT,Mayotte,197,40612,0,187,0.4604550379198266
2022-11-27,YT,Mayotte,594,41206,0,187,0.4538174052322477
2022-12-04,YT,Mayotte,473,41679,0,187,0.4486671945104249
2022-12-11,YT,Mayotte,174,41853,0,187,0.44680190189472674
2022-12-18,YT,Mayotte,68,41921,0,187,0.4460771451062713
2022-12-25,YT,Mayotte,48,41969,0,187,0.4455669660940218
2023-01-01,YT,Mayotte,24,41993,0,187,0.4453123139570881
2023-01-08,YT,Mayotte,9,42002,0,187,0.44521689443359835
2023-01-15,YT,Mayotte,0,42002,0,187,0.44521689443359835
2023-01-22,YT,Mayotte,0,42002,0,187,0.44521689443359835
2023-01-29,YT,Mayotte,0,42002,0,187,0.44521689443359835
2023-02-05,YT,Mayotte,0,42002,0,187,0.44521689443359835
2023-02-12,YT,Mayotte,2,42004,0,187,0.4451956956480335
2023-02-19,YT,Mayotte,0,42004,0,187,0.4451956956480335
2023-02-26,YT,Mayotte,0,42004,0,187,0.4451956956480335
2023-03-05,YT,Mayotte,0,42004,0,187,0.4451956956480335
2023-03-12,YT,Mayotte,0,42004,0,187,0.4451956956480335
2023-03-19,YT,Mayotte,0,42004,0,187,0.4451956956480335
2023-03-26,YT,Mayotte,3,42007,0,187,0.44516390125455285
2023-04-02,YT,Mayotte,1,42008,0,187,0.44515330413254617
2023-04-09,YT,Mayotte,0,42008,0,187,0.44515330413254617
2023-04-16,YT,Mayotte,19,42027,0,187,0.44495205463154636
2023-04-23,YT,Mayotte,0,42027,0,187,0.44495205463154636
2023-04-30,YT,Mayotte,0,42027,0,187,0.44495205463154636
2023-05-07,YT,Mayotte,0,42027,0,187,0.44495205463154636
2023-05-14,YT,Mayotte,0,42027,0,187,0.44495205463154636
2023-05-21,YT,Mayotte,0,42027,0,187,0.44495205463154636
2023-05-28,YT,Mayotte,0,42027,0,187,0.44495205463154636
2023-06-04,YT,Mayotte,0,42027,0,187,0.44495205463154636
2023-06-11,YT,Mayotte,0,42027,0,187,0.44495205463154636
2023-06-18,YT,Mayotte,0,42027,0,187,0.44495205463154636
2023-06-25,YT,Mayotte,0,42027,0,187,0.44495205463154636
2023-07-02,YT,Mayotte,0,42027,0,187,0.44495205463154636
2023-07-09,YT,Mayotte,0,42027,0,187,0.44495205463154636
2023-07-16,YT,Mayotte,0,42027,0,187,0.44495205463154636
2023-07-23,YT,Mayotte,0,42027,0,187,0.44495205463154636
2023-07-30,YT,Mayotte,0,42027,0,187,0.44495205463154636
2023-08-06,YT,Mayotte,0,42027,0,187,0.44495205463154636
2023-08-13,YT,Mayotte,0,42027,0,187,0.44495205463154636
2023-08-20,YT,Mayotte,0,42027,0,187,0.44495205463154636
2023-08-27,YT,Mayotte,0,42027,0,187,0.44495205463154636
2023-09-03,YT,Mayotte,0,42027,0,187,0.44495205463154636
2023-09-10,YT,Mayotte,0,42027,0,187,0.44495205463154636
2023-09-17,YT,Mayotte,0,42027,0,187,0.44495205463154636
2023-09-24,YT,Mayotte,0,42027,0,187,0.44495205463154636
2023-10-01,YT,Mayotte,0,42027,0,187,0.44495205463154636
2023-10-08,YT,Mayotte,0,42027,0,187,0.44495205463154636
2023-10-15,YT,Mayotte,0,42027,0,187,0.44495205463154636
2023-10-22,YT,Mayotte,0,42027,0,187,0.44495205463154636
2023-10-29,YT,Mayotte,0,42027,0,187,0.44495205463154636
2023-11-05,YT,Mayotte,0,42027,0,187,0.44495205463154636
2023-11-12,YT,Mayotte,0,42027,0,187,0.44495205463154636
2023-11-19,YT,Mayotte,0,42027,0,187,0.44495205463154636
2023-11-26,YT,Mayotte,0,42027,0,187,0.44495205463154636
2023-12-03,YT,Mayotte,0,42027,0,187,0.44495205463154636
2023-12-10,YT,Mayotte,0,42027,0,187,0.44495205463154636
2023-12-17,YT,Mayotte,0,42027,0,187,0.44495205463154636
2023-12-24,YT,Mayotte,0,42027,0,187,0.44495205463154636
2023-12-31,YT,Mayotte,0,42027,0,187,0.44495205463154636
2024-01-07,YT,Mayotte,0,42027,0,187,0.44495205463154636
2024-01-14,YT,Mayotte,0,42027,0,187,0.44495205463154636
2020-03-22,MX,Mexico,669,903,4,4,0.4429678848283499
2022-07-24,FM,Micronesia (Federated States of),111,149,1,1,0.6711409395973155
2022-07-31,FM,Micronesia (Federated States of),5109,5258,9,10,0.1901863826550019
2022-08-07,FM,Micronesia (Federated States of),1176,6434,6,16,0.24867889337892446
2022-08-14,FM,Micronesia (Federated States of),447,6881,5,21,0.3051881993896236
2022-08-21,FM,Micronesia (Federated States of),0,6881,0,21,0.3051881993896236
2022-08-28,FM,Micronesia (Federated States of),182,7063,5,26,0.3681155316437774
2022-09-04,FM,Micronesia (Federated States of),1486,8549,1,27,0.3158264124459001
2022-09-11,FM,Micronesia (Federated States of),827,9376,2,29,0.30930034129692835
2022-09-18,FM,Micronesia (Federated States of),660,10036,2,31,0.30888800318852133
2022-09-25,FM,Micronesia (Federated States of),47,10083,0,31,0.3074481801051274
2022-10-02,FM,Micronesia (Federated States of),4383,14466,2,33,0.22812111157196183
2022-10-09,FM,Micronesia (Federated States of),6367,20833,18,51,0.2448039168626698
2022-10-16,FM,Micronesia (Federated States of),982,21815,4,55,0.2521201008480403
2022-10-23,FM,Micronesia (Federated States of),217,22032,0,55,0.24963689179375456
2022-10-30,FM,Micronesia (Federated States of),0,22032,0,55,0.24963689179375456
2022-11-06,FM,Micronesia (Federated States of),0,22032,0,55,0.24963689179375456
2022-11-13,FM,Micronesia (Federated States of),0,22032,0,55,0.24963689179375456
2022-11-20,FM,Micronesia (Federated States of),2,22034,3,58,0.26322955432513384
2022-11-27,FM,Micronesia (Federated States of),2,22036,0,58,0.26320566345979307
2022-12-04,FM,Micronesia (Federated States of),0,22036,0,58,0.26320566345979307
2022-12-11,FM,Micronesia (Federated States of),0,22036,0,58,0.26320566345979307
2022-12-18,FM,Micronesia (Federated States of),12,22048,0,58,0.2630624092888244
2022-12-25,FM,Micronesia (Federated States of),21,22069,0,58,0.2628120893561104
2023-01-01,FM,Micronesia (Federated States of),165,22234,0,58,0.2608617432760637
2023-01-08,FM,Micronesia (Federated States of),13,22247,0,58,0.26070930912033086
2023-01-15,FM,Micronesia (Federated States of),1219,23466,0,58,0.24716611267365549
2023-01-22,FM,Micronesia (Federated States of),0,23466,0,58,0.24716611267365549
2023-01-29,FM,Micronesia (Federated States of),205,23671,0,58,0.24502555870051962
2023-02-05,FM,Micronesia (Federated States of),0,23671,2,60,0.2534747158970893
2023-02-12,FM,Micronesia (Federated States of),277,23948,1,61,0.2547185568732253
2023-02-19,FM,Micronesia (Federated States of),0,23948,0,61,0.2547185568732253
2023-02-26,FM,Micronesia (Federated States of),0,23948,0,61,0.2547185568732253
2023-03-05,FM,Micronesia (Federated States of),247,24195,2,63,0.26038437693738375
2023-03-12,FM,Micronesia (Federated States of),0,24195,0,63,0.26038437693738375
2023-03-19,FM,Micronesia (Federated States of),1066,25261,0,63,0.24939630260084716
2023-03-26,FM,Micronesia (Federated States of),442,25703,0,63,0.24510757499124616
2023-04-02,FM,Micronesia (Federated States of),0,25703,0,63,0.24510757499124616
2023-04-09,FM,Micronesia (Federated States of),226,25929,0,63,0.24297119055883376
2023-04-16,FM,Micronesia (Federated States of),115,26044,1,64,0.24573798187682386
2023-04-23,FM,Micronesia (Federated States of),36,26080,0,64,0.245398773006135
2023-04-30,FM,Micronesia (Federated States of),0,26080,0,64,0.245398773006135
2023-05-07,FM,Micronesia (Federated States of),373,26453,0,64,0.24193853249158884
2023-05-14,FM,Micronesia (Federated States of),0,26453,1,65,0.24571882206176993
2023-05-21,FM,Micronesia (Federated States of),5,26458,0,65,0.245672386423766
2023-05-28,FM,Micronesia (Federated States of),0,26458,0,65,0.245672386423766
2023-06-04,FM,Micronesia (Federated States of),0,26458,0,65,0.245672386423766
2023-06-11,FM,Micronesia (Federated States of),1,26459,0,65,0.24566310140216938
2023-06-18,FM,Micronesia (Federated States of),0,26459,0,65,0.24566310140216938
2023-06-25,FM,Micronesia (Federated States of),0,26459,0,65,0.24566310140216938
2023-07-02,FM,Micronesia (Federated States of),1,26460,0,65,0.24565381708238854
2023-07-09,FM,Micronesia (Federated States of),2,26462,0,65,0.24563525054795554
2023-07-16,FM,Micronesia (Federated States of),4,26466,0,65,0.24559812589737776
2023-07-23,FM,Micronesia (Federated States of),6,26472,0,65,0.24554245995769114
2023-07-30,FM,Micronesia (Federated States of),0,26472,0,65,0.24554245995769114
2023-08-06,FM,Micronesia (Federated States of),0,26472,0,65,0.24554245995769114
2023-08-13,FM,Micronesia (Federated States of),69,26541,0,65,0.24490411062130288
2023-08-20,FM,Micronesia (Federated States of),0,26541,0,65,0.24490411062130288
2023-08-27,FM,Micronesia (Federated States of),0,26541,0,65,0.24490411062130288
2023-09-03,FM,Micronesia (Federated States of),0,26541,0,65,0.24490411062130288
2023-09-10,FM,Micronesia (Federated States of),5,26546,0,65,0.2448579823702253
2023-09-17,FM,Micronesia (Federated States of),1,26547,0,65,0.24484875880513807
2023-09-24,FM,Micronesia (Federated States of),0,26547,0,65,0.24484875880513807
2023-10-01,FM,Micronesia (Federated States of),0,26547,0,65,0.24484875880513807
2023-10-08,FM,Micronesia (Federated States of),0,26547,0,65,0.24484875880513807
2023-10-15,FM,Micronesia (Federated States of),0,26547,0,65,0.24484875880513807
2023-10-22,FM,Micronesia (Federated States of),0,26547,0,65,0.24484875880513807
2023-10-29,FM,Micronesia (Federated States of),0,26547,0,65,0.24484875880513807
2023-11-05,FM,Micronesia (Federated States of),0,26547,0,65,0.24484875880513807
2023-11-12,FM,Micronesia (Federated States of),0,26547,0,65,0.24484875880513807
2023-11-19,FM,Micronesia (Federated States of),0,26547,0,65,0.24484875880513807
2023-11-26,FM,Micronesia (Federated States of),0,26547,0,65,0.24484875880513807
2023-12-03,FM,Micronesia (Federated States of),0,26547,0,65,0.24484875880513807
2023-12-10,FM,Micronesia (Federated States of),0,26547,0,65,0.24484875880513807
2023-12-17,FM,Micronesia (Federated States of),0,26547,0,65,0.24484875880513807
2023-12-24,FM,Micronesia (Federated States of),0,26547,0,65,0.24484875880513807
2023-12-31,FM,Micronesia (Federated States of),0,26547,0,65,0.24484875880513807
2024-01-07,FM,Micronesia (Federated States of),0,26547,0,65,0.24484875880513807
2024-01-14,FM,Micronesia (Federated States of),0,26547,0,65,0.24484875880513807
2020-08-30,MC,Monaco,22,123,0,1,0.8130081300813009
2020-09-06,MC,Monaco,24,147,0,1,0.6802721088435374
2020-09-13,MC,Monaco,13,160,0,1,0.625
2020-09-20,MC,Monaco,14,174,0,1,0.5747126436781609
2020-10-11,MC,Monaco,14,205,0,2,0.975609756097561
2020-10-18,MC,Monaco,22,227,0,2,0.881057268722467
2020-10-25,MC,Monaco,32,259,0,2,0.7722007722007722
2020-11-01,MC,Monaco,55,314,0,2,0.6369426751592357
2020-11-08,MC,Monaco,55,369,0,2,0.5420054200542005
2020-11-15,MC,Monaco,54,423,0,2,0.4728132387706856
2020-11-22,MC,Monaco,28,451,1,3,0.6651884700665188
2020-11-29,MC,Monaco,18,469,0,3,0.6396588486140725
2020-12-06,MC,Monaco,20,489,0,3,0.6134969325153374
2020-12-13,MC,Monaco,31,520,0,3,0.576923076923077
2020-12-20,MC,Monaco,64,584,0,3,0.5136986301369862
2020-12-27,MC,Monaco,61,645,0,3,0.46511627906976744
2021-01-03,MC,Monaco,119,764,1,4,0.5235602094240838
2021-01-10,MC,Monaco,124,888,1,5,0.5630630630630631
2021-01-17,MC,Monaco,141,1029,3,8,0.7774538386783284
2021-01-24,MC,Monaco,154,1183,1,9,0.760777683854607
2021-01-31,MC,Monaco,127,1310,3,12,0.9160305343511451
2021-12-05,MC,Monaco,156,3704,0,36,0.9719222462203023
2021-12-12,MC,Monaco,196,3900,0,36,0.9230769230769231
2021-12-19,MC,Monaco,328,4228,0,36,0.8514664143803218
2021-12-26,MC,Monaco,377,4605,2,38,0.8251900108577632
2022-01-02,MC,Monaco,523,5128,1,39,0.7605304212168487
2022-01-09,MC,Monaco,943,6071,3,42,0.6918135397792785
2022-01-16,MC,Monaco,913,6984,2,44,0.6300114547537228
2022-01-23,MC,Monaco,949,7933,1,45,0.5672507248203706
2022-01-30,MC,Monaco,696,8629,1,46,0.533086104994785
2022-02-06,MC,Monaco,467,9096,2,48,0.5277044854881267
2022-02-13,MC,Monaco,249,9345,2,50,0.5350454788657035
2022-02-20,MC,Monaco,171,9516,1,51,0.5359394703656999
2022-02-27,MC,Monaco,201,9717,0,51,0.5248533497993207
2022-03-06,MC,Monaco,178,9895,0,51,0.515411824153613
2022-03-13,MC,Monaco,265,10160,1,52,0.5118110236220472
2022-03-20,MC,Monaco,374,10534,2,54,0.5126257831782799
2022-03-27,MC,Monaco,421,10955,0,54,0.49292560474669095
2022-04-03,MC,Monaco,334,11289,0,54,0.4783417486048365
2022-04-10,MC,Monaco,334,11623,1,55,0.47319969026929365
2022-04-17,MC,Monaco,274,11897,1,56,0.47070690089938644
2022-04-24,MC,Monaco,203,12100,1,57,0.47107438016528924
2022-05-01,MC,Monaco,172,12272,0,57,0.4644719687092568
2022-05-08,MC,Monaco,156,12428,0,57,0.45864177663340844
2022-05-15,MC,Monaco,90,12518,0,57,0.4553443042019492
2022-05-22,MC,Monaco,86,12604,0,57,0.4522373849571565
2022-05-29,MC,Monaco,62,12666,0,57,0.45002368545712934
2022-06-05,MC,Monaco,144,12810,0,57,0.44496487119437944
2022-06-12,MC,Monaco,191,13001,0,57,0.43842781324513497
2022-06-19,MC,Monaco,161,13162,0,57,0.433064883756268
2022-06-26,MC,Monaco,207,13369,0,57,0.426359488368614
2022-07-03,MC,Monaco,334,13703,2,59,0.4305626505144859
2022-07-10,MC,Monaco,354,14057,1,60,0.42683360603258164
2022-07-17,MC,Monaco,291,14348,1,61,0.42514636186228044
2022-07-24,MC,Monaco,168,14516,0,61,0.4202259575640672
2022-07-31,MC,Monaco,111,14627,0,61,0.4170369863950229
2022-08-07,MC,Monaco,93,14720,0,61,0.4144021739130435
2022-08-14,MC,Monaco,98,14818,0,61,0.4116614927790525
2022-08-21,MC,Monaco,36,14854,0,61,0.41066379426417127
2022-08-28,MC,Monaco,41,14895,0,61,0.40953340046995634
2022-09-04,MC,Monaco,36,14931,0,61,0.40854597816623134
2022-09-11,MC,Monaco,33,14964,2,63,0.4210104250200481
2022-09-18,MC,Monaco,66,15030,0,63,0.41916167664670656
2022-09-25,MC,Monaco,56,15086,0,63,0.4176057271642583
2022-10-02,MC,Monaco,86,15172,0,63,0.41523859741629315
2022-10-09,MC,Monaco,87,15259,0,63,0.41287109247001763
2022-10-16,MC,Monaco,81,15340,0,63,0.4106910039113429
2022-10-23,MC,Monaco,80,15420,1,64,0.4150453955901427
2022-10-30,MC,Monaco,67,15487,1,65,0.4197068509072125
2022-11-06,MC,Monaco,63,15550,0,65,0.4180064308681672
2022-11-13,MC,Monaco,94,15644,0,65,0.4154947583738174
2022-11-20,MC,Monaco,93,15737,0,65,0.4130393340535045
2022-11-27,MC,Monaco,152,15889,0,65,0.40908804833532636
2022-12-04,MC,Monaco,209,16098,0,65,0.4037768666915144
2022-12-11,MC,Monaco,175,16273,0,65,0.3994346463467093
2022-12-18,MC,Monaco,100,16373,0,65,0.3969950528308801
2022-12-25,MC,Monaco,66,16439,0,65,0.3954011801204453
2023-01-01,MC,Monaco,37,16476,0,65,0.3945132313668366
2023-01-08,MC,Monaco,47,16523,0,65,0.3933910306845004
2023-01-15,MC,Monaco,23,16546,0,65,0.3928441919497159
2023-01-22,MC,Monaco,18,16564,0,65,0.3924172905095388
2023-01-29,MC,Monaco,13,16577,0,65,0.3921095493756409
2023-02-05,MC,Monaco,31,16608,2,67,0.4034200385356455
2023-02-12,MC,Monaco,14,16622,0,67,0.4030802550836241
2023-02-19,MC,Monaco,7,16629,0,67,0.4029105779060677
2023-02-26,MC,Monaco,5,16634,0,67,0.4027894673560178
2023-03-05,MC,Monaco,6,16640,0,67,0.4026442307692307
2023-03-12,MC,Monaco,7,16647,0,67,0.4024749204060792
2023-03-19,MC,Monaco,24,16671,0,67,0.40189550716813627
2023-03-26,MC,Monaco,15,16686,0,67,0.40153422030444685
2023-04-02,MC,Monaco,19,16705,0,67,0.40107752170008976
2023-04-09,MC,Monaco,19,16724,0,67,0.400621860798852
2023-04-16,MC,Monaco,15,16739,0,67,0.40026285919111054
2023-04-23,MC,Monaco,11,16750,0,67,0.4
2023-04-30,MC,Monaco,5,16755,0,67,0.39988063264697105
2023-05-07,MC,Monaco,8,16763,0,67,0.39968979299648033
2023-05-14,MC,Monaco,12,16775,0,67,0.39940387481371087
2023-05-21,MC,Monaco,9,16784,0,67,0.3991897044804576
2023-05-28,MC,Monaco,9,16793,0,67,0.39897576371107013
2023-06-04,MC,Monaco,5,16798,0,67,0.39885700678652225
2023-06-11,MC,Monaco,16,16814,0,67,0.3984774592601404
2023-06-18,MC,Monaco,3,16817,0,67,0.398406374501992
2023-06-25,MC,Monaco,9,16826,0,67,0.3981932723166528
2023-07-02,MC,Monaco,12,16838,0,67,0.3979094904382943
2023-07-09,MC,Monaco,2,16840,0,67,0.39786223277909744
2023-07-16,MC,Monaco,2,16842,0,67,0.39781498634366463
2023-07-23,MC,Monaco,6,16848,0,67,0.397673314339981
2023-07-30,MC,Monaco,4,16852,0,67,0.39757892238309994
2023-08-06,MC,Monaco,6,16858,0,67,0.3974374184363507
2023-08-13,MC,Monaco,13,16871,0,67,0.39713117183332347
2023-08-20,MC,Monaco,10,16881,0,67,0.39689591848824124
2023-08-27,MC,Monaco,20,16901,0,67,0.39642624696763507
2023-09-03,MC,Monaco,17,16918,0,67,0.39602789927887455
2023-09-10,MC,Monaco,13,16931,0,67,0.3957238202114465
2023-09-17,MC,Monaco,13,16944,0,67,0.3954202077431539
2023-09-24,MC,Monaco,31,16975,0,67,0.39469808541973495
2023-10-01,MC,Monaco,26,17001,0,67,0.3940944650314688
2023-10-08,MC,Monaco,26,17027,0,67,0.3934926880836319
2023-10-15,MC,Monaco,22,17049,0,67,0.39298492580209987
2023-10-22,MC,Monaco,23,17072,0,67,0.39245548266166824
2023-10-29,MC,Monaco,18,17090,0,67,0.3920421299005266
2023-11-05,MC,Monaco,19,17109,0,67,0.3916067566777719
2023-11-12,MC,Monaco,11,17120,0,67,0.3913551401869159
2023-11-19,MC,Monaco,46,17166,0,67,0.39030641966678314
2023-11-26,MC,Monaco,15,17181,0,67,0.3899656597404109
2023-12-03,MC,Monaco,0,17181,0,67,0.3899656597404109
2023-12-10,MC,Monaco,0,17181,0,67,0.3899656597404109
2023-12-17,MC,Monaco,0,17181,0,67,0.3899656597404109
2023-12-24,MC,Monaco,0,17181,0,67,0.3899656597404109
2023-12-31,MC,Monaco,0,17181,0,67,0.3899656597404109
2024-01-07,MC,Monaco,0,17181,0,67,0.3899656597404109
2024-01-14,MC,Monaco,0,17181,0,67,0.3899656597404109
2020-12-20,MN,Mongolia,54,961,1,1,0.10405827263267431
2020-12-27,MN,Mongolia,160,1121,0,1,0.08920606601248886
2021-01-03,MN,Mongolia,165,1286,0,1,0.07776049766718507
2021-01-10,MN,Mongolia,156,1442,0,1,0.06934812760055478
2021-01-17,MN,Mongolia,84,1526,0,1,0.0655307994757536
2021-01-24,MN,Mongolia,117,1643,1,2,0.12172854534388314
2021-01-31,MN,Mongolia,171,1814,0,2,0.11025358324145534
2021-02-07,MN,Mongolia,259,2073,0,2,0.0964785335262904
2021-02-14,MN,Mongolia,310,2383,0,2,0.0839278220730172
2021-02-21,MN,Mongolia,310,2693,0,2,0.07426661715558856
2021-02-28,MN,Mongolia,259,2952,0,2,0.06775067750677506
2021-03-07,MN,Mongolia,384,3336,1,3,0.08992805755395684
2021-03-14,MN,Mongolia,747,4083,1,4,0.09796718099436688
2021-03-21,MN,Mongolia,1103,5186,1,5,0.09641342074816814
2021-03-28,MN,Mongolia,2403,7589,1,6,0.07906179997364607
2021-04-04,MN,Mongolia,3231,10820,6,12,0.11090573012939
2021-04-11,MN,Mongolia,4898,15718,11,23,0.14632904949739153
2021-04-18,MN,Mongolia,7166,22884,26,49,0.21412340499912605
2021-04-25,MN,Mongolia,8455,31339,34,83,0.26484571939117396
2021-05-02,MN,Mongolia,8042,39381,48,131,0.33264772352149513
2021-05-09,MN,Mongolia,6078,45459,34,165,0.36296442948591034
2021-05-16,MN,Mongolia,3716,49175,37,202,0.4107778342653788
2021-05-23,MN,Mongolia,3925,53100,21,223,0.4199623352165725
2021-05-30,MN,Mongolia,5339,58439,30,253,0.43293006382723864
2021-06-06,MN,Mongolia,8004,66443,35,288,0.4334542389717502
2021-06-13,MN,Mongolia,11904,78347,57,345,0.44034870511953234
2021-06-20,MN,Mongolia,17472,95819,74,419,0.4372827936004342
2021-06-27,MN,Mongolia,15686,111505,60,479,0.42957714900677096
2021-07-04,MN,Mongolia,15306,126811,69,548,0.4321391677378146
2021-07-11,MN,Mongolia,12473,139284,57,605,0.43436432038137907
2021-07-18,MN,Mongolia,10449,149733,32,637,0.42542392124648537
2021-07-25,MN,Mongolia,8241,157974,51,688,0.4355147049514477
2021-08-01,MN,Mongolia,9255,167229,34,722,0.43174329811216955
2021-08-08,MN,Mongolia,8331,175560,31,753,0.42891319207108686
2021-08-15,MN,Mongolia,8092,183652,23,776,0.42253827891882473
2021-08-22,MN,Mongolia,11593,195245,26,802,0.4107659607160235
2021-08-29,MN,Mongolia,16030,211275,33,835,0.3952195006508105
2021-09-05,MN,Mongolia,24999,236274,50,885,0.37456512354300514
2021-09-12,MN,Mongolia,32709,268983,88,973,0.3617328976180651
2021-09-19,MN,Mongolia,38895,307878,73,1046,0.3397449639142777
2021-09-26,MN,Mongolia,50789,358667,106,1152,0.3211892925750069
2021-10-03,MN,Mongolia,46698,405365,122,1274,0.31428465703748476
2021-10-10,MN,Mongolia,46988,452353,103,1377,0.3044082829117967
2021-10-17,MN,Mongolia,46550,498903,106,1483,0.2972521712637527
2021-10-24,MN,Mongolia,40294,539197,110,1593,0.29543932922475463
2021-10-31,MN,Mongolia,53797,592994,79,1672,0.2819590080169445
2021-11-07,MN,Mongolia,27029,620023,72,1744,0.2812798880041547
2021-11-14,MN,Mongolia,18494,638517,71,1815,0.28425241614553726
2021-11-21,MN,Mongolia,16310,654827,60,1875,0.2863351694416999
2021-11-28,MN,Mongolia,12534,667361,47,1922,0.28800004795006
2021-12-05,MN,Mongolia,9498,676859,22,1944,0.28720900512514425
2021-12-12,MN,Mongolia,5868,682727,19,1963,0.2875234171198737
2021-12-19,MN,Mongolia,4705,687432,9,1972,0.28686473716673067
2021-12-26,MN,Mongolia,3518,690950,9,1981,0.2867067081554382
2022-01-02,MN,Mongolia,2899,693849,6,1987,0.28637354813511295
2022-01-09,MN,Mongolia,12137,705986,14,2001,0.28343338253166495
2022-01-16,MN,Mongolia,35696,741682,12,2013,0.2714101191615814
2022-01-23,MN,Mongolia,53226,794908,8,2021,0.2542432583393298
2022-01-30,MN,Mongolia,46940,841848,15,2036,0.2418488848343169
2022-02-06,MN,Mongolia,19128,860976,19,2055,0.2386826113619892
2022-02-13,MN,Mongolia,26778,887754,19,2074,0.23362327852085152
2022-02-20,MN,Mongolia,11952,899706,13,2087,0.23196466401246627
2022-02-27,MN,Mongolia,8451,908157,9,2096,0.23079709785863017
2022-03-06,MN,Mongolia,5098,913255,8,2104,0.23038472277731847
2022-03-13,MN,Mongolia,2556,915811,1,2105,0.22985091902150115
2022-03-20,MN,Mongolia,1402,917213,3,2108,0.22982665967447038
2022-03-27,MN,Mongolia,1691,918904,0,2108,0.2294037244369379
2022-04-03,MN,Mongolia,640,919544,0,2108,0.2292440600993536
2022-04-10,MN,Mongolia,460,920004,0,2108,0.2291294385676584
2022-04-17,MN,Mongolia,202,920206,0,2108,0.22907914097495563
2022-04-24,MN,Mongolia,230,920436,0,2108,0.22902189831775377
2022-05-01,MN,Mongolia,989,921425,2,2110,0.22899313563230864
2022-05-08,MN,Mongolia,802,922227,1,2111,0.22890242857777965
2022-05-15,MN,Mongolia,0,922227,2,2113,0.22911929492413474
2022-05-22,MN,Mongolia,1808,924035,1,2114,0.22877921290860195
2022-05-29,MN,Mongolia,1038,925073,1,2115,0.2286306053684412
2022-06-05,MN,Mongolia,2199,927272,1,2116,0.22819625740882932
2022-06-12,MN,Mongolia,741,928013,0,2116,0.228014047217011
2022-06-19,MN,Mongolia,573,928586,0,2116,0.22787334721824365
2022-06-26,MN,Mongolia,0,928586,0,2116,0.22787334721824365
2022-07-03,MN,Mongolia,395,928981,2,2118,0.22799174579458567
2022-07-10,MN,Mongolia,672,929653,1,2119,0.2279345088974058
2022-07-17,MN,Mongolia,1024,930677,0,2119,0.227683718411436
2022-07-24,MN,Mongolia,7066,937743,0,2119,0.22596809573625182
2022-07-31,MN,Mongolia,9279,947022,0,2119,0.2237540416167734
2022-08-07,MN,Mongolia,13970,960992,4,2123,0.2209175518630748
2022-08-14,MN,Mongolia,5431,966423,0,2123,0.21967606317316538
2022-08-21,MN,Mongolia,7810,974233,2,2125,0.21812030592271045
2022-08-28,MN,Mongolia,3023,977256,3,2128,0.21775256432296142
2022-09-04,MN,Mongolia,2388,979644,1,2129,0.2173238441719645
2022-09-11,MN,Mongolia,1506,981150,1,2130,0.21709218773887784
2022-09-18,MN,Mongolia,1157,982307,1,2131,0.21693828914992971
2022-09-25,MN,Mongolia,393,982700,0,2131,0.21685153149486108
2022-10-02,MN,Mongolia,304,983004,0,2131,0.21678446883227334
2022-10-09,MN,Mongolia,606,983610,0,2131,0.2166509083884873
2022-10-16,MN,Mongolia,378,983988,0,2131,0.21656768171969576
2022-10-23,MN,Mongolia,343,984331,0,2131,0.2164922165409806
2022-10-30,MN,Mongolia,492,984823,0,2131,0.2163840608921603
2022-11-06,MN,Mongolia,829,985652,0,2131,0.21620206726106173
2022-11-13,MN,Mongolia,1588,987240,1,2132,0.21595559337141934
2022-11-20,MN,Mongolia,2473,989713,2,2134,0.21561806301422737
2022-11-27,MN,Mongolia,2388,992101,0,2134,0.21509906753445465
2022-12-04,MN,Mongolia,1271,993372,1,2135,0.21492451971668217
2022-12-11,MN,Mongolia,707,994079,0,2135,0.21477166301672201
2022-12-18,MN,Mongolia,12991,1007070,0,2135,0.2120011518563754
2022-12-25,MN,Mongolia,244,1007314,1,2136,0.21204907307949658
2023-01-01,MN,Mongolia,108,1007422,0,2136,0.21202634050080305
2023-01-08,MN,Mongolia,343,1007765,0,2136,0.211954175824721
2023-01-15,MN,Mongolia,61,1007826,0,2136,0.21194134701823528
2023-01-22,MN,Mongolia,31,1007857,0,2136,0.21193482805596428
2023-01-29,MN,Mongolia,12,1007869,0,2136,0.21193230469436006
2023-02-05,MN,Mongolia,7,1007876,0,2136,0.21193083276117303
2023-02-12,MN,Mongolia,18,1007894,0,2136,0.21192704788400366
2023-02-19,MN,Mongolia,1,1007895,0,2136,0.21192683761701367
2023-02-26,MN,Mongolia,2,1007897,0,2136,0.2119264170842854
2023-03-05,MN,Mongolia,3,1007900,0,2136,0.21192578628832226
2023-03-12,MN,Mongolia,5,1007905,0,2136,0.21192473497006165
2023-03-19,MN,Mongolia,2,1007907,0,2136,0.21192431444567802
2023-03-26,MN,Mongolia,4,1007911,0,2136,0.21192347340191742
2023-04-02,MN,Mongolia,9,1007920,0,2136,0.21192158107786332
2023-04-09,MN,Mongolia,0,1007920,0,2136,0.21192158107786332
2023-04-16,MN,Mongolia,23,1007943,0,2136,0.2119167452921445
2023-04-23,MN,Mongolia,27,1007970,0,2136,0.211911068781809
2023-04-30,MN,Mongolia,29,1007999,0,2136,0.21190497212794854
2023-05-07,MN,Mongolia,39,1008038,0,2136,0.21189677373273627
2023-05-14,MN,Mongolia,227,1008265,0,2136,0.21184906745746407
2023-05-21,MN,Mongolia,390,1008655,0,2136,0.21176715527112835
2023-05-28,MN,Mongolia,671,1009326,0,2136,0.2116263724505264
2023-06-04,MN,Mongolia,764,1010090,0,2136,0.2114663049827243
2023-06-11,MN,Mongolia,369,1010459,0,2136,0.21138908159559172
2023-06-18,MN,Mongolia,277,1010736,0,2136,0.2113311487866268
2023-06-25,MN,Mongolia,116,1010852,0,2136,0.21130689754781115
2023-07-02,MN,Mongolia,54,1010906,148,2284,0.22593594260989647
2023-07-09,MN,Mongolia,29,1010935,0,2284,0.22592946134024441
2023-07-16,MN,Mongolia,6,1010941,0,2284,0.22592812043432803
2023-07-23,MN,Mongolia,6,1010947,0,2284,0.22592677954432824
2023-07-30,MN,Mongolia,7,1010954,0,2284,0.2259252151927783
2023-08-06,MN,Mongolia,9,1010963,0,2284,0.22592320391547466
2023-08-13,MN,Mongolia,8,1010971,0,2284,0.2259214161434898
2023-08-20,MN,Mongolia,4,1010975,0,2284,0.22592052226810752
2023-08-27,MN,Mongolia,9,1010984,0,2284,0.22591851107435923
2023-09-03,MN,Mongolia,11,1010995,0,2284,0.22591605299729475
2023-09-10,MN,Mongolia,16,1011011,0,2284,0.2259124777079577
2023-09-17,MN,Mongolia,34,1011045,0,2284,0.22590488059384103
2023-09-24,MN,Mongolia,41,1011086,0,2284,0.22589572004755284
2023-10-01,MN,Mongolia,84,1011170,0,2284,0.22587695441913824
2023-10-08,MN,Mongolia,18,1011188,0,2284,0.22587293361867428
2023-10-15,MN,Mongolia,0,1011188,0,2284,0.22587293361867428
2023-10-22,MN,Mongolia,18,1011206,0,2284,0.22586891296135508
2023-10-29,MN,Mongolia,18,1011224,0,2284,0.22586489244717295
2023-11-05,MN,Mongolia,21,1011245,0,2284,0.22586020202819296
2023-11-12,MN,Mongolia,16,1011261,0,2284,0.22585662850638952
2023-11-19,MN,Mongolia,19,1011280,0,2284,0.2258523850961158
2023-11-26,MN,Mongolia,17,1011297,0,2284,0.2258485884957634
2023-12-03,MN,Mongolia,22,1011319,0,2284,0.22584367543772044
2023-12-10,MN,Mongolia,34,1011353,0,2284,0.22583608295026564
2023-12-17,MN,Mongolia,35,1011388,0,2284,0.22582826768757389
2023-12-24,MN,Mongolia,19,1011407,0,2284,0.2258240253429134
2023-12-31,MN,Mongolia,13,1011420,0,2284,0.22582112277787664
2024-01-07,MN,Mongolia,11,1011431,0,2284,0.22581866681958535
2024-01-14,MN,Mongolia,0,1011431,0,2284,0.22581866681958535
2022-01-09,MS,Montserrat,60,110,0,1,0.9090909090909091
2022-01-16,MS,Montserrat,19,129,0,1,0.7751937984496124
2022-01-23,MS,Montserrat,23,152,0,1,0.6578947368421052
2022-01-30,MS,Montserrat,10,162,0,1,0.6172839506172839
2022-02-06,MS,Montserrat,1,163,0,1,0.6134969325153374
2022-05-01,MS,Montserrat,39,216,0,2,0.9259259259259258
2022-05-08,MS,Montserrat,236,452,0,2,0.4424778761061947
2022-05-15,MS,Montserrat,295,747,0,2,0.2677376171352075
2022-05-22,MS,Montserrat,139,886,2,4,0.4514672686230248
2022-05-29,MS,Montserrat,72,958,0,4,0.41753653444676403
2022-06-05,MS,Montserrat,45,1003,4,8,0.7976071784646062
2022-06-12,MS,Montserrat,7,1010,0,8,0.7920792079207921
2022-06-19,MS,Montserrat,5,1015,0,8,0.7881773399014778
2022-06-26,MS,Montserrat,1,1016,0,8,0.7874015748031495
2022-07-03,MS,Montserrat,4,1020,0,8,0.7843137254901961
2022-07-10,MS,Montserrat,3,1023,0,8,0.7820136852394917
2022-07-17,MS,Montserrat,2,1025,0,8,0.7804878048780488
2022-07-24,MS,Montserrat,7,1032,0,8,0.7751937984496124
2022-07-31,MS,Montserrat,22,1054,0,8,0.7590132827324478
2022-08-07,MS,Montserrat,23,1077,0,8,0.7428040854224698
2022-08-14,MS,Montserrat,20,1097,0,8,0.7292616226071102
2022-08-21,MS,Montserrat,9,1106,0,8,0.7233273056057866
2022-08-28,MS,Montserrat,20,1126,0,8,0.7104795737122558
2022-09-04,MS,Montserrat,64,1190,0,8,0.6722689075630253
2022-09-11,MS,Montserrat,86,1276,0,8,0.6269592476489028
2022-09-18,MS,Montserrat,80,1356,0,8,0.5899705014749262
2022-09-25,MS,Montserrat,36,1392,0,8,0.5747126436781609
2022-10-02,MS,Montserrat,11,1403,0,8,0.5702066999287242
2022-10-09,MS,Montserrat,0,1403,0,8,0.5702066999287242
2022-10-16,MS,Montserrat,0,1403,0,8,0.5702066999287242
2022-10-23,MS,Montserrat,0,1403,0,8,0.5702066999287242
2022-10-30,MS,Montserrat,0,1403,0,8,0.5702066999287242
2022-11-06,MS,Montserrat,0,1403,0,8,0.5702066999287242
2022-11-13,MS,Montserrat,0,1403,0,8,0.5702066999287242
2022-11-20,MS,Montserrat,0,1403,0,8,0.5702066999287242
2022-11-27,MS,Montserrat,0,1403,0,8,0.5702066999287242
2022-12-04,MS,Montserrat,0,1403,0,8,0.5702066999287242
2022-12-11,MS,Montserrat,0,1403,0,8,0.5702066999287242
2022-12-18,MS,Montserrat,0,1403,0,8,0.5702066999287242
2022-12-25,MS,Montserrat,0,1403,0,8,0.5702066999287242
2023-01-01,MS,Montserrat,0,1403,0,8,0.5702066999287242
2023-01-08,MS,Montserrat,0,1403,0,8,0.5702066999287242
2023-01-15,MS,Montserrat,0,1403,0,8,0.5702066999287242
2023-01-22,MS,Montserrat,0,1403,0,8,0.5702066999287242
2023-01-29,MS,Montserrat,0,1403,0,8,0.5702066999287242
2023-02-05,MS,Montserrat,0,1403,0,8,0.5702066999287242
2023-02-12,MS,Montserrat,0,1403,0,8,0.5702066999287242
2023-02-19,MS,Montserrat,0,1403,0,8,0.5702066999287242
2023-02-26,MS,Montserrat,0,1403,0,8,0.5702066999287242
2023-03-05,MS,Montserrat,0,1403,0,8,0.5702066999287242
2023-03-12,MS,Montserrat,0,1403,0,8,0.5702066999287242
2023-03-19,MS,Montserrat,0,1403,0,8,0.5702066999287242
2023-03-26,MS,Montserrat,0,1403,0,8,0.5702066999287242
2023-04-02,MS,Montserrat,0,1403,0,8,0.5702066999287242
2023-04-09,MS,Montserrat,0,1403,0,8,0.5702066999287242
2023-04-16,MS,Montserrat,0,1403,0,8,0.5702066999287242
2023-04-23,MS,Montserrat,0,1403,0,8,0.5702066999287242
2023-04-30,MS,Montserrat,0,1403,0,8,0.5702066999287242
2023-05-07,MS,Montserrat,0,1403,0,8,0.5702066999287242
2023-05-14,MS,Montserrat,0,1403,0,8,0.5702066999287242
2023-05-21,MS,Montserrat,0,1403,0,8,0.5702066999287242
2023-05-28,MS,Montserrat,0,1403,0,8,0.5702066999287242
2023-06-04,MS,Montserrat,0,1403,0,8,0.5702066999287242
2023-06-11,MS,Montserrat,0,1403,0,8,0.5702066999287242
2023-06-18,MS,Montserrat,0,1403,0,8,0.5702066999287242
2023-06-25,MS,Montserrat,0,1403,0,8,0.5702066999287242
2023-07-02,MS,Montserrat,0,1403,0,8,0.5702066999287242
2023-07-09,MS,Montserrat,0,1403,0,8,0.5702066999287242
2023-07-16,MS,Montserrat,0,1403,0,8,0.5702066999287242
2023-07-23,MS,Montserrat,0,1403,0,8,0.5702066999287242
2023-07-30,MS,Montserrat,0,1403,0,8,0.5702066999287242
2023-08-06,MS,Montserrat,0,1403,0,8,0.5702066999287242
2023-08-13,MS,Montserrat,0,1403,0,8,0.5702066999287242
2023-08-20,MS,Montserrat,0,1403,0,8,0.5702066999287242
2023-08-27,MS,Montserrat,0,1403,0,8,0.5702066999287242
2023-09-03,MS,Montserrat,0,1403,0,8,0.5702066999287242
2023-09-10,MS,Montserrat,0,1403,0,8,0.5702066999287242
2023-09-17,MS,Montserrat,0,1403,0,8,0.5702066999287242
2023-09-24,MS,Montserrat,0,1403,0,8,0.5702066999287242
2023-10-01,MS,Montserrat,0,1403,0,8,0.5702066999287242
2023-10-08,MS,Montserrat,0,1403,0,8,0.5702066999287242
2023-10-15,MS,Montserrat,0,1403,0,8,0.5702066999287242
2023-10-22,MS,Montserrat,0,1403,0,8,0.5702066999287242
2023-10-29,MS,Montserrat,0,1403,0,8,0.5702066999287242
2023-11-05,MS,Montserrat,0,1403,0,8,0.5702066999287242
2023-11-12,MS,Montserrat,0,1403,0,8,0.5702066999287242
2023-11-19,MS,Montserrat,0,1403,0,8,0.5702066999287242
2023-11-26,MS,Montserrat,0,1403,0,8,0.5702066999287242
2023-12-03,MS,Montserrat,0,1403,0,8,0.5702066999287242
2023-12-10,MS,Montserrat,0,1403,0,8,0.5702066999287242
2023-12-17,MS,Montserrat,0,1403,0,8,0.5702066999287242
2023-12-24,MS,Montserrat,0,1403,0,8,0.5702066999287242
2023-12-31,MS,Montserrat,0,1403,0,8,0.5702066999287242
2024-01-07,MS,Montserrat,0,1403,0,8,0.5702066999287242
2024-01-14,MS,Montserrat,0,1403,0,8,0.5702066999287242
2020-05-31,MZ,Mozambique,76,244,2,2,0.819672131147541
2020-06-07,MZ,Mozambique,167,411,0,2,0.48661800486618007
2020-06-14,MZ,Mozambique,142,553,0,2,0.3616636528028933
2020-06-21,MZ,Mozambique,135,688,2,4,0.5813953488372093
2020-06-28,MZ,Mozambique,151,839,1,5,0.5959475566150179
2020-07-05,MZ,Mozambique,130,969,2,7,0.7223942208462332
2020-07-12,MZ,Mozambique,166,1135,2,9,0.7929515418502203
2020-07-19,MZ,Mozambique,300,1435,1,10,0.6968641114982579
2020-07-26,MZ,Mozambique,181,1616,1,11,0.6806930693069307
2020-08-02,MZ,Mozambique,291,1907,1,12,0.6292606187729418
2020-08-09,MZ,Mozambique,334,2241,6,18,0.8032128514056224
2020-08-16,MZ,Mozambique,550,2791,1,19,0.680759584378359
2020-08-23,MZ,Mozambique,513,3304,1,20,0.6053268765133172
2020-08-30,MZ,Mozambique,456,3760,2,22,0.5851063829787234
2020-09-06,MZ,Mozambique,581,4341,4,26,0.598940336328035
2020-09-13,MZ,Mozambique,699,5040,9,35,0.6944444444444444
2020-09-20,MZ,Mozambique,1497,6537,6,41,0.6271990209576258
2020-09-27,MZ,Mozambique,1220,7757,13,54,0.6961454170426712
2020-10-04,MZ,Mozambique,1292,9049,10,64,0.7072604707702508
2020-10-11,MZ,Mozambique,795,9844,7,71,0.7212515237708249
2020-10-18,MZ,Mozambique,863,10707,3,74,0.6911366395815821
2020-10-25,MZ,Mozambique,1188,11895,11,85,0.7145859604875998
2020-11-01,MZ,Mozambique,974,12869,7,92,0.7148962623358459
2020-11-08,MZ,Mozambique,708,13577,7,99,0.7291743389555867
2020-11-15,MZ,Mozambique,763,14340,11,110,0.7670850767085077
2020-11-22,MZ,Mozambique,641,14981,13,123,0.8210399839797076
2020-11-29,MZ,Mozambique,605,15586,6,129,0.8276658539715129
2020-12-06,MZ,Mozambique,547,16133,4,133,0.8243971982892208
2020-12-13,MZ,Mozambique,679,16812,7,140,0.8327385201046872
2020-12-20,MZ,Mozambique,665,17477,7,147,0.8411054528809293
2020-12-27,MZ,Mozambique,685,18162,12,159,0.8754542451271887
2021-01-03,MZ,Mozambique,806,18968,9,168,0.8857022353437369
2021-01-10,MZ,Mozambique,2393,21361,19,187,0.8754271803754506
2021-01-17,MZ,Mozambique,4501,25862,47,234,0.9048024128064343
2021-01-24,MZ,Mozambique,5766,31628,63,297,0.9390413557607182
2021-01-31,MZ,Mozambique,6077,37705,66,363,0.9627370375281793
2022-01-16,MZ,Mozambique,9408,218797,46,2123,0.9703058085805565
2022-01-23,MZ,Mozambique,3618,222415,30,2153,0.9680102511071644
2022-01-30,MZ,Mozambique,1323,223738,14,2167,0.9685435643475852
2022-02-06,MZ,Mozambique,571,224309,16,2183,0.9732110615267332
2022-02-13,MZ,Mozambique,344,224653,6,2189,0.9743916172942272
2022-02-20,MZ,Mozambique,229,224882,0,2189,0.9733993827874173
2022-02-27,MZ,Mozambique,154,225036,3,2192,0.9740663716027658
2022-03-06,MZ,Mozambique,99,225135,4,2196,0.9754147511493104
2022-03-13,MZ,Mozambique,38,225173,2,2198,0.9761383469598931
2022-03-20,MZ,Mozambique,33,225206,1,2199,0.9764393488628189
2022-03-27,MZ,Mozambique,31,225237,1,2200,0.9767489355656486
2022-04-03,MZ,Mozambique,27,225264,0,2200,0.9766318630584558
2022-04-10,MZ,Mozambique,16,225280,0,2200,0.9765625
2022-04-17,MZ,Mozambique,43,225323,0,2200,0.9763761355920167
2022-04-24,MZ,Mozambique,35,225358,1,2201,0.9766682345423726
2022-05-01,MZ,Mozambique,29,225387,0,2201,0.9765425690035362
2022-05-08,MZ,Mozambique,32,225419,0,2201,0.9764039411052308
2022-05-15,MZ,Mozambique,74,225493,0,2201,0.9760835147875987
2022-05-22,MZ,Mozambique,70,225563,0,2201,0.9757806023150959
2022-05-29,MZ,Mozambique,138,225701,2,2203,0.9760701104558687
2022-06-05,MZ,Mozambique,232,225933,1,2204,0.9755104389354365
2022-06-12,MZ,Mozambique,392,226325,2,2206,0.9747045178393903
2022-06-19,MZ,Mozambique,758,227083,3,2209,0.9727720701241397
2022-06-26,MZ,Mozambique,444,227527,3,2212,0.9721923112421822
2022-07-03,MZ,Mozambique,495,228022,0,2212,0.9700818342089799
2022-07-10,MZ,Mozambique,617,228639,1,2213,0.9679013641592205
2022-07-17,MZ,Mozambique,381,229020,2,2215,0.9671644397869182
2022-07-24,MZ,Mozambique,331,229351,0,2215,0.9657686253820564
2022-07-31,MZ,Mozambique,213,229564,0,2215,0.9648725409907476
2022-08-07,MZ,Mozambique,132,229696,1,2216,0.9647534132070215
2022-08-14,MZ,Mozambique,182,229878,3,2219,0.9652946345452806
2022-08-21,MZ,Mozambique,114,229992,0,2219,0.9648161675188702
2022-08-28,MZ,Mozambique,72,230064,1,2220,0.9649488837888588
2022-09-04,MZ,Mozambique,61,230125,0,2220,0.9646931015752308
2022-09-11,MZ,Mozambique,46,230171,2,2222,0.9653692254888756
2022-09-18,MZ,Mozambique,48,230219,0,2222,0.9651679487792059
2022-09-25,MZ,Mozambique,0,230219,0,2222,0.9651679487792059
2022-10-02,MZ,Mozambique,93,230312,0,2222,0.9647782139011428
2022-10-09,MZ,Mozambique,58,230370,2,2224,0.9654034813560795
2022-10-16,MZ,Mozambique,31,230401,0,2224,0.9652735882222733
2022-10-23,MZ,Mozambique,30,230431,0,2224,0.9651479184658314
2022-10-30,MZ,Mozambique,44,230475,0,2224,0.9649636620023864
2022-11-06,MZ,Mozambique,24,230499,0,2224,0.9648631881266295
2022-11-13,MZ,Mozambique,44,230543,0,2224,0.964679040352559
2022-11-20,MZ,Mozambique,47,230590,0,2224,0.9644824146753979
2022-11-27,MZ,Mozambique,34,230624,2,2226,0.9652074372138199
2022-12-04,MZ,Mozambique,91,230715,0,2226,0.9648267342825564
2022-12-11,MZ,Mozambique,101,230816,3,2229,0.9657042839317898
2022-12-18,MZ,Mozambique,102,230918,0,2229,0.9652777176313669
2022-12-25,MZ,Mozambique,52,230970,1,2230,0.965493354115253
2023-01-01,MZ,Mozambique,69,231039,2,2232,0.9660706633944919
2023-01-08,MZ,Mozambique,180,231219,0,2232,0.9653185940601766
2023-01-15,MZ,Mozambique,185,231404,0,2232,0.9645468531226772
2023-01-22,MZ,Mozambique,590,231994,1,2233,0.9625248928851607
2023-01-29,MZ,Mozambique,516,232510,3,2236,0.9616790675669864
2023-02-05,MZ,Mozambique,309,232819,1,2237,0.9608322344825809
2023-02-12,MZ,Mozambique,184,233003,2,2239,0.9609318334957061
2023-02-19,MZ,Mozambique,95,233098,3,2242,0.9618272143047131
2023-02-26,MZ,Mozambique,50,233148,0,2242,0.9616209446360251
2023-03-05,MZ,Mozambique,66,233214,0,2242,0.9613488041026695
2023-03-12,MZ,Mozambique,0,233214,0,2242,0.9613488041026695
2023-03-19,MZ,Mozambique,0,233214,0,2242,0.9613488041026695
2023-03-26,MZ,Mozambique,120,233334,0,2242,0.9608543975588641
2023-04-02,MZ,Mozambique,9,233343,0,2242,0.9608173375674437
2023-04-09,MZ,Mozambique,27,233370,0,2242,0.9607061747439688
2023-04-16,MZ,Mozambique,12,233382,0,2242,0.9606567773007344
2023-04-23,MZ,Mozambique,16,233398,0,2242,0.9605909219444897
2023-04-30,MZ,Mozambique,19,233417,1,2243,0.9609411482454148
2023-05-07,MZ,Mozambique,0,233417,0,2243,0.9609411482454148
2023-05-14,MZ,Mozambique,0,233417,0,2243,0.9609411482454148
2023-05-21,MZ,Mozambique,0,233417,0,2243,0.9609411482454148
2023-05-28,MZ,Mozambique,0,233417,0,2243,0.9609411482454148
2023-06-04,MZ,Mozambique,0,233417,0,2243,0.9609411482454148
2023-06-11,MZ,Mozambique,0,233417,0,2243,0.9609411482454148
2023-06-18,MZ,Mozambique,0,233417,0,2243,0.9609411482454148
2023-06-25,MZ,Mozambique,0,233417,0,2243,0.9609411482454148
2023-07-02,MZ,Mozambique,0,233417,0,2243,0.9609411482454148
2023-07-09,MZ,Mozambique,0,233417,0,2243,0.9609411482454148
2023-07-16,MZ,Mozambique,0,233417,0,2243,0.9609411482454148
2023-07-23,MZ,Mozambique,0,233417,0,2243,0.9609411482454148
2023-07-30,MZ,Mozambique,0,233417,0,2243,0.9609411482454148
2023-08-06,MZ,Mozambique,0,233417,0,2243,0.9609411482454148
2023-08-13,MZ,Mozambique,214,233631,6,2249,0.9626291031583992
2023-08-20,MZ,Mozambique,3,233634,0,2249,0.962616742426188
2023-08-27,MZ,Mozambique,4,233638,0,2249,0.9626002619436906
2023-09-03,MZ,Mozambique,4,233642,0,2249,0.962583782025492
2023-09-10,MZ,Mozambique,3,233645,0,2249,0.9625714224571467
2023-09-17,MZ,Mozambique,4,233649,0,2249,0.9625549435264008
2023-09-24,MZ,Mozambique,2,233651,0,2249,0.9625467042726117
2023-10-01,MZ,Mozambique,1,233652,0,2249,0.9625425846986116
2023-10-08,MZ,Mozambique,2,233654,0,2249,0.962534345656398
2023-10-15,MZ,Mozambique,4,233658,0,2249,0.962517867995104
2023-10-22,MZ,Mozambique,1,233659,0,2249,0.9625137486679307
2023-10-29,MZ,Mozambique,3,233662,0,2249,0.9625013908979638
2023-11-05,MZ,Mozambique,2,233664,1,2250,0.9629211175020542
2023-11-12,MZ,Mozambique,4,233668,0,2250,0.962904633925056
2023-11-19,MZ,Mozambique,12,233680,0,2250,0.9628551865799384
2023-11-26,MZ,Mozambique,31,233711,0,2250,0.9627274711074789
2023-12-03,MZ,Mozambique,9,233720,0,2250,0.9626903987677562
2023-12-10,MZ,Mozambique,11,233731,0,2250,0.9626450920074787
2023-12-17,MZ,Mozambique,0,233731,0,2250,0.9626450920074787
2023-12-24,MZ,Mozambique,0,233731,0,2250,0.9626450920074787
2023-12-31,MZ,Mozambique,-23,233708,0,2250,0.9627398291885602
2024-01-07,MZ,Mozambique,0,233708,0,2250,0.9627398291885602
2024-01-14,MZ,Mozambique,0,233708,0,2250,0.9627398291885602
2020-08-30,MM,Myanmar,331,775,0,6,0.7741935483870968
2020-09-06,MM,Myanmar,644,1419,2,8,0.5637773079633545
2020-09-13,MM,Myanmar,1513,2932,12,20,0.6821282401091405
2022-07-03,NR,Nauru,1565,3970,1,1,0.025188916876574305
2022-07-10,NR,Nauru,365,4335,0,1,0.02306805074971165
2022-07-17,NR,Nauru,0,4335,0,1,0.02306805074971165
2022-07-24,NR,Nauru,67,4402,0,1,0.022716946842344387
2022-07-31,NR,Nauru,5,4407,0,1,0.02269117313365101
2022-08-07,NR,Nauru,2,4409,0,1,0.022680880018144705
2022-08-14,NR,Nauru,196,4605,0,1,0.02171552660152009
2022-08-21,NR,Nauru,5,4610,0,1,0.021691973969631236
2022-08-28,NR,Nauru,0,4610,0,1,0.021691973969631236
2022-09-04,NR,Nauru,0,4610,0,1,0.021691973969631236
2022-09-11,NR,Nauru,0,4610,0,1,0.021691973969631236
2022-09-18,NR,Nauru,0,4610,0,1,0.021691973969631236
2022-09-25,NR,Nauru,0,4610,0,1,0.021691973969631236
2022-10-02,NR,Nauru,0,4610,0,1,0.021691973969631236
2022-10-09,NR,Nauru,0,4610,0,1,0.021691973969631236
2022-10-16,NR,Nauru,0,4610,0,1,0.021691973969631236
2022-10-23,NR,Nauru,0,4610,0,1,0.021691973969631236
2022-10-30,NR,Nauru,0,4610,0,1,0.021691973969631236
2022-11-06,NR,Nauru,0,4610,0,1,0.021691973969631236
2022-11-13,NR,Nauru,8,4618,0,1,0.021654395842355997
2022-11-20,NR,Nauru,3,4621,0,1,0.02164033758926639
2022-11-27,NR,Nauru,0,4621,0,1,0.02164033758926639
2022-12-04,NR,Nauru,0,4621,0,1,0.02164033758926639
2022-12-11,NR,Nauru,0,4621,0,1,0.02164033758926639
2022-12-18,NR,Nauru,0,4621,0,1,0.02164033758926639
2022-12-25,NR,Nauru,0,4621,0,1,0.02164033758926639
2023-01-01,NR,Nauru,0,4621,0,1,0.02164033758926639
2023-01-08,NR,Nauru,0,4621,0,1,0.02164033758926639
2023-01-15,NR,Nauru,0,4621,0,1,0.02164033758926639
2023-01-22,NR,Nauru,0,4621,0,1,0.02164033758926639
2023-01-29,NR,Nauru,67,4688,0,1,0.021331058020477817
2023-02-05,NR,Nauru,0,4688,0,1,0.021331058020477817
2023-02-12,NR,Nauru,127,4815,0,1,0.020768431983385256
2023-02-19,NR,Nauru,306,5121,0,1,0.019527436047646944
2023-02-26,NR,Nauru,126,5247,0,1,0.01905850962454736
2023-03-05,NR,Nauru,37,5284,0,1,0.018925056775170326
2023-03-12,NR,Nauru,72,5356,0,1,0.018670649738610906
2023-03-19,NR,Nauru,37,5393,0,1,0.018542555164101613
2023-03-26,NR,Nauru,0,5393,0,1,0.018542555164101613
2023-04-02,NR,Nauru,0,5393,0,1,0.018542555164101613
2023-04-09,NR,Nauru,0,5393,0,1,0.018542555164101613
2023-04-16,NR,Nauru,0,5393,0,1,0.018542555164101613
2023-04-23,NR,Nauru,0,5393,0,1,0.018542555164101613
2023-04-30,NR,Nauru,0,5393,0,1,0.018542555164101613
2023-05-07,NR,Nauru,0,5393,0,1,0.018542555164101613
2023-05-14,NR,Nauru,0,5393,0,1,0.018542555164101613
2023-05-21,NR,Nauru,0,5393,0,1,0.018542555164101613
2023-05-28,NR,Nauru,0,5393,0,1,0.018542555164101613
2023-06-04,NR,Nauru,0,5393,0,1,0.018542555164101613
2023-06-11,NR,Nauru,0,5393,0,1,0.018542555164101613
2023-06-18,NR,Nauru,0,5393,0,1,0.018542555164101613
2023-06-25,NR,Nauru,0,5393,0,1,0.018542555164101613
2023-07-02,NR,Nauru,0,5393,0,1,0.018542555164101613
2023-07-09,NR,Nauru,0,5393,0,1,0.018542555164101613
2023-07-16,NR,Nauru,0,5393,0,1,0.018542555164101613
2023-07-23,NR,Nauru,0,5393,0,1,0.018542555164101613
2023-07-30,NR,Nauru,0,5393,0,1,0.018542555164101613
2023-08-06,NR,Nauru,0,5393,0,1,0.018542555164101613
2023-08-13,NR,Nauru,0,5393,0,1,0.018542555164101613
2023-08-20,NR,Nauru,0,5393,0,1,0.018542555164101613
2023-08-27,NR,Nauru,0,5393,0,1,0.018542555164101613
2023-09-03,NR,Nauru,0,5393,0,1,0.018542555164101613
2023-09-10,NR,Nauru,0,5393,0,1,0.018542555164101613
2023-09-17,NR,Nauru,0,5393,0,1,0.018542555164101613
2023-09-24,NR,Nauru,0,5393,0,1,0.018542555164101613
2023-10-01,NR,Nauru,0,5393,0,1,0.018542555164101613
2023-10-08,NR,Nauru,0,5393,0,1,0.018542555164101613
2023-10-15,NR,Nauru,0,5393,0,1,0.018542555164101613
2023-10-22,NR,Nauru,0,5393,0,1,0.018542555164101613
2023-10-29,NR,Nauru,0,5393,0,1,0.018542555164101613
2023-11-05,NR,Nauru,0,5393,0,1,0.018542555164101613
2023-11-12,NR,Nauru,0,5393,0,1,0.018542555164101613
2023-11-19,NR,Nauru,0,5393,0,1,0.018542555164101613
2023-11-26,NR,Nauru,0,5393,0,1,0.018542555164101613
2023-12-03,NR,Nauru,0,5393,0,1,0.018542555164101613
2023-12-10,NR,Nauru,0,5393,0,1,0.018542555164101613
2023-12-17,NR,Nauru,0,5393,0,1,0.018542555164101613
2023-12-24,NR,Nauru,0,5393,0,1,0.018542555164101613
2023-12-31,NR,Nauru,0,5393,0,1,0.018542555164101613
2024-01-07,NR,Nauru,0,5393,0,1,0.018542555164101613
2024-01-14,NR,Nauru,0,5393,0,1,0.018542555164101613
2020-05-17,NP,Nepal,185,295,2,2,0.6779661016949152
2020-05-24,NP,Nepal,308,603,1,3,0.4975124378109453
2020-05-31,NP,Nepal,969,1572,5,8,0.5089058524173028
2020-06-07,NP,Nepal,1876,3448,6,14,0.40603248259860786
2020-06-14,NP,Nepal,2312,5760,6,20,0.3472222222222222
2020-06-21,NP,Nepal,3266,9026,4,24,0.2658985153999557
2020-06-28,NP,Nepal,3746,12772,5,29,0.22705919198246163
2020-07-05,NP,Nepal,3012,15784,7,36,0.2280790674100355
2020-07-12,NP,Nepal,1017,16801,5,41,0.24403309326825784
2020-07-19,NP,Nepal,857,17658,2,43,0.2435156869407634
2020-07-26,NP,Nepal,955,18613,5,48,0.2578842744318487
2020-08-02,NP,Nepal,1719,20332,13,61,0.30001967342120794
2020-08-09,NP,Nepal,2640,22972,19,80,0.34825004353125544
2020-08-16,NP,Nepal,3688,26660,34,114,0.42760690172543137
2020-08-23,NP,Nepal,5275,31935,50,164,0.5135431344919368
2020-08-30,NP,Nepal,6626,38561,80,244,0.6327636731412567
2020-09-06,NP,Nepal,7696,46257,83,327,0.7069200337246254
2020-09-13,NP,Nepal,7902,54159,63,390,0.7201019221182074
2020-09-20,NP,Nepal,9963,64122,82,472,0.7360968154455569
2020-09-27,NP,Nepal,9272,73394,89,561,0.7643676594817015
2020-10-04,NP,Nepal,13429,86823,98,659,0.7590154682515002
2020-10-11,NP,Nepal,20932,107755,157,816,0.7572734443877315
2020-10-18,NP,Nepal,24491,132246,176,992,0.7501172058134083
2020-10-25,NP,Nepal,25843,158089,219,1211,0.7660242015573506
2020-11-01,NP,Nepal,15478,173567,221,1432,0.8250416265764806
2020-11-08,NP,Nepal,20886,194453,230,1662,0.8547052501118523
2020-11-15,NP,Nepal,15323,209776,207,1869,0.8909503470368393
2020-11-22,NP,Nepal,10532,220308,166,2035,0.9237068104653485
2020-11-29,NP,Nepal,11670,231978,216,2251,0.9703506366983077
2021-05-02,NP,Nepal,35911,336030,161,3325,0.9894949855667647
2021-05-09,NP,Nepal,58637,394667,395,3720,0.9425667714807674
2021-07-18,NL,Netherlands (Kingdom of the),69451,1810528,12,17796,0.9829176903091253
2021-07-25,NL,Netherlands (Kingdom of the),38748,1849276,27,17823,0.9637825830216799
2021-08-01,NL,Netherlands (Kingdom of the),22349,1871625,36,17859,0.9541975556000802
2021-08-08,NL,Netherlands (Kingdom of the),17261,1888886,50,17909,0.9481249794852628
2021-08-15,NL,Netherlands (Kingdom of the),16599,1905485,44,17953,0.9421748268813451
2021-08-22,NL,Netherlands (Kingdom of the),16882,1922367,34,17987,0.9356694117200306
2021-08-29,NL,Netherlands (Kingdom of the),17582,1939949,50,18037,0.9297667103619736
2021-09-05,NL,Netherlands (Kingdom of the),17515,1957464,42,18079,0.9235929754008246
2021-09-12,NL,Netherlands (Kingdom of the),16189,1973653,37,18116,0.9178918482630938
2021-09-19,NL,Netherlands (Kingdom of the),13635,1987288,43,18159,0.9137578448619424
2021-09-26,NL,Netherlands (Kingdom of the),11633,1998921,24,18183,0.9096407511852644
2021-10-03,NL,Netherlands (Kingdom of the),11871,2010792,27,18210,0.9056133105761313
2021-10-10,NL,Netherlands (Kingdom of the),17281,2028073,23,18233,0.899030754810108
2021-10-17,NL,Netherlands (Kingdom of the),25310,2053383,49,18282,0.8903356071419701
2021-10-24,NL,Netherlands (Kingdom of the),37779,2091162,82,18364,0.87817204023409
2021-10-31,NL,Netherlands (Kingdom of the),53511,2144673,142,18506,0.8628821270188975
2021-11-07,NL,Netherlands (Kingdom of the),75856,2220529,174,18680,0.8412409835674293
2021-11-14,NL,Netherlands (Kingdom of the),114696,2335225,202,18882,0.8085730497061312
2021-11-21,NL,Netherlands (Kingdom of the),154065,2489290,347,19229,0.7724692583025683
2021-11-28,NL,Netherlands (Kingdom of the),154548,2643838,419,19648,0.743162024299522
2021-12-05,NL,Netherlands (Kingdom of the),144887,2788725,433,20081,0.7200781719244457
2021-12-12,NL,Netherlands (Kingdom of the),116172,2904897,414,20495,0.7055327607140632
2021-12-19,NL,Netherlands (Kingdom of the),95619,3000516,292,20787,0.6927808416952284
2021-12-26,NL,Netherlands (Kingdom of the),84986,3085502,173,20960,0.6793059929956292
2022-01-02,NL,Netherlands (Kingdom of the),109523,3195025,132,21092,0.6601513290193347
2022-01-09,NL,Netherlands (Kingdom of the),201891,3396916,85,21177,0.623418418353589
2022-01-16,NL,Netherlands (Kingdom of the),251885,3648801,59,21236,0.5819994019953404
2022-01-23,NL,Netherlands (Kingdom of the),423932,4072733,63,21299,0.5229657824365113
2022-01-30,NL,Netherlands (Kingdom of the),582545,4655278,53,21352,0.4586621894546362
2022-02-06,NL,Netherlands (Kingdom of the),626302,5281580,72,21424,0.40563619220006136
2022-02-13,NL,Netherlands (Kingdom of the),513691,5795271,90,21514,0.37123371797453475
2022-02-20,NL,Netherlands (Kingdom of the),326724,6121995,95,21609,0.352973172960775
2022-02-27,NL,Netherlands (Kingdom of the),243445,6365440,59,21668,0.3404006635833501
2022-03-06,NL,Netherlands (Kingdom of the),408462,6773902,70,21738,0.32090809698752654
2022-03-13,NL,Netherlands (Kingdom of the),448158,7222060,78,21816,0.3020744773651839
2022-03-20,NL,Netherlands (Kingdom of the),324075,7546135,97,21913,0.2903870656965453
2022-03-27,NL,Netherlands (Kingdom of the),231665,7777800,107,22020,0.28311347681863763
2022-04-03,NL,Netherlands (Kingdom of the),145200,7923000,82,22102,0.2789599899028146
2022-04-10,NL,Netherlands (Kingdom of the),73707,7996707,63,22165,0.2771765928150175
2022-04-17,NL,Netherlands (Kingdom of the),28273,8024980,44,22209,0.27674835326692404
2022-04-24,NL,Netherlands (Kingdom of the),16529,8041509,29,22238,0.2765401369320112
2022-05-01,NL,Netherlands (Kingdom of the),10341,8051850,34,22272,0.27660723933009185
2022-05-08,NL,Netherlands (Kingdom of the),10185,8062035,13,22285,0.27641904308279486
2022-05-15,NL,Netherlands (Kingdom of the),8434,8070469,12,22297,0.27627886309952987
2022-05-22,NL,Netherlands (Kingdom of the),7561,8078030,13,22310,0.27618119764348487
2022-05-29,NL,Netherlands (Kingdom of the),6840,8084870,11,22321,0.2760835981283558
2022-06-05,NL,Netherlands (Kingdom of the),9368,8094238,4,22325,0.2758134860872635
2022-06-12,NL,Netherlands (Kingdom of the),14164,8108402,10,22335,0.2754550156738652
2022-06-19,NL,Netherlands (Kingdom of the),24704,8133106,14,22349,0.27479046750405073
2022-06-26,NL,Netherlands (Kingdom of the),33507,8166613,16,22365,0.2738589425016221
2022-07-03,NL,Netherlands (Kingdom of the),38387,8205000,28,22393,0.27291895185862275
2022-07-10,NL,Netherlands (Kingdom of the),42753,8247753,20,22413,0.27174674120333137
2022-07-17,NL,Netherlands (Kingdom of the),40744,8288497,35,22448,0.2708331800083899
2022-07-24,NL,Netherlands (Kingdom of the),28294,8316791,32,22480,0.2702965602959122
2022-07-31,NL,Netherlands (Kingdom of the),22692,8339483,32,22512,0.2699447915416339
2022-08-07,NL,Netherlands (Kingdom of the),15856,8355339,31,22543,0.2698035352006663
2022-08-14,NL,Netherlands (Kingdom of the),11780,8367119,28,22571,0.26975832422127616
2022-08-21,NL,Netherlands (Kingdom of the),9302,8376421,25,22596,0.2697572149250856
2022-08-28,NL,Netherlands (Kingdom of the),7762,8384183,12,22608,0.2696506028076916
2022-09-04,NL,Netherlands (Kingdom of the),7678,8391861,8,22616,0.2694992207330412
2022-09-11,NL,Netherlands (Kingdom of the),8345,8400206,15,22631,0.26941005970567866
2022-09-18,NL,Netherlands (Kingdom of the),8646,8408852,13,22644,0.26928765068049715
2022-09-25,NL,Netherlands (Kingdom of the),11537,8420389,11,22655,0.2690493277685865
2022-10-02,NL,Netherlands (Kingdom of the),18296,8438685,28,22683,0.2687978043972491
2022-10-09,NL,Netherlands (Kingdom of the),23937,8462622,36,22719,0.26846289483330343
2022-10-16,NL,Netherlands (Kingdom of the),22656,8485278,50,22769,0.2683353450529258
2022-10-23,NL,Netherlands (Kingdom of the),18412,8503690,38,22807,0.26820121617791803
2022-10-30,NL,Netherlands (Kingdom of the),12726,8516416,32,22839,0.26817619054776093
2022-11-06,NL,Netherlands (Kingdom of the),8230,8524646,26,22865,0.26822228160559397
2022-11-13,NL,Netherlands (Kingdom of the),6146,8530792,24,22889,0.2683103749335349
2022-11-20,NL,Netherlands (Kingdom of the),5482,8536274,10,22899,0.26825521298871147
2022-11-27,NL,Netherlands (Kingdom of the),5131,8541405,11,22910,0.2682228509244088
2022-12-04,NL,Netherlands (Kingdom of the),5533,8546938,14,22924,0.2682130138302161
2022-12-11,NL,Netherlands (Kingdom of the),5707,8552645,16,22940,0.2682211175607078
2022-12-18,NL,Netherlands (Kingdom of the),6093,8558738,15,22955,0.2682054293518507
2022-12-25,NL,Netherlands (Kingdom of the),7329,8566067,21,22976,0.2682211101080577
2023-01-01,NL,Netherlands (Kingdom of the),5805,8571872,10,22986,0.26815612738967637
2023-01-08,NL,Netherlands (Kingdom of the),4389,8576261,0,22986,0.2680188954137473
2023-01-15,NL,Netherlands (Kingdom of the),2434,8578695,0,22986,0.26794285144768526
2023-01-22,NL,Netherlands (Kingdom of the),1754,8580449,0,22986,0.2678880790504086
2023-01-29,NL,Netherlands (Kingdom of the),1892,8582341,0,22986,0.26782902240775563
2023-02-05,NL,Netherlands (Kingdom of the),2455,8584796,0,22986,0.26775243115852726
2023-02-12,NL,Netherlands (Kingdom of the),2851,8587647,0,22986,0.2676635404319716
2023-02-19,NL,Netherlands (Kingdom of the),3949,8591596,0,22986,0.2675405128453433
2023-02-26,NL,Netherlands (Kingdom of the),4627,8596223,0,22986,0.26739650658201863
2023-03-05,NL,Netherlands (Kingdom of the),4153,8600376,0,22986,0.2672673845887668
2023-03-12,NL,Netherlands (Kingdom of the),3860,8604236,0,22986,0.2671474840996923
2023-03-19,NL,Netherlands (Kingdom of the),2819,8607055,0,22986,0.2670599874172989
2023-03-26,NL,Netherlands (Kingdom of the),1864,8608919,0,22986,0.2670021636862886
2023-04-02,NL,Netherlands (Kingdom of the),1469,8610388,0,22986,0.26695661101450946
2023-04-09,NL,Netherlands (Kingdom of the),1089,8611477,0,22986,0.2669228519103053
2023-04-16,NL,Netherlands (Kingdom of the),946,8612423,0,22986,0.26689353274914623
2023-04-23,NL,Netherlands (Kingdom of the),836,8613259,0,22986,0.2668676281532925
2023-04-30,NL,Netherlands (Kingdom of the),622,8613881,0,22986,0.26684835790046324
2023-05-07,NL,Netherlands (Kingdom of the),591,8614472,0,22986,0.26683005064036425
2023-05-14,NL,Netherlands (Kingdom of the),446,8614918,0,22986,0.2668162366722469
2023-05-21,NL,Netherlands (Kingdom of the),296,8615214,0,22986,0.26680706944714316
2023-05-28,NL,Netherlands (Kingdom of the),270,8615484,0,22986,0.2667987080006184
2023-06-04,NL,Netherlands (Kingdom of the),286,8615770,0,22986,0.26678985163252966
2023-06-11,NL,Netherlands (Kingdom of the),195,8615965,0,22986,0.266783813536847
2023-06-18,NL,Netherlands (Kingdom of the),164,8616129,0,22986,0.26677873555514314
2023-06-25,NL,Netherlands (Kingdom of the),114,8616243,0,22986,0.2667752058524812
2023-07-02,NL,Netherlands (Kingdom of the),126,8616369,0,22986,0.2667713047108358
2023-07-09,NL,Netherlands (Kingdom of the),74,8616443,0,22986,0.26676901361733607
2023-07-16,NL,Netherlands (Kingdom of the),83,8616526,0,22986,0.2667664439241523
2023-07-23,NL,Netherlands (Kingdom of the),106,8616632,0,22986,0.2667631622192987
2023-07-30,NL,Netherlands (Kingdom of the),88,8616720,0,22986,0.26676043784641956
2023-08-06,NL,Netherlands (Kingdom of the),128,8616848,0,22986,0.2667564752215659
2023-08-13,NL,Netherlands (Kingdom of the),178,8617026,0,22986,0.2667509648920637
2023-08-20,NL,Netherlands (Kingdom of the),200,8617226,0,22986,0.2667447737821893
2023-08-27,NL,Netherlands (Kingdom of the),287,8617513,0,22986,0.2667358900415932
2023-09-03,NL,Netherlands (Kingdom of the),259,8617772,0,22986,0.2667278735153355
2023-09-10,NL,Netherlands (Kingdom of the),354,8618126,0,22986,0.26671691734374736
2023-09-17,NL,Netherlands (Kingdom of the),393,8618519,0,22986,0.26670475519053793
2023-09-24,NL,Netherlands (Kingdom of the),403,8618922,0,22986,0.26669228471959716
2023-10-01,NL,Netherlands (Kingdom of the),345,8619267,0,22986,0.266681609932724
2023-10-08,NL,Netherlands (Kingdom of the),438,8619705,0,22986,0.26666805882567907
2023-10-15,NL,Netherlands (Kingdom of the),346,8620051,0,22986,0.26665735504349103
2023-10-22,NL,Netherlands (Kingdom of the),0,8620051,0,22986,0.26665735504349103
2023-10-29,NL,Netherlands (Kingdom of the),0,8620051,0,22986,0.26665735504349103
2023-11-05,NL,Netherlands (Kingdom of the),920,8620971,0,22986,0.2666288982992751
2023-11-12,NL,Netherlands (Kingdom of the),903,8621874,0,22986,0.26660097329188526
2023-11-19,NL,Netherlands (Kingdom of the),891,8622765,0,22986,0.26657342511363813
2023-11-26,NL,Netherlands (Kingdom of the),917,8623682,0,22986,0.26654507900453656
2023-12-03,NL,Netherlands (Kingdom of the),1078,8624760,0,22986,0.26651176380560154
2023-12-10,NL,Netherlands (Kingdom of the),1556,8626316,0,22986,0.26646369087336935
2023-12-17,NL,Netherlands (Kingdom of the),1793,8628109,0,22986,0.2664083172801827
2023-12-24,NL,Netherlands (Kingdom of the),1572,8629681,0,22986,0.26635978780675673
2023-12-31,NL,Netherlands (Kingdom of the),1182,8630863,0,22986,0.26632330973159923
2024-01-07,NL,Netherlands (Kingdom of the),783,8631646,0,22986,0.2662991508224503
2024-01-14,NL,Netherlands (Kingdom of the),0,8631646,0,22986,0.2662991508224503
2021-09-12,NC,New Caledonia,821,957,1,1,0.10449320794148381
2021-09-19,NC,New Caledonia,2574,3531,21,22,0.6230529595015576
2022-02-13,NC,New Caledonia,9263,35179,0,284,0.8072998095454675
2022-02-20,NC,New Caledonia,8842,44021,3,287,0.6519615637990959
2022-02-27,NC,New Caledonia,9122,53143,12,299,0.5626328961481286
2022-03-06,NC,New Caledonia,3826,56969,3,302,0.5301128684021135
2022-03-13,NC,New Caledonia,2424,59393,3,305,0.5135285302981833
2022-03-20,NC,New Caledonia,618,60011,1,306,0.5099065171385246
2022-03-27,NC,New Caledonia,260,60271,4,310,0.5143435483068142
2022-04-03,NC,New Caledonia,159,60430,1,311,0.5146450438523912
2022-04-10,NC,New Caledonia,68,60498,1,312,0.5157195279182782
2022-04-17,NC,New Caledonia,23,60521,0,312,0.5155235372845789
2022-04-24,NC,New Caledonia,36,60557,0,312,0.5152170682167214
2022-05-01,NC,New Caledonia,96,60653,0,312,0.514401595963926
2022-05-08,NC,New Caledonia,232,60885,0,312,0.5124414880512441
2022-05-15,NC,New Caledonia,300,61185,0,312,0.5099289041431724
2022-05-22,NC,New Caledonia,465,61650,0,312,0.5060827250608272
2022-05-29,NC,New Caledonia,358,62008,1,313,0.50477357760289
2022-06-05,NC,New Caledonia,321,62329,0,313,0.5021739479215133
2022-06-12,NC,New Caledonia,294,62623,0,313,0.4998163614007633
2022-06-19,NC,New Caledonia,379,63002,0,313,0.4968096250912669
2022-06-26,NC,New Caledonia,513,63515,0,313,0.49279697709202547
2022-07-03,NC,New Caledonia,822,64337,0,313,0.4865007693862008
2022-07-10,NC,New Caledonia,1070,65407,0,313,0.478542052073937
2022-07-17,NC,New Caledonia,1365,66772,1,314,0.4702569939495597
2022-07-24,NC,New Caledonia,1363,68135,0,314,0.46084978351801575
2022-07-31,NC,New Caledonia,1661,69796,0,314,0.4498825147572927
2022-08-07,NC,New Caledonia,1222,71018,0,314,0.4421414289335098
2022-08-14,NC,New Caledonia,1344,72362,0,314,0.4339294104640557
2022-08-21,NC,New Caledonia,710,73072,0,314,0.42971315962338513
2022-08-28,NC,New Caledonia,561,73633,0,314,0.42643923240938164
2022-09-04,NC,New Caledonia,469,74102,0,314,0.42374024992577797
2022-09-11,NC,New Caledonia,23,74125,0,314,0.42360876897133226
2022-09-18,NC,New Caledonia,93,74218,0,314,0.4230779595246436
2022-09-25,NC,New Caledonia,39,74257,0,314,0.4228557577063442
2022-10-02,NC,New Caledonia,58,74315,0,314,0.42252573504676044
2022-10-09,NC,New Caledonia,31,74346,0,314,0.42234955478438646
2022-10-16,NC,New Caledonia,1,74347,0,314,0.42234387399626083
2022-10-23,NC,New Caledonia,0,74347,0,314,0.42234387399626083
2022-10-30,NC,New Caledonia,59,74406,0,314,0.4220089777706099
2022-11-06,NC,New Caledonia,44,74450,0,314,0.42175957018132976
2022-11-13,NC,New Caledonia,368,74818,0,314,0.4196851025154375
2022-11-20,NC,New Caledonia,440,75258,0,314,0.41723139068271814
2022-11-27,NC,New Caledonia,0,75258,0,314,0.41723139068271814
2022-12-04,NC,New Caledonia,929,76187,0,314,0.4121438040610603
2022-12-11,NC,New Caledonia,2151,78338,0,314,0.4008271847634609
2022-12-18,NC,New Caledonia,0,78338,0,314,0.4008271847634609
2022-12-25,NC,New Caledonia,824,79162,0,314,0.3966549607134736
2023-01-01,NC,New Caledonia,415,79577,0,314,0.39458637546024605
2023-01-08,NC,New Caledonia,165,79742,0,314,0.3937699079531489
2023-01-15,NC,New Caledonia,118,79860,0,314,0.39318807913849235
2023-01-22,NC,New Caledonia,59,79919,0,314,0.39289780903164456
2023-01-29,NC,New Caledonia,37,79956,0,314,0.39271599379658817
2023-02-05,NC,New Caledonia,25,79981,0,314,0.39259324089471254
2023-02-12,NC,New Caledonia,16,79997,0,314,0.39251471930197385
2023-02-19,NC,New Caledonia,10,80007,0,314,0.39246565925481525
2023-02-26,NC,New Caledonia,0,80007,0,314,0.39246565925481525
2023-03-05,NC,New Caledonia,10,80017,0,314,0.3924166114700626
2023-03-12,NC,New Caledonia,0,80017,0,314,0.3924166114700626
2023-03-19,NC,New Caledonia,15,80032,0,314,0.39234306277489
2023-03-26,NC,New Caledonia,0,80032,0,314,0.39234306277489
2023-04-02,NC,New Caledonia,16,80048,0,314,0.3922646412152709
2023-04-09,NC,New Caledonia,4,80052,0,314,0.39224504072352967
2023-04-16,NC,New Caledonia,1,80053,0,314,0.3922401409066493
2023-04-23,NC,New Caledonia,4,80057,0,314,0.3922205428632099
2023-04-30,NC,New Caledonia,1,80058,0,314,0.3922156436583477
2023-05-07,NC,New Caledonia,0,80058,0,314,0.3922156436583477
2023-05-14,NC,New Caledonia,0,80058,0,314,0.3922156436583477
2023-05-21,NC,New Caledonia,0,80058,0,314,0.3922156436583477
2023-05-28,NC,New Caledonia,0,80058,0,314,0.3922156436583477
2023-06-04,NC,New Caledonia,6,80064,0,314,0.3921862509992006
2023-06-11,NC,New Caledonia,0,80064,0,314,0.3921862509992006
2023-06-18,NC,New Caledonia,0,80064,0,314,0.3921862509992006
2023-06-25,NC,New Caledonia,0,80064,0,314,0.3921862509992006
2023-07-02,NC,New Caledonia,0,80064,0,314,0.3921862509992006
2023-07-09,NC,New Caledonia,0,80064,0,314,0.3921862509992006
2023-07-16,NC,New Caledonia,0,80064,0,314,0.3921862509992006
2023-07-23,NC,New Caledonia,0,80064,0,314,0.3921862509992006
2023-07-30,NC,New Caledonia,0,80064,0,314,0.3921862509992006
2023-08-06,NC,New Caledonia,0,80064,0,314,0.3921862509992006
2023-08-13,NC,New Caledonia,0,80064,0,314,0.3921862509992006
2023-08-20,NC,New Caledonia,0,80064,0,314,0.3921862509992006
2023-08-27,NC,New Caledonia,0,80064,0,314,0.3921862509992006
2023-09-03,NC,New Caledonia,0,80064,0,314,0.3921862509992006
2023-09-10,NC,New Caledonia,0,80064,0,314,0.3921862509992006
2023-09-17,NC,New Caledonia,0,80064,0,314,0.3921862509992006
2023-09-24,NC,New Caledonia,0,80064,0,314,0.3921862509992006
2023-10-01,NC,New Caledonia,0,80064,0,314,0.3921862509992006
2023-10-08,NC,New Caledonia,0,80064,0,314,0.3921862509992006
2023-10-15,NC,New Caledonia,0,80064,0,314,0.3921862509992006
2023-10-22,NC,New Caledonia,0,80064,0,314,0.3921862509992006
2023-10-29,NC,New Caledonia,0,80064,0,314,0.3921862509992006
2023-11-05,NC,New Caledonia,0,80064,0,314,0.3921862509992006
2023-11-12,NC,New Caledonia,0,80064,0,314,0.3921862509992006
2023-11-19,NC,New Caledonia,0,80064,0,314,0.3921862509992006
2023-11-26,NC,New Caledonia,0,80064,0,314,0.3921862509992006
2023-12-03,NC,New Caledonia,0,80064,0,314,0.3921862509992006
2023-12-10,NC,New Caledonia,0,80064,0,314,0.3921862509992006
2023-12-17,NC,New Caledonia,0,80064,0,314,0.3921862509992006
2023-12-24,NC,New Caledonia,0,80064,0,314,0.3921862509992006
2023-12-31,NC,New Caledonia,0,80064,0,314,0.3921862509992006
2024-01-07,NC,New Caledonia,0,80064,0,314,0.3921862509992006
2024-01-14,NC,New Caledonia,0,80064,0,314,0.3921862509992006
2020-03-29,NZ,New Zealand,410,476,1,1,0.21008403361344538
2020-04-05,NZ,New Zealand,396,872,0,1,0.11467889908256881
2020-04-12,NZ,New Zealand,177,1049,3,4,0.3813155386081983
2021-08-22,NZ,New Zealand,128,2698,0,26,0.9636767976278725
2021-08-29,NZ,New Zealand,465,3163,0,26,0.8220044261776794
2021-09-05,NZ,New Zealand,272,3435,1,27,0.7860262008733625
2021-09-12,NZ,New Zealand,158,3593,0,27,0.7514611745059838
2021-09-19,NZ,New Zealand,131,3724,0,27,0.7250268528464017
2021-09-26,NZ,New Zealand,112,3836,0,27,0.7038581856100105
2021-10-03,NZ,New Zealand,188,4024,0,27,0.6709741550695825
2021-10-10,NZ,New Zealand,275,4299,1,28,0.6513142591300303
2021-10-17,NZ,New Zealand,396,4695,0,28,0.5963791267305644
2021-10-24,NZ,New Zealand,687,5382,0,28,0.5202526941657376
2021-10-31,NZ,New Zealand,851,6233,0,28,0.4492218835231831
2021-11-07,NZ,New Zealand,1053,7286,4,32,0.43919846280538016
2021-11-14,NZ,New Zealand,1218,8504,1,33,0.3880526810912512
2021-11-21,NZ,New Zealand,1302,9806,7,40,0.4079135223332654
2021-11-28,NZ,New Zealand,1265,11071,3,43,0.3884021316954205
2021-12-05,NZ,New Zealand,888,11959,1,44,0.36792373944309725
2021-12-12,NZ,New Zealand,657,12616,3,47,0.3725428027901078
2021-12-19,NZ,New Zealand,512,13128,2,49,0.3732480195003047
2021-12-26,NZ,New Zealand,401,13529,1,50,0.36957646537068517
2022-01-02,NZ,New Zealand,403,13932,1,51,0.3660637381567614
2022-01-09,NZ,New Zealand,426,14358,0,51,0.355202674467196
2022-01-16,NZ,New Zealand,392,14750,1,52,0.3525423728813559
2022-01-23,NZ,New Zealand,500,15250,0,52,0.3409836065573771
2022-01-30,NZ,New Zealand,790,16040,0,52,0.3241895261845386
2022-02-06,NZ,New Zealand,1571,17611,1,53,0.30094827096700927
2022-02-13,NZ,New Zealand,3575,21186,0,53,0.25016520343623144
2022-02-20,NZ,New Zealand,11724,32910,0,53,0.16104527499240354
2022-02-27,NZ,New Zealand,65839,98749,3,56,0.056709435032253494
2022-03-06,NZ,New Zealand,140787,239536,9,65,0.02713579587201924
2022-03-13,NZ,New Zealand,137160,376696,37,102,0.02707753732452694
2022-03-20,NZ,New Zealand,119858,496554,61,163,0.03282623843529606
2022-03-27,NZ,New Zealand,112755,609309,68,231,0.037911798447093345
2022-04-03,NZ,New Zealand,92674,701983,132,363,0.05171065396170563
2022-04-10,NZ,New Zealand,71244,773227,106,469,0.06065489177175655
2022-04-17,NZ,New Zealand,55640,828867,95,564,0.0680446923330281
2022-04-24,NZ,New Zealand,58325,887192,80,644,0.07258857158315224
2022-05-01,NZ,New Zealand,52916,940108,69,713,0.07584235002786914
2022-05-08,NZ,New Zealand,52539,992647,99,812,0.08180148632897696
2022-05-15,NZ,New Zealand,58157,1050804,117,929,0.08840849482872162
2022-05-22,NZ,New Zealand,49841,1100645,88,1017,0.09240036524038178
2022-05-29,NZ,New Zealand,48148,1148793,95,1112,0.09679724719771099
2022-06-05,NZ,New Zealand,46082,1194875,82,1194,0.09992677058269694
2022-06-12,NZ,New Zealand,47762,1242637,92,1286,0.10348959511104208
2022-06-19,NZ,New Zealand,28175,1270812,64,1350,0.10623129148922107
2022-06-26,NZ,New Zealand,43542,1314354,87,1437,0.10933127604891833
2022-07-03,NZ,New Zealand,36180,1350534,97,1534,0.11358470057029293
2022-07-10,NZ,New Zealand,70398,1420932,111,1645,0.11576908676840271
2022-07-17,NZ,New Zealand,69674,1490606,158,1803,0.12095751660733955
2022-07-24,NZ,New Zealand,61169,1551775,236,2039,0.13139791529055436
2022-07-31,NZ,New Zealand,51603,1603378,56,2095,0.13066164061125948
2022-08-07,NZ,New Zealand,39002,1642380,0,2095,0.12755878663890208
2022-08-14,NZ,New Zealand,30700,1673080,0,2095,0.1252181605183255
2022-08-21,NZ,New Zealand,26682,1699762,0,2095,0.1232525494745735
2022-08-28,NZ,New Zealand,18411,1718173,0,2095,0.12193184271898115
2022-09-04,NZ,New Zealand,13074,1731247,0,2095,0.12101104001913071
2022-09-11,NZ,New Zealand,10756,1742003,0,2095,0.12026385718049853
2022-09-18,NZ,New Zealand,3178,1745181,0,2095,0.12004485494627778
2022-09-25,NZ,New Zealand,7219,1752400,0,2095,0.11955033097466332
2022-10-02,NZ,New Zealand,19616,1772016,0,2095,0.11822692345893038
2022-10-09,NZ,New Zealand,0,1772016,0,2095,0.11822692345893038
2022-10-16,NZ,New Zealand,25047,1797063,0,2095,0.11657910713202599
2022-10-23,NZ,New Zealand,14489,1811552,0,2095,0.11564669410538589
2022-10-30,NZ,New Zealand,41043,1852595,24,2119,0.11438009926616449
2022-11-06,NZ,New Zealand,0,1852595,0,2119,0.11438009926616449
2022-11-13,NZ,New Zealand,19678,1872273,63,2182,0.11654283322998303
2022-11-20,NZ,New Zealand,21885,1894158,0,2182,0.11519630358185537
2022-11-27,NZ,New Zealand,24759,1918917,30,2212,0.11527335470997443
2022-12-04,NZ,New Zealand,31859,1950776,23,2235,0.1145697917136565
2022-12-11,NZ,New Zealand,37483,1988259,22,2257,0.11351639801454438
2022-12-18,NZ,New Zealand,39722,2027981,31,2288,0.11282156982733074
2022-12-25,NZ,New Zealand,0,2027981,0,2288,0.11282156982733074
2023-01-01,NZ,New Zealand,29469,2057450,43,2331,0.11329558433983815
2023-01-08,NZ,New Zealand,0,2057450,0,2331,0.11329558433983815
2023-01-15,NZ,New Zealand,40236,2097686,0,2331,0.11112244635279064
2023-01-22,NZ,New Zealand,17311,2114997,0,2331,0.11021292228783303
2023-01-29,NZ,New Zealand,12278,2127275,0,2331,0.10957680600768588
2023-02-05,NZ,New Zealand,9387,2136662,146,2477,0.11592849032743599
2023-02-12,NZ,New Zealand,7604,2144266,36,2513,0.11719628068532542
2023-02-19,NZ,New Zealand,7272,2151538,21,2534,0.1177762140385157
2023-02-26,NZ,New Zealand,7100,2158638,8,2542,0.11775943905369961
2023-03-05,NZ,New Zealand,7832,2166470,6,2548,0.11761067543053909
2023-03-12,NZ,New Zealand,10029,2176499,12,2560,0.1176200862026585
2023-03-19,NZ,New Zealand,10133,2186632,26,2586,0.11826407004013478
2023-03-26,NZ,New Zealand,9923,2196555,76,2662,0.12118977216595989
2023-04-02,NZ,New Zealand,9839,2206394,25,2687,0.12178241964037248
2023-04-09,NZ,New Zealand,10653,2217047,0,2687,0.12119725021616592
2023-04-16,NZ,New Zealand,10595,2227642,29,2716,0.12192264286631335
2023-04-23,NZ,New Zealand,12799,2240441,0,2716,0.12122613360494652
2023-04-30,NZ,New Zealand,10999,2251440,20,2736,0.12152222577550367
2023-05-07,NZ,New Zealand,9686,2261126,56,2792,0.12347830240331586
2023-05-14,NZ,New Zealand,11103,2272229,0,2792,0.12287493910164865
2023-05-21,NZ,New Zealand,10632,2282861,101,2893,0.12672694482931723
2023-05-28,NZ,New Zealand,12698,2295559,49,2942,0.12816050469624174
2023-06-04,NZ,New Zealand,11384,2306943,0,2942,0.12752807503262975
2023-06-11,NZ,New Zealand,0,2306943,96,3038,0.13168942622336138
2023-06-18,NZ,New Zealand,19446,2326389,39,3077,0.1322650683097281
2023-06-25,NZ,New Zealand,7524,2333913,0,3077,0.13183867607747163
2023-07-02,NZ,New Zealand,0,2333913,61,3138,0.13445231248979717
2023-07-09,NZ,New Zealand,11979,2345892,21,3159,0.1346609306822309
2023-07-16,NZ,New Zealand,4609,2350501,13,3172,0.13494995322273848
2023-07-23,NZ,New Zealand,3741,2354242,16,3188,0.13541513574220493
2023-07-30,NZ,New Zealand,3114,2357356,31,3219,0.13655128881679304
2023-08-06,NZ,New Zealand,3079,2360435,10,3229,0.13679681923035372
2023-08-13,NZ,New Zealand,3869,2364304,20,3249,0.13741887676034892
2023-08-20,NZ,New Zealand,4527,2368831,0,3249,0.1371562597753913
2023-08-27,NZ,New Zealand,3287,2372118,34,3283,0.13839952312658982
2023-09-03,NZ,New Zealand,2804,2374922,0,3283,0.13823611891253693
2023-09-10,NZ,New Zealand,2899,2377821,11,3294,0.13853019213809617
2023-09-17,NZ,New Zealand,2767,2380588,15,3309,0.13899927244865554
2023-09-24,NZ,New Zealand,2478,2383066,20,3329,0.13969399085044226
2023-10-01,NZ,New Zealand,2372,2385438,18,3347,0.14030966220878516
2023-10-08,NZ,New Zealand,2420,2387858,14,3361,0.1407537634147424
2023-10-15,NZ,New Zealand,2919,2390777,15,3376,0.14120932232491779
2023-10-22,NZ,New Zealand,3200,2393977,40,3416,0.14269142936628046
2023-10-29,NZ,New Zealand,3460,2397437,0,3416,0.14248549596923715
2023-11-05,NZ,New Zealand,3530,2400967,29,3445,0.14348385463023855
2023-11-12,NZ,New Zealand,4508,2405475,19,3464,0.14400482233238757
2023-11-19,NZ,New Zealand,4897,2410372,38,3502,0.1452887770020561
2023-11-26,NZ,New Zealand,6405,2416777,20,3522,0.14573127764787566
2023-12-03,NZ,New Zealand,5615,2422392,27,3549,0.1465080796171718
2023-12-10,NZ,New Zealand,5524,2427916,20,3569,0.146998495829345
2023-12-17,NZ,New Zealand,6136,2434052,27,3596,0.14773718885216913
2023-12-24,NZ,New Zealand,6323,2440375,27,3623,0.14846078983762742
2023-12-31,NZ,New Zealand,0,2440375,0,3623,0.14846078983762742
2024-01-07,NZ,New Zealand,11861,2452236,0,3623,0.14774271318094997
2024-01-14,NZ,New Zealand,5733,2457969,22,3645,0.14829316399027
2020-03-22,MK,North Macedonia,117,136,1,1,0.7352941176470588
2021-08-08,MP,Northern Mariana Islands,10,206,0,2,0.9708737864077669
2021-08-15,MP,Northern Mariana Islands,8,214,0,2,0.9345794392523363
2021-08-22,MP,Northern Mariana Islands,10,224,0,2,0.8928571428571428
2021-08-29,MP,Northern Mariana Islands,17,241,0,2,0.8298755186721992
2021-09-05,MP,Northern Mariana Islands,7,248,0,2,0.8064516129032258
2021-09-12,MP,Northern Mariana Islands,3,251,0,2,0.796812749003984
2021-09-19,MP,Northern Mariana Islands,12,263,0,2,0.7604562737642585
2021-09-26,MP,Northern Mariana Islands,3,266,0,2,0.7518796992481203
2021-10-03,MP,Northern Mariana Islands,6,272,0,2,0.7352941176470588
2021-10-31,MP,Northern Mariana Islands,21,312,0,3,0.9615384615384616
2021-11-07,MP,Northern Mariana Islands,39,351,0,3,0.8547008547008548
2021-11-14,MP,Northern Mariana Islands,38,389,0,3,0.7712082262210797
2021-11-21,MP,Northern Mariana Islands,75,464,0,3,0.646551724137931
2021-11-28,MP,Northern Mariana Islands,323,787,0,3,0.3811944091486658
2021-12-05,MP,Northern Mariana Islands,317,1104,2,5,0.4528985507246377
2021-12-12,MP,Northern Mariana Islands,804,1908,1,6,0.3144654088050315
2021-12-19,MP,Northern Mariana Islands,514,2422,2,8,0.3303055326176713
2021-12-26,MP,Northern Mariana Islands,471,2893,3,11,0.38022813688212925
2022-01-02,MP,Northern Mariana Islands,404,3297,6,17,0.5156202608431908
2022-01-09,MP,Northern Mariana Islands,350,3647,3,20,0.5483959418700302
2022-01-16,MP,Northern Mariana Islands,299,3946,1,21,0.5321844906234161
2022-01-23,MP,Northern Mariana Islands,300,4246,1,22,0.5181347150259068
2022-01-30,MP,Northern Mariana Islands,618,4864,1,23,0.47286184210526316
2022-02-06,MP,Northern Mariana Islands,1238,6102,0,23,0.37692559816453625
2022-02-13,MP,Northern Mariana Islands,1428,7530,0,23,0.3054448871181939
2022-02-20,MP,Northern Mariana Islands,1114,8644,3,26,0.3007866728366497
2022-02-27,MP,Northern Mariana Islands,870,9514,4,30,0.3153247845280639
2022-03-06,MP,Northern Mariana Islands,612,10126,0,30,0.2962670353545329
2022-03-13,MP,Northern Mariana Islands,253,10379,0,30,0.28904518739762985
2022-03-20,MP,Northern Mariana Islands,310,10689,1,31,0.2900177752830012
2022-03-27,MP,Northern Mariana Islands,333,11022,2,33,0.29940119760479045
2022-04-03,MP,Northern Mariana Islands,43,11065,0,33,0.29823768639855397
2022-04-10,MP,Northern Mariana Islands,93,11158,0,33,0.29575192686861446
2022-04-17,MP,Northern Mariana Islands,44,11202,1,34,0.3035172290662382
2022-04-24,MP,Northern Mariana Islands,19,11221,0,34,0.30300329738882453
2022-05-01,MP,Northern Mariana Islands,42,11263,0,34,0.3018733907484684
2022-05-08,MP,Northern Mariana Islands,18,11281,0,34,0.3013917205921461
2022-05-15,MP,Northern Mariana Islands,24,11305,0,34,0.30075187969924816
2022-05-22,MP,Northern Mariana Islands,10,11315,0,34,0.30048608042421565
2022-05-29,MP,Northern Mariana Islands,18,11333,0,34,0.300008823788935
2022-06-05,MP,Northern Mariana Islands,33,11366,0,34,0.2991377793418969
2022-06-12,MP,Northern Mariana Islands,39,11405,0,34,0.2981148619026742
2022-06-19,MP,Northern Mariana Islands,77,11482,0,34,0.29611565929280614
2022-06-26,MP,Northern Mariana Islands,87,11569,0,34,0.29388884086783645
2022-07-03,MP,Northern Mariana Islands,190,11759,1,35,0.297644357513394
2022-07-10,MP,Northern Mariana Islands,0,11759,0,35,0.297644357513394
2022-07-17,MP,Northern Mariana Islands,434,12193,0,35,0.2870499466907242
2022-07-24,MP,Northern Mariana Islands,380,12573,2,37,0.29428139664360137
2022-07-31,MP,Northern Mariana Islands,159,12732,1,38,0.2984605717876217
2022-08-07,MP,Northern Mariana Islands,1,12733,0,38,0.2984371318620906
2022-08-14,MP,Northern Mariana Islands,215,12948,1,39,0.30120481927710846
2022-08-21,MP,Northern Mariana Islands,0,12948,1,40,0.3089280197713933
2022-08-28,MP,Northern Mariana Islands,175,13123,0,40,0.3048083517488379
2022-09-04,MP,Northern Mariana Islands,24,13147,0,40,0.30425192059024875
2022-09-11,MP,Northern Mariana Islands,7,13154,0,40,0.3040900106431504
2022-09-18,MP,Northern Mariana Islands,1,13155,0,40,0.3040668947168377
2022-09-25,MP,Northern Mariana Islands,16,13171,0,40,0.3036975172727963
2022-10-02,MP,Northern Mariana Islands,0,13171,0,40,0.3036975172727963
2022-10-09,MP,Northern Mariana Islands,0,13171,0,40,0.3036975172727963
2022-10-16,MP,Northern Mariana Islands,0,13171,0,40,0.3036975172727963
2022-10-23,MP,Northern Mariana Islands,0,13171,0,40,0.3036975172727963
2022-10-30,MP,Northern Mariana Islands,0,13171,0,40,0.3036975172727963
2022-11-06,MP,Northern Mariana Islands,0,13171,0,40,0.3036975172727963
2022-11-13,MP,Northern Mariana Islands,0,13171,0,40,0.3036975172727963
2022-11-20,MP,Northern Mariana Islands,0,13171,0,40,0.3036975172727963
2022-11-27,MP,Northern Mariana Islands,0,13171,0,40,0.3036975172727963
2022-12-04,MP,Northern Mariana Islands,0,13171,0,40,0.3036975172727963
2022-12-11,MP,Northern Mariana Islands,0,13171,1,41,0.3112899552046162
2022-12-18,MP,Northern Mariana Islands,65,13236,0,41,0.309761257177395
2022-12-25,MP,Northern Mariana Islands,0,13236,0,41,0.309761257177395
2023-01-01,MP,Northern Mariana Islands,159,13395,0,41,0.3060843598357596
2023-01-08,MP,Northern Mariana Islands,0,13395,0,41,0.3060843598357596
2023-01-15,MP,Northern Mariana Islands,0,13395,0,41,0.3060843598357596
2023-01-22,MP,Northern Mariana Islands,0,13395,0,41,0.3060843598357596
2023-01-29,MP,Northern Mariana Islands,0,13395,0,41,0.3060843598357596
2023-02-05,MP,Northern Mariana Islands,0,13395,0,41,0.3060843598357596
2023-02-12,MP,Northern Mariana Islands,0,13395,0,41,0.3060843598357596
2023-02-19,MP,Northern Mariana Islands,0,13395,0,41,0.3060843598357596
2023-02-26,MP,Northern Mariana Islands,254,13649,0,41,0.3003883068356656
2023-03-05,MP,Northern Mariana Islands,0,13649,0,41,0.3003883068356656
2023-03-12,MP,Northern Mariana Islands,73,13722,0,41,0.2987902638099402
2023-03-19,MP,Northern Mariana Islands,26,13748,0,41,0.2982251963922025
2023-03-26,MP,Northern Mariana Islands,25,13773,0,41,0.2976838742467146
2023-04-02,MP,Northern Mariana Islands,13,13786,0,41,0.2974031626287538
2023-04-09,MP,Northern Mariana Islands,0,13786,0,41,0.2974031626287538
2023-04-16,MP,Northern Mariana Islands,28,13814,0,41,0.29680034747357753
2023-04-23,MP,Northern Mariana Islands,25,13839,0,41,0.29626418093792906
2023-04-30,MP,Northern Mariana Islands,10,13849,0,41,0.2960502563361975
2023-05-07,MP,Northern Mariana Islands,23,13872,0,41,0.2955594002306805
2023-05-14,MP,Northern Mariana Islands,24,13896,0,41,0.295048934945308
2023-05-21,MP,Northern Mariana Islands,21,13917,0,41,0.29460372206653734
2023-05-28,MP,Northern Mariana Islands,18,13935,0,41,0.2942231790455687
2023-06-04,MP,Northern Mariana Islands,13,13948,0,41,0.2939489532549469
2023-06-11,MP,Northern Mariana Islands,24,13972,0,41,0.2934440309189808
2023-06-18,MP,Northern Mariana Islands,28,14000,0,41,0.2928571428571428
2023-06-25,MP,Northern Mariana Islands,0,14000,0,41,0.2928571428571428
2023-07-02,MP,Northern Mariana Islands,13,14013,0,41,0.2925854563619496
2023-07-09,MP,Northern Mariana Islands,50,14063,0,41,0.2915451895043732
2023-07-16,MP,Northern Mariana Islands,15,14078,0,41,0.29123455036226736
2023-07-23,MP,Northern Mariana Islands,18,14096,0,41,0.2908626560726447
2023-07-30,MP,Northern Mariana Islands,0,14096,0,41,0.2908626560726447
2023-08-06,MP,Northern Mariana Islands,53,14149,0,41,0.28977312884302775
2023-08-13,MP,Northern Mariana Islands,3,14152,0,41,0.289711701526286
2023-08-20,MP,Northern Mariana Islands,15,14167,0,41,0.28940495517752524
2023-08-27,MP,Northern Mariana Islands,0,14167,0,41,0.28940495517752524
2023-09-03,MP,Northern Mariana Islands,31,14198,0,41,0.2887730666291027
2023-09-10,MP,Northern Mariana Islands,40,14238,0,41,0.28796179238657116
2023-09-17,MP,Northern Mariana Islands,36,14274,0,41,0.2872355331371725
2023-09-24,MP,Northern Mariana Islands,2,14276,0,41,0.2871952927991034
2023-10-01,MP,Northern Mariana Islands,23,14299,0,41,0.28673333799566403
2023-10-08,MP,Northern Mariana Islands,0,14299,0,41,0.28673333799566403
2023-10-15,MP,Northern Mariana Islands,7,14306,0,41,0.2865930378862016
2023-10-22,MP,Northern Mariana Islands,3,14309,0,41,0.28653295128939826
2023-10-29,MP,Northern Mariana Islands,9,14318,0,41,0.28635284257577875
2023-11-05,MP,Northern Mariana Islands,4,14322,0,41,0.2862728669180282
2023-11-12,MP,Northern Mariana Islands,0,14322,0,41,0.2862728669180282
2023-11-19,MP,Northern Mariana Islands,8,14330,0,41,0.2861130495464061
2023-11-26,MP,Northern Mariana Islands,4,14334,0,41,0.28603320775777874
2023-12-03,MP,Northern Mariana Islands,0,14334,0,41,0.28603320775777874
2023-12-10,MP,Northern Mariana Islands,0,14334,0,41,0.28603320775777874
2023-12-17,MP,Northern Mariana Islands,3,14337,0,41,0.285973355653205
2023-12-24,MP,Northern Mariana Islands,0,14337,0,41,0.285973355653205
2023-12-31,MP,Northern Mariana Islands,4,14341,0,41,0.28589359179973506
2024-01-07,MP,Northern Mariana Islands,0,14341,0,41,0.28589359179973506
2024-01-14,MP,Northern Mariana Islands,0,14341,0,41,0.28589359179973506
2020-03-15,NO,Norway,1181,1364,1,1,0.07331378299120235
2020-03-22,NO,Norway,1390,2754,6,7,0.2541757443718228
2020-03-29,NO,Norway,1775,4529,13,20,0.44159858688452197
2020-04-05,NO,Norway,1226,5755,30,50,0.8688097306689836
2020-11-22,NO,Norway,3785,33022,12,306,0.9266549573011932
2020-11-29,NO,Norway,2977,35999,22,328,0.9111364204561238
2020-12-06,NO,Norway,2492,38491,26,354,0.9196955132368605
2020-12-13,NO,Norway,2701,41192,33,387,0.9395028160807924
2020-12-20,NO,Norway,2934,44126,17,404,0.9155599873090695
2020-12-27,NO,Norway,3118,47244,17,421,0.8911184489035644
2021-01-03,NO,Norway,3847,51091,15,436,0.8533792644497074
2021-01-10,NO,Norway,4694,55785,42,478,0.8568611633951778
2021-01-17,NO,Norway,3218,59003,39,517,0.8762266325441079
2021-01-24,NO,Norway,2259,61262,27,544,0.887989291893833
2021-01-31,NO,Norway,1951,63213,19,563,0.8906395836299495
2021-02-07,NO,Norway,1860,65073,19,582,0.8943801576690793
2021-02-14,NO,Norway,1742,66815,10,592,0.8860285863952705
2021-02-21,NO,Norway,1973,68788,15,607,0.8824213525614932
2021-02-28,NO,Norway,2940,71728,15,622,0.8671648449698862
2021-03-07,NO,Norway,4010,75738,10,632,0.8344556233330693
2021-03-14,NO,Norway,5539,81277,7,639,0.7862002780614443
2021-03-21,NO,Norway,6625,87902,9,648,0.7371845919319242
2021-03-28,NO,Norway,6092,93994,8,656,0.6979168883120199
2021-04-04,NO,Norway,4933,98927,17,673,0.6802996148675287
2021-04-11,NO,Norway,5082,104009,11,684,0.6576353969368035
2021-04-18,NO,Norway,3789,107798,24,708,0.6567839848605725
2021-04-25,NO,Norway,3251,111049,28,736,0.6627704887031851
2021-05-02,NO,Norway,2825,113874,20,756,0.6638916697402392
2021-05-09,NO,Norway,3064,116938,11,767,0.6559031281533804
2021-05-16,NO,Norway,2636,119574,7,774,0.6472979075718802
2021-05-23,NO,Norway,3169,122743,7,781,0.636288831134973
2021-05-30,NO,Norway,2442,125185,2,783,0.6254742980389024
2021-06-06,NO,Norway,1898,127083,1,784,0.6169196509367894
2021-06-13,NO,Norway,1260,128343,5,789,0.6147588882915312
2021-06-20,NO,Norway,1250,129593,1,790,0.6096008272051731
2021-06-27,NO,Norway,1280,130873,2,792,0.6051668411360632
2021-07-04,NO,Norway,1288,132161,3,795,0.6015390319383177
2021-07-11,NO,Norway,1200,133361,3,798,0.5983758370138197
2021-07-18,NO,Norway,1141,134502,2,800,0.5947866946216412
2021-07-25,NO,Norway,1448,135950,3,803,0.590658330268481
2021-08-01,NO,Norway,2236,138186,10,813,0.5883374582085016
2021-08-08,NO,Norway,2912,141098,10,823,0.5832825412124906
2021-08-15,NO,Norway,3706,144804,5,828,0.5718074086351206
2021-08-22,NO,Norway,4330,149134,4,832,0.5578875373824882
2021-08-29,NO,Norway,8312,157446,10,842,0.5347865299848837
2021-09-05,NO,Norway,10109,167555,11,853,0.5090865685894185
2021-09-12,NO,Norway,8732,176287,21,874,0.49578244567097973
2021-09-19,NO,Norway,6028,182315,11,885,0.48542358006746567
2021-09-26,NO,Norway,4710,187025,12,897,0.4796150247293142
2021-10-03,NO,Norway,3614,190639,7,904,0.4741946820954789
2021-10-10,NO,Norway,3024,193663,8,912,0.4709211362005133
2021-10-17,NO,Norway,2817,196480,6,918,0.4672231270358306
2021-10-24,NO,Norway,4160,200640,11,929,0.463018341307815
2021-10-31,NO,Norway,6821,207461,20,949,0.45743537339548157
2021-11-07,NO,Norway,9569,217030,39,988,0.4552366032345758
2021-11-14,NO,Norway,11720,228750,47,1035,0.4524590163934426
2021-11-21,NO,Norway,14431,243181,53,1088,0.4474033744412598
2021-11-28,NO,Norway,17970,261151,56,1144,0.4380607388062845
2021-12-05,NO,Norway,25554,286705,53,1197,0.41750231073751765
2021-12-12,NO,Norway,33849,320554,74,1271,0.39650105754412673
2021-12-19,NO,Norway,31740,352294,43,1314,0.372983928196336
2021-12-26,NO,Norway,22996,375290,21,1335,0.3557249060726372
2022-01-02,NO,Norway,25064,400354,59,1394,0.3481918502125619
2022-01-09,NO,Norway,45479,445833,49,1443,0.3236637933934904
2022-01-16,NO,Norway,69632,515465,31,1474,0.28595539949366106
2022-01-23,NO,Norway,115307,630772,29,1503,0.23827944170001203
2022-01-30,NO,Norway,136796,767568,29,1532,0.19959143684989472
2022-02-06,NO,Norway,129168,896736,33,1565,0.17452182136102487
2022-02-13,NO,Norway,141784,1038520,54,1619,0.1558949273966799
2022-02-20,NO,Norway,101190,1139710,61,1680,0.14740591904958278
2022-02-27,NO,Norway,102327,1242037,86,1766,0.14218578029478993
2022-03-06,NO,Norway,68214,1310251,114,1880,0.14348395841712772
2022-03-13,NO,Norway,43203,1353454,156,2036,0.15042993703517077
2022-03-20,NO,Norway,27649,1381103,189,2225,0.1611031183047173
2022-03-27,NO,Norway,18009,1399112,203,2428,0.17353864451166168
2022-04-03,NO,Norway,10821,1409933,172,2600,0.1844059256716454
2022-04-10,NO,Norway,7074,1417007,130,2730,0.19265959871757868
2022-04-17,NO,Norway,3757,1420764,125,2855,0.20094822222409917
2022-04-24,NO,Norway,3862,1424626,81,2936,0.20608917708928517
2022-05-01,NO,Norway,2306,1426932,64,3000,0.21024127288476255
2022-05-08,NO,Norway,1880,1428812,72,3072,0.215003793361198
2022-05-15,NO,Norway,1799,1430611,46,3118,0.21794883444905708
2022-05-22,NO,Norway,1545,1432156,26,3144,0.21952915743815615
2022-05-29,NO,Norway,1579,1433735,38,3182,0.22193780580093253
2022-06-05,NO,Norway,1875,1435610,36,3218,0.2241555854305835
2022-06-12,NO,Norway,2060,1437670,39,3257,0.22654712138390593
2022-06-19,NO,Norway,3023,1440693,33,3290,0.22836232285434857
2022-06-26,NO,Norway,4554,1445247,40,3330,0.2304104419521369
2022-07-03,NO,Norway,3907,1449154,68,3398,0.23448163549215614
2022-07-10,NO,Norway,2378,1451532,72,3470,0.23905776793071046
2022-07-17,NO,Norway,1990,1453522,96,3566,0.2453351239265728
2022-07-24,NO,Norway,1644,1455166,103,3669,0.25213618240118313
2022-07-31,NO,Norway,1325,1456491,91,3760,0.258154701951471
2022-08-07,NO,Norway,1149,1457640,75,3835,0.26309651217035757
2022-08-14,NO,Norway,1121,1458761,66,3901,0.2674187204072497
2022-08-21,NO,Norway,865,1459626,57,3958,0.2711653533165345
2022-08-28,NO,Norway,743,1460369,56,4014,0.27486203829306155
2022-09-04,NO,Norway,672,1461041,33,4047,0.2769942801057602
2022-09-11,NO,Norway,547,1461588,25,4072,0.2786010832053903
2022-09-18,NO,Norway,511,1462099,40,4112,0.2812395056695887
2022-09-25,NO,Norway,457,1462556,24,4136,0.2827925905059362
2022-10-02,NO,Norway,500,1463056,28,4164,0.284609748362332
2022-10-09,NO,Norway,504,1463560,24,4188,0.28615157561015603
2022-10-16,NO,Norway,500,1464060,31,4219,0.2881712498121662
2022-10-23,NO,Norway,534,1464594,29,4248,0.2900462517257342
2022-10-30,NO,Norway,785,1465379,25,4273,0.2915969179304467
2022-11-06,NO,Norway,891,1466270,23,4296,0.2929883309349574
2022-11-13,NO,Norway,912,1467182,52,4348,0.2963504186937953
2022-11-20,NO,Norway,917,1468099,46,4394,0.2992986167826556
2022-11-27,NO,Norway,1007,1469106,50,4444,0.30249689266805796
2022-12-04,NO,Norway,1082,1470188,56,4500,0.30608330363191644
2022-12-11,NO,Norway,1295,1471483,70,4570,0.3105710361587596
2022-12-18,NO,Norway,1477,1472960,80,4650,0.31569085379100587
2022-12-25,NO,Norway,1564,1474524,95,4745,0.3217987635331809
2023-01-01,NO,Norway,1261,1475785,91,4836,0.3276900090460331
2023-01-08,NO,Norway,1068,1476853,97,4933,0.3340210569366078
2023-01-15,NO,Norway,660,1477513,111,5044,0.34138447512813763
2023-01-22,NO,Norway,428,1477941,71,5115,0.34608959356293656
2023-01-29,NO,Norway,343,1478284,47,5162,0.3491886538716512
2023-02-05,NO,Norway,300,1478584,27,5189,0.35094387603274485
2023-02-12,NO,Norway,288,1478872,14,5203,0.35182219962241496
2023-02-19,NO,Norway,296,1479168,17,5220,0.35290109034267914
2023-02-26,NO,Norway,286,1479454,18,5238,0.35404953449042686
2023-03-05,NO,Norway,348,1479802,10,5248,0.35464203994858773
2023-03-12,NO,Norway,358,1480160,17,5265,0.35570478867149496
2023-03-19,NO,Norway,439,1480599,19,5284,0.35688258603443607
2023-03-26,NO,Norway,531,1481130,21,5305,0.35817247642003064
2023-04-02,NO,Norway,643,1481773,18,5323,0.3592318121601622
2023-04-09,NO,Norway,504,1482277,25,5348,0.36079626142751997
2023-04-16,NO,Norway,557,1482834,31,5379,0.3627513261767669
2023-04-23,NO,Norway,477,1483311,28,5407,0.36452234224650126
2023-04-30,NO,Norway,423,1483734,39,5446,0.3670469235051566
2023-05-07,NO,Norway,398,1484132,32,5478,0.3691046348977045
2023-05-14,NO,Norway,339,1484471,21,5499,0.370434989972859
2023-05-21,NO,Norway,255,1484726,16,5515,0.371449008099811
2023-05-28,NO,Norway,240,1484966,17,5532,0.3725337819182392
2023-06-04,NO,Norway,173,1485139,13,5545,0.3733657253630805
2023-06-11,NO,Norway,196,1485335,14,5559,0.3742590055442038
2023-06-18,NO,Norway,159,1485494,7,5566,0.3746901704079586
2023-06-25,NO,Norway,21,1485515,0,5566,0.37468487359602565
2023-07-02,NO,Norway,184,1485699,6,5572,0.37504232014694766
2023-07-09,NO,Norway,184,1485883,20,5592,0.37634187886933224
2023-07-16,NO,Norway,92,1485975,8,5600,0.3768569457763421
2023-07-23,NO,Norway,73,1486048,6,5606,0.3772421886776201
2023-07-30,NO,Norway,119,1486167,5,5611,0.37754841817911444
2023-08-06,NO,Norway,134,1486301,2,5613,0.3776489419034233
2023-08-13,NO,Norway,182,1486483,7,5620,0.3780736140272038
2023-08-20,NO,Norway,212,1486695,1,5621,0.37808696471031383
2023-08-27,NO,Norway,263,1486958,5,5626,0.37835634900246007
2023-09-03,NO,Norway,428,1487386,5,5631,0.3785836359895817
2023-09-10,NO,Norway,459,1487845,10,5641,0.3791389560068421
2023-09-17,NO,Norway,409,1488254,12,5653,0.3798410755153354
2023-09-24,NO,Norway,438,1488692,19,5672,0.3810056076072149
2023-10-01,NO,Norway,384,1489076,33,5705,0.383123494032541
2023-10-08,NO,Norway,383,1489459,27,5732,0.38483771624462304
2023-10-15,NO,Norway,0,1489459,0,5732,0.38483771624462304
2023-10-22,NO,Norway,0,1489459,0,5732,0.38483771624462304
2023-10-29,NO,Norway,0,1489459,0,5732,0.38483771624462304
2023-11-05,NO,Norway,1177,1490636,0,5732,0.3845338499808136
2023-11-12,NO,Norway,1422,1492058,0,5732,0.3841673715096866
2023-11-19,NO,Norway,1608,1493666,0,5732,0.383753797703101
2023-11-26,NO,Norway,1798,1495464,0,5732,0.38329240957990296
2023-12-03,NO,Norway,1848,1497312,0,5732,0.3828193456006497
2023-12-10,NO,Norway,1948,1499260,0,5732,0.38232194549310994
2023-12-17,NO,Norway,2041,1501301,0,5732,0.38180218357278123
2023-12-24,NO,Norway,1567,1502868,0,5732,0.3814040887157089
2023-12-31,NO,Norway,1007,1503875,0,5732,0.38114869919374944
2024-01-07,NO,Norway,855,1504730,0,5732,0.38093212735839654
2024-01-14,NO,Norway,0,1504730,0,5732,0.38093212735839654
2020-04-05,PS,"occupied Palestinian territory, including east Jerusalem",120,217,0,1,0.4608294930875576
2020-04-12,PS,"occupied Palestinian territory, including east Jerusalem",51,268,1,2,0.7462686567164178
2020-04-19,PS,"occupied Palestinian territory, including east Jerusalem",45,313,0,2,0.6389776357827476
2020-04-26,PS,"occupied Palestinian territory, including east Jerusalem",29,342,0,2,0.5847953216374269
2020-05-03,PS,"occupied Palestinian territory, including east Jerusalem",11,353,0,2,0.56657223796034
2020-05-10,PS,"occupied Palestinian territory, including east Jerusalem",194,547,2,4,0.7312614259597806
2020-05-17,PS,"occupied Palestinian territory, including east Jerusalem",8,555,0,4,0.7207207207207207
2020-05-24,PS,"occupied Palestinian territory, including east Jerusalem",47,602,1,5,0.8305647840531563
2020-05-31,PS,"occupied Palestinian territory, including east Jerusalem",24,626,0,5,0.7987220447284344
2020-06-07,PS,"occupied Palestinian territory, including east Jerusalem",17,643,0,5,0.7776049766718507
2020-06-14,PS,"occupied Palestinian territory, including east Jerusalem",30,673,0,5,0.7429420505200593
2020-06-21,PS,"occupied Palestinian territory, including east Jerusalem",306,979,0,5,0.5107252298263534
2020-06-28,PS,"occupied Palestinian territory, including east Jerusalem",1074,2053,2,7,0.34096444227959083
2020-07-05,PS,"occupied Palestinian territory, including east Jerusalem",2197,4250,12,19,0.4470588235294118
2020-07-12,PS,"occupied Palestinian territory, including east Jerusalem",2438,6688,13,32,0.4784688995215311
2020-07-19,PS,"occupied Palestinian territory, including east Jerusalem",2899,9587,30,62,0.6467090852195682
2020-07-26,PS,"occupied Palestinian territory, including east Jerusalem",3208,12795,16,78,0.6096131301289567
2020-08-02,PS,"occupied Palestinian territory, including east Jerusalem",2760,15555,8,86,0.5528768884603021
2020-08-09,PS,"occupied Palestinian territory, including east Jerusalem",2819,18374,17,103,0.5605747251551105
2020-08-16,PS,"occupied Palestinian territory, including east Jerusalem",3180,21554,16,119,0.5521016980606848
2020-08-23,PS,"occupied Palestinian territory, including east Jerusalem",3144,24698,19,138,0.5587496963316868
2020-08-30,PS,"occupied Palestinian territory, including east Jerusalem",3829,28527,26,164,0.5748939601079679
2020-09-06,PS,"occupied Palestinian territory, including east Jerusalem",4723,33250,35,199,0.5984962406015037
2020-09-13,PS,"occupied Palestinian territory, including east Jerusalem",5266,38516,39,238,0.6179250181742652
2020-09-20,PS,"occupied Palestinian territory, including east Jerusalem",6247,44763,53,291,0.6500904765096173
2020-09-27,PS,"occupied Palestinian territory, including east Jerusalem",3809,48572,43,334,0.6876389689533065
2020-10-04,PS,"occupied Palestinian territory, including east Jerusalem",3441,52013,56,390,0.7498125468632842
2020-10-11,PS,"occupied Palestinian territory, including east Jerusalem",3121,55134,52,442,0.8016831719084412
2020-10-18,PS,"occupied Palestinian territory, including east Jerusalem",3016,58150,30,472,0.8116938950988821
2020-10-25,PS,"occupied Palestinian territory, including east Jerusalem",3443,61593,42,514,0.8345104151445782
2020-11-01,PS,"occupied Palestinian territory, including east Jerusalem",3669,65262,41,555,0.8504183138733107
2020-11-08,PS,"occupied Palestinian territory, including east Jerusalem",4350,69612,29,584,0.8389358156639659
2020-11-15,PS,"occupied Palestinian territory, including east Jerusalem",4738,74350,49,633,0.85137861466039
2020-11-22,PS,"occupied Palestinian territory, including east Jerusalem",8430,82780,65,698,0.8431988402995894
2020-11-29,PS,"occupied Palestinian territory, including east Jerusalem",12081,94861,93,791,0.833851635550964
2020-12-06,PS,"occupied Palestinian territory, including east Jerusalem",14841,109702,114,905,0.824962170243022
2020-12-13,PS,"occupied Palestinian territory, including east Jerusalem",13300,123002,157,1062,0.8634005951122746
2020-12-20,PS,"occupied Palestinian territory, including east Jerusalem",14104,137106,170,1232,0.8985748253176374
2020-12-27,PS,"occupied Palestinian territory, including east Jerusalem",11434,148540,174,1406,0.9465463848121717
2022-01-30,PS,"occupied Palestinian territory, including east Jerusalem",33080,516059,38,5087,0.9857400025966023
2022-02-06,PS,"occupied Palestinian territory, including east Jerusalem",58046,574105,65,5152,0.897396817655307
2022-02-13,PS,"occupied Palestinian territory, including east Jerusalem",37153,611258,113,5265,0.8613384201106571
2022-02-20,PS,"occupied Palestinian territory, including east Jerusalem",20498,631756,126,5391,0.8533357815359095
2022-02-27,PS,"occupied Palestinian territory, including east Jerusalem",12881,644637,105,5496,0.8525728433211249
2022-03-06,PS,"occupied Palestinian territory, including east Jerusalem",6488,651125,81,5577,0.8565175657515838
2022-03-13,PS,"occupied Palestinian territory, including east Jerusalem",2537,653662,35,5612,0.8585476897846287
2022-03-20,PS,"occupied Palestinian territory, including east Jerusalem",1292,654954,29,5641,0.8612818610161934
2022-03-27,PS,"occupied Palestinian territory, including east Jerusalem",796,655750,14,5655,0.8623713305375523
2022-04-03,PS,"occupied Palestinian territory, including east Jerusalem",537,656287,0,5655,0.86166570418125
2022-04-10,PS,"occupied Palestinian territory, including east Jerusalem",330,656617,1,5656,0.8613849473894218
2022-04-17,PS,"occupied Palestinian territory, including east Jerusalem",259,656876,1,5657,0.8611975471778539
2022-04-24,PS,"occupied Palestinian territory, including east Jerusalem",184,657060,0,5657,0.8609563814567924
2022-05-01,PS,"occupied Palestinian territory, including east Jerusalem",0,657060,0,5657,0.8609563814567924
2022-05-08,PS,"occupied Palestinian territory, including east Jerusalem",133,657193,0,5657,0.8607821446667875
2022-05-15,PS,"occupied Palestinian territory, including east Jerusalem",263,657456,2,5659,0.8607420116327177
2022-05-22,PS,"occupied Palestinian territory, including east Jerusalem",117,657573,1,5660,0.8607409367477071
2022-05-29,PS,"occupied Palestinian territory, including east Jerusalem",132,657705,0,5660,0.8605681878653803
2022-06-05,PS,"occupied Palestinian territory, including east Jerusalem",174,657879,0,5660,0.8603405793466581
2022-06-12,PS,"occupied Palestinian territory, including east Jerusalem",221,658100,0,5660,0.8600516638808693
2022-06-19,PS,"occupied Palestinian territory, including east Jerusalem",403,658503,0,5660,0.8595253172726623
2022-06-26,PS,"occupied Palestinian territory, including east Jerusalem",1350,659853,0,5660,0.8577668056370131
2022-07-03,PS,"occupied Palestinian territory, including east Jerusalem",2637,662490,2,5662,0.854654409877885
2022-07-10,PS,"occupied Palestinian territory, including east Jerusalem",2595,665085,1,5663,0.8514701128427193
2022-07-17,PS,"occupied Palestinian territory, including east Jerusalem",6954,672039,1,5664,0.8428082298795159
2022-07-24,PS,"occupied Palestinian territory, including east Jerusalem",10057,682096,14,5678,0.8324341441673899
2022-07-31,PS,"occupied Palestinian territory, including east Jerusalem",8969,691065,10,5688,0.8230774239760369
2022-08-07,PS,"occupied Palestinian territory, including east Jerusalem",6382,697447,3,5691,0.815975980970597
2022-08-14,PS,"occupied Palestinian territory, including east Jerusalem",937,698384,3,5694,0.8153107745881922
2022-08-21,PS,"occupied Palestinian territory, including east Jerusalem",0,698384,0,5694,0.8153107745881922
2022-08-28,PS,"occupied Palestinian territory, including east Jerusalem",3355,701739,6,5700,0.8122678089717117
2022-09-04,PS,"occupied Palestinian territory, including east Jerusalem",852,702591,6,5706,0.8121367908214026
2022-09-11,PS,"occupied Palestinian territory, including east Jerusalem",177,702768,1,5707,0.8120745395350956
2022-09-18,PS,"occupied Palestinian territory, including east Jerusalem",0,702768,0,5707,0.8120745395350956
2022-09-25,PS,"occupied Palestinian territory, including east Jerusalem",102,702870,1,5708,0.8120989656693272
2022-10-02,PS,"occupied Palestinian territory, including east Jerusalem",70,702940,0,5708,0.8120180954277748
2022-10-09,PS,"occupied Palestinian territory, including east Jerusalem",37,702977,0,5708,0.8119753562349835
2022-10-16,PS,"occupied Palestinian territory, including east Jerusalem",37,703014,0,5708,0.811932621540965
2022-10-23,PS,"occupied Palestinian territory, including east Jerusalem",0,703014,0,5708,0.811932621540965
2022-10-30,PS,"occupied Palestinian territory, including east Jerusalem",22,703036,0,5708,0.8119072138553359
2022-11-06,PS,"occupied Palestinian territory, including east Jerusalem",33,703069,0,5708,0.8118691053082984
2022-11-13,PS,"occupied Palestinian territory, including east Jerusalem",0,703069,0,5708,0.8118691053082984
2022-11-20,PS,"occupied Palestinian territory, including east Jerusalem",0,703069,0,5708,0.8118691053082984
2022-11-27,PS,"occupied Palestinian territory, including east Jerusalem",0,703069,0,5708,0.8118691053082984
2022-12-04,PS,"occupied Palestinian territory, including east Jerusalem",0,703069,0,5708,0.8118691053082984
2022-12-11,PS,"occupied Palestinian territory, including east Jerusalem",159,703228,0,5708,0.8116855415313383
2022-12-18,PS,"occupied Palestinian territory, including east Jerusalem",0,703228,0,5708,0.8116855415313383
2022-12-25,PS,"occupied Palestinian territory, including east Jerusalem",0,703228,0,5708,0.8116855415313383
2023-01-01,PS,"occupied Palestinian territory, including east Jerusalem",0,703228,0,5708,0.8116855415313383
2023-01-08,PS,"occupied Palestinian territory, including east Jerusalem",0,703228,0,5708,0.8116855415313383
2023-01-15,PS,"occupied Palestinian territory, including east Jerusalem",0,703228,0,5708,0.8116855415313383
2023-01-22,PS,"occupied Palestinian territory, including east Jerusalem",0,703228,0,5708,0.8116855415313383
2023-01-29,PS,"occupied Palestinian territory, including east Jerusalem",0,703228,0,5708,0.8116855415313383
2023-02-05,PS,"occupied Palestinian territory, including east Jerusalem",0,703228,0,5708,0.8116855415313383
2023-02-12,PS,"occupied Palestinian territory, including east Jerusalem",0,703228,0,5708,0.8116855415313383
2023-02-19,PS,"occupied Palestinian territory, including east Jerusalem",0,703228,0,5708,0.8116855415313383
2023-02-26,PS,"occupied Palestinian territory, including east Jerusalem",0,703228,0,5708,0.8116855415313383
2023-03-05,PS,"occupied Palestinian territory, including east Jerusalem",0,703228,0,5708,0.8116855415313383
2023-03-12,PS,"occupied Palestinian territory, including east Jerusalem",0,703228,0,5708,0.8116855415313383
2023-03-19,PS,"occupied Palestinian territory, including east Jerusalem",0,703228,0,5708,0.8116855415313383
2023-03-26,PS,"occupied Palestinian territory, including east Jerusalem",0,703228,0,5708,0.8116855415313383
2023-04-02,PS,"occupied Palestinian territory, including east Jerusalem",0,703228,0,5708,0.8116855415313383
2023-04-09,PS,"occupied Palestinian territory, including east Jerusalem",0,703228,0,5708,0.8116855415313383
2023-04-16,PS,"occupied Palestinian territory, including east Jerusalem",0,703228,0,5708,0.8116855415313383
2023-04-23,PS,"occupied Palestinian territory, including east Jerusalem",0,703228,0,5708,0.8116855415313383
2023-04-30,PS,"occupied Palestinian territory, including east Jerusalem",0,703228,0,5708,0.8116855415313383
2023-05-07,PS,"occupied Palestinian territory, including east Jerusalem",0,703228,0,5708,0.8116855415313383
2023-05-14,PS,"occupied Palestinian territory, including east Jerusalem",0,703228,0,5708,0.8116855415313383
2023-05-21,PS,"occupied Palestinian territory, including east Jerusalem",0,703228,0,5708,0.8116855415313383
2023-05-28,PS,"occupied Palestinian territory, including east Jerusalem",0,703228,0,5708,0.8116855415313383
2023-06-04,PS,"occupied Palestinian territory, including east Jerusalem",0,703228,0,5708,0.8116855415313383
2023-06-11,PS,"occupied Palestinian territory, including east Jerusalem",0,703228,0,5708,0.8116855415313383
2023-06-18,PS,"occupied Palestinian territory, including east Jerusalem",0,703228,0,5708,0.8116855415313383
2023-06-25,PS,"occupied Palestinian territory, including east Jerusalem",0,703228,0,5708,0.8116855415313383
2023-07-02,PS,"occupied Palestinian territory, including east Jerusalem",0,703228,0,5708,0.8116855415313383
2023-07-09,PS,"occupied Palestinian territory, including east Jerusalem",0,703228,0,5708,0.8116855415313383
2023-07-16,PS,"occupied Palestinian territory, including east Jerusalem",0,703228,0,5708,0.8116855415313383
2023-07-23,PS,"occupied Palestinian territory, including east Jerusalem",0,703228,0,5708,0.8116855415313383
2023-07-30,PS,"occupied Palestinian territory, including east Jerusalem",0,703228,0,5708,0.8116855415313383
2023-08-06,PS,"occupied Palestinian territory, including east Jerusalem",0,703228,0,5708,0.8116855415313383
2023-08-13,PS,"occupied Palestinian territory, including east Jerusalem",0,703228,0,5708,0.8116855415313383
2023-08-20,PS,"occupied Palestinian territory, including east Jerusalem",0,703228,0,5708,0.8116855415313383
2023-08-27,PS,"occupied Palestinian territory, including east Jerusalem",0,703228,0,5708,0.8116855415313383
2023-09-03,PS,"occupied Palestinian territory, including east Jerusalem",0,703228,0,5708,0.8116855415313383
2023-09-10,PS,"occupied Palestinian territory, including east Jerusalem",0,703228,0,5708,0.8116855415313383
2023-09-17,PS,"occupied Palestinian territory, including east Jerusalem",0,703228,0,5708,0.8116855415313383
2023-09-24,PS,"occupied Palestinian territory, including east Jerusalem",0,703228,0,5708,0.8116855415313383
2023-10-01,PS,"occupied Palestinian territory, including east Jerusalem",0,703228,0,5708,0.8116855415313383
2023-10-08,PS,"occupied Palestinian territory, including east Jerusalem",0,703228,0,5708,0.8116855415313383
2023-10-15,PS,"occupied Palestinian territory, including east Jerusalem",0,703228,0,5708,0.8116855415313383
2023-10-22,PS,"occupied Palestinian territory, including east Jerusalem",0,703228,0,5708,0.8116855415313383
2023-10-29,PS,"occupied Palestinian territory, including east Jerusalem",0,703228,0,5708,0.8116855415313383
2023-11-05,PS,"occupied Palestinian territory, including east Jerusalem",0,703228,0,5708,0.8116855415313383
2023-11-12,PS,"occupied Palestinian territory, including east Jerusalem",0,703228,0,5708,0.8116855415313383
2023-11-19,PS,"occupied Palestinian territory, including east Jerusalem",0,703228,0,5708,0.8116855415313383
2023-11-26,PS,"occupied Palestinian territory, including east Jerusalem",0,703228,0,5708,0.8116855415313383
2023-12-03,PS,"occupied Palestinian territory, including east Jerusalem",0,703228,0,5708,0.8116855415313383
2023-12-10,PS,"occupied Palestinian territory, including east Jerusalem",0,703228,0,5708,0.8116855415313383
2023-12-17,PS,"occupied Palestinian territory, including east Jerusalem",0,703228,0,5708,0.8116855415313383
2023-12-24,PS,"occupied Palestinian territory, including east Jerusalem",0,703228,0,5708,0.8116855415313383
2023-12-31,PS,"occupied Palestinian territory, including east Jerusalem",0,703228,0,5708,0.8116855415313383
2024-01-07,PS,"occupied Palestinian territory, including east Jerusalem",0,703228,0,5708,0.8116855415313383
2024-01-14,PS,"occupied Palestinian territory, including east Jerusalem",0,703228,0,5708,0.8116855415313383
2020-04-05,OM,Oman,125,277,2,2,0.7220216606498195
2020-04-12,OM,Oman,269,546,1,3,0.5494505494505495
2020-04-19,OM,Oman,634,1180,3,6,0.5084745762711864
2020-04-26,OM,Oman,725,1905,4,10,0.5249343832020997
2020-05-03,OM,Oman,578,2483,2,12,0.4832863471606927
2020-05-10,OM,Oman,741,3224,5,17,0.5272952853598015
2020-05-17,OM,Oman,1805,5029,4,21,0.41757804732551207
2020-05-24,OM,Oman,2228,7257,15,36,0.49607275733774286
2020-05-31,OM,Oman,3166,10423,6,42,0.4029550033579583
2020-06-07,OM,Oman,5593,16016,30,72,0.4495504495504496
2020-06-14,OM,Oman,6061,22077,27,99,0.4484304932735426
2020-06-21,OM,Oman,6489,28566,29,128,0.4480851361758734
2020-06-28,OM,Oman,8387,36953,31,159,0.4302762969177063
2020-07-05,OM,Oman,8153,45106,44,203,0.4500509909989802
2020-07-12,OM,Oman,9591,54697,45,248,0.4534069510210798
2020-07-19,OM,Oman,10807,65504,60,308,0.470200293111871
2020-07-26,OM,Oman,9354,74858,63,371,0.4956050121563494
2020-08-02,OM,Oman,4301,79159,50,421,0.5318409782842127
2020-08-09,OM,Oman,2198,81357,88,509,0.6256376218395466
2020-08-16,OM,Oman,1567,82924,53,562,0.6777290048719309
2020-08-23,OM,Oman,845,83769,47,609,0.7269992479318125
2020-08-30,OM,Oman,1236,85005,41,650,0.7646609022998647
2020-09-06,OM,Oman,1375,86380,55,705,0.8161611484139847
2020-09-13,OM,Oman,1957,88337,57,762,0.8626057031594916
2020-09-20,OM,Oman,3416,91753,56,818,0.8915239828670452
2020-09-27,OM,Oman,4154,95907,67,885,0.9227689324032657
2020-10-04,OM,Oman,2678,98585,50,935,0.9484201450524927
2020-10-11,OM,Oman,5544,104129,74,1009,0.9689903869239116
2020-10-18,OM,Oman,4167,108296,62,1071,0.988956194134594
2020-03-22,PK,Pakistan,440,461,2,2,0.43383947939262474
2020-03-29,PK,Pakistan,774,1235,7,9,0.728744939271255
2022-02-13,PW,Palau,577,3133,6,6,0.1915097350781998
2022-02-20,PW,Palau,330,3463,0,6,0.17326017903551832
2022-02-27,PW,Palau,263,3726,0,6,0.1610305958132045
2022-03-06,PW,Palau,118,3844,0,6,0.15608740894901144
2022-03-13,PW,Palau,55,3899,0,6,0.15388561169530648
2022-03-20,PW,Palau,46,3945,0,6,0.1520912547528517
2022-03-27,PW,Palau,42,3987,0,6,0.15048908954100826
2022-04-03,PW,Palau,55,4042,0,6,0.14844136566056407
2022-04-10,PW,Palau,56,4098,0,6,0.14641288433382138
2022-04-17,PW,Palau,24,4122,0,6,0.1455604075691412
2022-04-24,PW,Palau,274,4396,0,6,0.13648771610555052
2022-05-01,PW,Palau,214,4610,0,6,0.1301518438177874
2022-05-08,PW,Palau,122,4732,0,6,0.12679628064243448
2022-05-15,PW,Palau,147,4879,0,6,0.12297601967616315
2022-05-22,PW,Palau,88,4967,0,6,0.12079726192872962
2022-05-29,PW,Palau,76,5043,0,6,0.1189767995240928
2022-06-05,PW,Palau,40,5083,0,6,0.11804052724768838
2022-06-12,PW,Palau,62,5145,0,6,0.11661807580174927
2022-06-19,PW,Palau,36,5181,0,6,0.11580775911986102
2022-06-26,PW,Palau,18,5199,0,6,0.1154068090017311
2022-07-03,PW,Palau,0,5199,0,6,0.1154068090017311
2022-07-10,PW,Palau,0,5199,0,6,0.1154068090017311
2022-07-17,PW,Palau,0,5199,0,6,0.1154068090017311
2022-07-24,PW,Palau,17,5216,0,6,0.11503067484662577
2022-07-31,PW,Palau,16,5232,0,6,0.11467889908256881
2022-08-07,PW,Palau,7,5239,0,6,0.11452567283832793
2022-08-14,PW,Palau,7,5246,0,6,0.1143728555089592
2022-08-21,PW,Palau,33,5279,0,6,0.11365788975184693
2022-08-28,PW,Palau,69,5348,0,6,0.11219147344801794
2022-09-04,PW,Palau,55,5403,0,6,0.11104941699056081
2022-09-11,PW,Palau,27,5430,0,6,0.11049723756906078
2022-09-18,PW,Palau,30,5460,0,6,0.10989010989010989
2022-09-25,PW,Palau,0,5460,0,6,0.10989010989010989
2022-10-02,PW,Palau,21,5481,0,6,0.10946907498631638
2022-10-09,PW,Palau,9,5490,1,7,0.12750455373406194
2022-10-16,PW,Palau,0,5490,0,7,0.12750455373406194
2022-10-23,PW,Palau,23,5513,0,7,0.1269726101940867
2022-10-30,PW,Palau,17,5530,0,7,0.12658227848101267
2022-11-06,PW,Palau,0,5530,0,7,0.12658227848101267
2022-11-13,PW,Palau,154,5684,0,7,0.12315270935960591
2022-11-20,PW,Palau,101,5785,0,7,0.12100259291270526
2022-11-27,PW,Palau,111,5896,0,7,0.11872455902306649
2022-12-04,PW,Palau,37,5933,0,7,0.11798415641328165
2022-12-11,PW,Palau,22,5955,2,9,0.15113350125944583
2022-12-18,PW,Palau,0,5955,0,9,0.15113350125944583
2022-12-25,PW,Palau,13,5968,0,9,0.15080428954423591
2023-01-01,PW,Palau,3,5971,0,9,0.15072852118573102
2023-01-08,PW,Palau,5,5976,0,9,0.15060240963855423
2023-01-15,PW,Palau,4,5980,0,9,0.15050167224080266
2023-01-22,PW,Palau,6,5986,0,9,0.1503508185766789
2023-01-29,PW,Palau,0,5986,0,9,0.1503508185766789
2023-02-05,PW,Palau,1,5987,0,9,0.15032570569567397
2023-02-12,PW,Palau,1,5988,0,9,0.15030060120240482
2023-02-19,PW,Palau,0,5988,0,9,0.15030060120240482
2023-02-26,PW,Palau,1,5989,0,9,0.1502755050926699
2023-03-05,PW,Palau,2,5991,0,9,0.15022533800701052
2023-03-12,PW,Palau,3,5994,0,9,0.15015015015015015
2023-03-19,PW,Palau,1,5995,0,9,0.1501251042535446
2023-03-26,PW,Palau,2,5997,0,9,0.1500750375187594
2023-04-02,PW,Palau,0,5997,0,9,0.1500750375187594
2023-04-09,PW,Palau,0,5997,0,9,0.1500750375187594
2023-04-16,PW,Palau,2,5999,0,9,0.15002500416736123
2023-04-23,PW,Palau,0,5999,0,9,0.15002500416736123
2023-04-30,PW,Palau,0,5999,0,9,0.15002500416736123
2023-05-07,PW,Palau,1,6000,0,9,0.15
2023-05-14,PW,Palau,0,6000,0,9,0.15
2023-05-21,PW,Palau,9,6009,0,9,0.14977533699450823
2023-05-28,PW,Palau,0,6009,0,9,0.14977533699450823
2023-06-04,PW,Palau,2,6011,0,9,0.14972550324405257
2023-06-11,PW,Palau,-2,6009,0,9,0.14977533699450823
2023-06-18,PW,Palau,4,6013,0,9,0.14967570264427074
2023-06-25,PW,Palau,0,6013,0,9,0.14967570264427074
2023-07-02,PW,Palau,0,6013,0,9,0.14967570264427074
2023-07-09,PW,Palau,36,6049,0,9,0.1487849231277897
2023-07-16,PW,Palau,18,6067,0,9,0.1483434976100214
2023-07-23,PW,Palau,0,6067,0,9,0.1483434976100214
2023-07-30,PW,Palau,55,6122,0,9,0.14701078079059132
2023-08-06,PW,Palau,54,6176,0,9,0.14572538860103626
2023-08-13,PW,Palau,21,6197,0,9,0.14523156365983542
2023-08-20,PW,Palau,0,6197,0,9,0.14523156365983542
2023-08-27,PW,Palau,0,6197,0,9,0.14523156365983542
2023-09-03,PW,Palau,23,6220,0,9,0.14469453376205788
2023-09-10,PW,Palau,9,6229,0,9,0.14448547118317548
2023-09-17,PW,Palau,0,6229,0,9,0.14448547118317548
2023-09-24,PW,Palau,9,6238,0,9,0.14427701186277653
2023-10-01,PW,Palau,3,6241,0,9,0.14420765902900176
2023-10-08,PW,Palau,2,6243,0,9,0.14416146083613646
2023-10-15,PW,Palau,0,6243,0,9,0.14416146083613646
2023-10-22,PW,Palau,3,6246,0,9,0.1440922190201729
2023-10-29,PW,Palau,0,6246,0,9,0.1440922190201729
2023-11-05,PW,Palau,1,6247,0,9,0.1440691531935329
2023-11-12,PW,Palau,0,6247,0,9,0.1440691531935329
2023-11-19,PW,Palau,2,6249,0,9,0.14402304368698993
2023-11-26,PW,Palau,0,6249,0,9,0.14402304368698993
2023-12-03,PW,Palau,0,6249,0,9,0.14402304368698993
2023-12-10,PW,Palau,0,6249,0,9,0.14402304368698993
2023-12-17,PW,Palau,16,6265,0,9,0.14365522745411013
2023-12-24,PW,Palau,0,6265,0,9,0.14365522745411013
2023-12-31,PW,Palau,0,6265,0,9,0.14365522745411013
2024-01-07,PW,Palau,0,6265,0,9,0.14365522745411013
2024-01-14,PW,Palau,0,6265,0,9,0.14365522745411013
2020-03-22,PA,Panama,110,137,0,1,0.7299270072992701
2022-05-29,PA,Panama,22458,847375,28,8244,0.9728868564685057
2022-06-05,PA,Panama,21421,868796,23,8267,0.9515467382446512
2022-06-12,PA,Panama,18841,887637,28,8295,0.934503631552087
2022-06-19,PA,Panama,12696,900333,23,8318,0.9238803864792249
2022-06-26,PA,Panama,12015,912348,22,8340,0.9141248734035696
2022-07-03,PA,Panama,10642,922990,28,8368,0.906618706594871
2022-07-10,PA,Panama,9120,932110,16,8384,0.8994646554591196
2022-07-17,PA,Panama,9973,942083,11,8395,0.8911104435596439
2022-07-24,PA,Panama,6390,948473,17,8412,0.886899258070604
2022-07-31,PA,Panama,5896,954369,13,8425,0.8827822362210004
2022-08-07,PA,Panama,5931,960300,9,8434,0.8782672081641154
2022-08-14,PA,Panama,6479,966779,10,8444,0.8734157444462489
2022-08-21,PA,Panama,6021,972800,12,8456,0.8692434210526315
2022-08-28,PA,Panama,5381,978181,14,8470,0.8658929175684255
2022-09-04,PA,Panama,3641,981822,10,8480,0.8637003448690292
2022-09-11,PA,Panama,2412,984234,7,8487,0.8622949420564623
2022-09-18,PA,Panama,1580,985814,3,8490,0.8612172275906003
2022-09-25,PA,Panama,1052,986866,7,8497,0.8610084854478725
2022-10-02,PA,Panama,747,987613,5,8502,0.8608635163773665
2022-10-09,PA,Panama,667,988280,3,8505,0.8605860687254625
2022-10-16,PA,Panama,725,989005,1,8506,0.8600563192299331
2022-10-23,PA,Panama,603,989608,0,8506,0.8595322592380014
2022-10-30,PA,Panama,805,990413,3,8509,0.8591365420284266
2022-11-06,PA,Panama,838,991251,0,8509,0.8584102311119989
2022-11-13,PA,Panama,1372,992623,6,8515,0.8578281986212287
2022-11-20,PA,Panama,3103,995726,4,8519,0.8555566491183317
2022-11-27,PA,Panama,6435,1002161,7,8526,0.8507615043890153
2022-12-04,PA,Panama,7091,1009252,7,8533,0.8454776408667012
2022-12-11,PA,Panama,6718,1015970,10,8543,0.8408712855694558
2022-12-18,PA,Panama,4991,1020961,11,8554,0.8378380760871376
2022-12-25,PA,Panama,2817,1023778,13,8567,0.8368025099191427
2023-01-01,PA,Panama,2066,1025844,8,8575,0.8358970759686658
2023-01-08,PA,Panama,1403,1027247,9,8584,0.8356315472325546
2023-01-15,PA,Panama,1025,1028272,5,8589,0.835284827360854
2023-01-22,PA,Panama,789,1029061,5,8594,0.8351302789630546
2023-01-29,PA,Panama,640,1029701,2,8596,0.8348054435219545
2023-02-05,PA,Panama,513,1030214,3,8599,0.8346809497832489
2023-02-12,PA,Panama,444,1030658,1,8600,0.834418400672192
2023-02-19,PA,Panama,356,1031014,3,8603,0.8344212590711669
2023-02-26,PA,Panama,259,1031273,1,8604,0.8343086651158327
2023-03-05,PA,Panama,458,1031731,5,8609,0.8344229261309393
2023-03-12,PA,Panama,506,1032237,2,8611,0.834207648049818
2023-03-19,PA,Panama,702,1032939,1,8612,0.8337375198341818
2023-03-26,PA,Panama,842,1033781,0,8612,0.8330584524188392
2023-04-02,PA,Panama,0,1033781,0,8612,0.8330584524188392
2023-04-09,PA,Panama,0,1033781,0,8612,0.8330584524188392
2023-04-16,PA,Panama,1576,1035357,5,8617,0.8322733124902811
2023-04-23,PA,Panama,743,1036100,1,8618,0.8317729948846636
2023-04-30,PA,Panama,633,1036733,3,8621,0.8315545082485075
2023-05-07,PA,Panama,591,1037324,-1,8620,0.8309843404760712
2023-05-14,PA,Panama,654,1037978,2,8622,0.8306534435219244
2023-05-21,PA,Panama,0,1037978,0,8622,0.8306534435219244
2023-05-28,PA,Panama,330,1038308,1,8623,0.8304857518193061
2023-06-04,PA,Panama,408,1038716,6,8629,0.830737179363753
2023-06-11,PA,Panama,436,1039152,3,8632,0.8306773215083068
2023-06-18,PA,Panama,563,1039715,2,8634,0.8304198746771952
2023-06-25,PA,Panama,473,1040188,2,8636,0.830234534526451
2023-07-02,PA,Panama,347,1040535,0,8636,0.8299576660083515
2023-07-09,PA,Panama,211,1040746,1,8637,0.8298854859879357
2023-07-16,PA,Panama,178,1040924,3,8640,0.8300317794574821
2023-07-23,PA,Panama,91,1041015,2,8642,0.8301513426799806
2023-07-30,PA,Panama,75,1041090,1,8643,0.8301875918508487
2023-08-06,PA,Panama,56,1041146,1,8644,0.8302389866550898
2023-08-13,PA,Panama,46,1041192,0,8644,0.8302023065870656
2023-08-20,PA,Panama,37,1041229,0,8644,0.8301728054059194
2023-08-27,PA,Panama,37,1041266,0,8644,0.8301433063213435
2023-09-03,PA,Panama,38,1041304,1,8645,0.8302090455813096
2023-09-10,PA,Panama,32,1041336,0,8645,0.8301835334608617
2023-09-17,PA,Panama,37,1041373,1,8646,0.8302500640980706
2023-09-24,PA,Panama,22,1041395,0,8646,0.8302325246424267
2023-10-01,PA,Panama,52,1041447,0,8646,0.8301910706929877
2023-10-08,PA,Panama,50,1041497,1,8647,0.8302472306689312
2023-10-15,PA,Panama,53,1041550,0,8647,0.8302049829580913
2023-10-22,PA,Panama,44,1041594,3,8650,0.8304579327453883
2023-10-29,PA,Panama,39,1041633,0,8650,0.8304268393954493
2023-11-05,PA,Panama,37,1041670,1,8651,0.8304933424213042
2023-11-12,PA,Panama,37,1041707,0,8651,0.8304638444399434
2023-11-19,PA,Panama,31,1041738,0,8651,0.830439131528273
2023-11-26,PA,Panama,48,1041786,0,8651,0.8304008692764157
2023-12-03,PA,Panama,53,1041839,0,8651,0.8303586254690024
2023-12-10,PA,Panama,48,1041887,1,8652,0.8304163503335774
2023-12-17,PA,Panama,102,1041989,0,8652,0.8303350611186875
2023-12-24,PA,Panama,176,1042165,1,8653,0.8302907888865967
2023-12-31,PA,Panama,402,1042567,1,8654,0.830066556873563
2024-01-07,PA,Panama,142,1042709,12,8666,0.8311043637294777
2024-01-14,PA,Panama,100,1042809,20,8686,0.8329425618689521
2020-09-13,PG,Papua New Guinea,20,508,0,5,0.984251968503937
2021-02-14,PG,Papua New Guinea,27,922,0,9,0.9761388286334056
2021-02-21,PG,Papua New Guinea,134,1056,0,9,0.8522727272727272
2021-02-28,PG,Papua New Guinea,260,1316,0,9,0.6838905775075987
2021-03-07,PG,Papua New Guinea,354,1670,0,9,0.5389221556886228
2021-03-14,PG,Papua New Guinea,599,2269,0,9,0.3966505068312032
2021-03-21,PG,Papua New Guinea,1305,3574,0,9,0.2518186905428092
2021-03-28,PG,Papua New Guinea,1775,5349,0,9,0.16825574873808188
2021-04-04,PG,Papua New Guinea,1689,7038,0,9,0.1278772378516624
2021-04-11,PG,Papua New Guinea,1564,8602,0,9,0.10462683096954196
2021-04-18,PG,Papua New Guinea,1197,9799,0,9,0.09184610674558628
2021-04-25,PG,Papua New Guinea,1036,10835,0,9,0.08306414397784956
2021-05-02,PG,Papua New Guinea,438,11273,96,105,0.9314290783287502
2021-05-09,PG,Papua New Guinea,1220,12493,16,121,0.9685423837348917
2021-05-16,PG,Papua New Guinea,1713,14206,0,121,0.8517527805152753
2021-05-23,PG,Papua New Guinea,1016,15222,15,136,0.8934436999080279
2021-06-13,PG,Papua New Guinea,337,16728,1,165,0.9863701578192252
2020-06-14,PY,Paraguay,171,1261,0,11,0.8723235527359239
2020-06-21,PY,Paraguay,101,1362,2,13,0.9544787077826725
2020-06-28,PY,Paraguay,349,1711,0,13,0.7597895967270601
2020-07-05,PY,Paraguay,674,2385,7,20,0.8385744234800839
2020-07-12,PY,Paraguay,351,2736,0,20,0.7309941520467835
2020-07-19,PY,Paraguay,721,3457,8,28,0.8099508244142319
2020-07-26,PY,Paraguay,767,4224,10,38,0.8996212121212122
2020-08-02,PY,Paraguay,1114,5338,11,49,0.9179467965530161
2020-03-22,PL,Poland,431,534,2,5,0.9363295880149813
2022-01-23,PT,Portugal,367358,2299681,281,19621,0.8532052923862049
2022-01-30,PT,Portugal,405306,2704987,292,19913,0.7361588059388086
2022-02-06,PT,Portugal,308062,3013049,355,20268,0.6726740919248244
2022-02-13,PT,Portugal,169681,3182730,301,20569,0.6462690834597971
2022-02-20,PT,Portugal,105839,3288569,298,20867,0.6345313113393698
2022-02-27,PT,Portugal,80116,3368685,202,21069,0.6254369286531688
2022-03-06,PT,Portugal,82398,3451083,155,21224,0.6149953507348274
2022-03-13,PT,Portugal,85842,3536925,140,21364,0.6040275097719064
2022-03-20,PT,Portugal,81477,3618402,127,21491,0.593936218253251
2022-03-27,PT,Portugal,77148,3695550,158,21649,0.585812666585488
2022-04-03,PT,Portugal,68162,3763712,151,21800,0.5792154128689975
2022-04-10,PT,Portugal,62897,3826609,152,21952,0.5736671815698965
2022-04-17,PT,Portugal,63637,3890246,145,22097,0.5680103520445751
2022-04-24,PT,Portugal,70068,3960314,127,22224,0.5611676245873433
2022-05-01,PT,Portugal,74057,4034371,128,22352,0.5540392789854974
2022-05-08,PT,Portugal,100901,4135272,131,22483,0.5436885409230638
2022-05-15,PT,Portugal,160111,4295383,192,22675,0.5278923905039434
2022-05-22,PT,Portugal,190560,4485943,223,22898,0.5104389422692174
2022-05-29,PT,Portugal,175844,4661787,231,23129,0.49614021404238334
2022-06-05,PT,Portugal,165476,4827263,295,23424,0.4852439156515814
2022-06-12,PT,Portugal,118089,4945352,262,23686,0.4789547842094961
2022-06-19,PT,Portugal,100752,5046104,269,23955,0.47472267713864
2022-06-26,PT,Portugal,75145,5121249,155,24110,0.47078359204951764
2022-07-03,PT,Portugal,66673,5187922,136,24246,0.46735475205679655
2022-07-10,PT,Portugal,53160,5241082,139,24385,0.4652665232102836
2022-07-17,PT,Portugal,36813,5277895,119,24504,0.4642760039750696
2022-07-24,PT,Portugal,30282,5308177,83,24587,0.46319103526502603
2022-07-31,PT,Portugal,22110,5330287,70,24657,0.4625829716110971
2022-08-07,PT,Portugal,19202,5349489,70,24727,0.4622310654344742
2022-08-14,PT,Portugal,17633,5367122,57,24784,0.4617744854691211
2022-08-21,PT,Portugal,16001,5383123,40,24824,0.46114495247461373
2022-08-28,PT,Portugal,17870,5400993,45,24869,0.4604523649632577
2022-09-04,PT,Portugal,16575,5417568,48,24917,0.45992962155712674
2022-09-11,PT,Portugal,15909,5433477,39,24956,0.4593007387350678
2022-09-18,PT,Portugal,17355,5450832,41,24997,0.45859054177417324
2022-09-25,PT,Portugal,19259,5470091,42,25039,0.45774375599967165
2022-10-02,PT,Portugal,17513,5487604,50,25089,0.45719406866822027
2022-10-09,PT,Portugal,6467,5494071,42,25131,0.45742037188816814
2022-10-16,PT,Portugal,7052,5501123,47,25178,0.4576883665389776
2022-10-23,PT,Portugal,7736,5508859,50,25228,0.4579532712672443
2022-10-30,PT,Portugal,5806,5514665,61,25289,0.4585772662528005
2022-11-06,PT,Portugal,5304,5519969,49,25338,0.4590243169843889
2022-11-13,PT,Portugal,6060,5526029,55,25393,0.45951622765642386
2022-11-20,PT,Portugal,6093,5532122,48,25441,0.45987778288331316
2022-11-27,PT,Portugal,5126,5537248,60,25501,0.4605356306959703
2022-12-04,PT,Portugal,3963,5541211,69,25570,0.4614514769424951
2022-12-11,PT,Portugal,3370,5544581,73,25643,0.4624876072691516
2022-12-18,PT,Portugal,3445,5548026,71,25714,0.4634801639357855
2022-12-25,PT,Portugal,2542,5550568,59,25773,0.4643308576707825
2023-01-01,PT,Portugal,2401,5552969,50,25823,0.4650305089043356
2023-01-08,PT,Portugal,2154,5555123,61,25884,0.46594827873298217
2023-01-15,PT,Portugal,1851,5556974,58,25942,0.46683680722637894
2023-01-22,PT,Portugal,1333,5558307,64,26006,0.46787627959376843
2023-01-29,PT,Portugal,1242,5559549,33,26039,0.46836532963375266
2023-02-05,PT,Portugal,1074,5560623,27,26066,0.4687604248660627
2023-02-12,PT,Portugal,1646,5562269,52,26118,0.4695565784394821
2023-02-19,PT,Portugal,1544,5563813,57,26175,0.47045075023190036
2023-02-26,PT,Portugal,1567,5565380,53,26228,0.47127060506200835
2023-03-05,PT,Portugal,1585,5566965,49,26277,0.47201661946859735
2023-03-12,PT,Portugal,1609,5568574,42,26319,0.472634466202658
2023-03-19,PT,Portugal,1736,5570310,57,26376,0.47351045094438193
2023-03-26,PT,Portugal,1615,5571925,45,26421,0.47418082619561464
2023-04-02,PT,Portugal,1568,5573493,44,26465,0.47483687518760676
2023-04-09,PT,Portugal,1344,5574837,30,26495,0.4752605322810335
2023-04-16,PT,Portugal,1754,5576591,36,26531,0.47575660470706926
2023-04-23,PT,Portugal,1510,5578101,39,26570,0.4763269793788244
2023-04-30,PT,Portugal,1309,5579410,34,26604,0.47682461048748886
2023-05-07,PT,Portugal,1379,5580789,50,26654,0.4776027188987077
2023-05-14,PT,Portugal,1333,5582122,24,26678,0.47791861231266536
2023-05-21,PT,Portugal,1618,5583740,42,26720,0.47853230988548895
2023-05-28,PT,Portugal,2082,5585822,36,26756,0.47899843568234
2023-06-04,PT,Portugal,1758,5587580,46,26802,0.47967098457650714
2023-06-11,PT,Portugal,1255,5588835,40,26842,0.48027898479736836
2023-06-18,PT,Portugal,1123,5589958,45,26887,0.4809875136807825
2023-06-25,PT,Portugal,1096,5591054,26,26913,0.4813582555274909
2023-07-02,PT,Portugal,1029,5592083,27,26940,0.48175250617703635
2023-07-09,PT,Portugal,1253,5593336,30,26970,0.4821809381735694
2023-07-16,PT,Portugal,1400,5594736,23,26993,0.482471380240283
2023-07-23,PT,Portugal,1379,5596115,31,27024,0.48290644491759016
2023-07-30,PT,Portugal,1837,5597952,37,27061,0.48340893240956695
2023-08-06,PT,Portugal,1713,5599665,45,27106,0.48406467172589795
2023-08-13,PT,Portugal,2386,5602051,33,27139,0.484447571077093
2023-08-20,PT,Portugal,3172,5605223,52,27191,0.4851011280015086
2023-08-27,PT,Portugal,4332,5609555,73,27264,0.4860278578247294
2023-09-03,PT,Portugal,4165,5613720,54,27318,0.4866291870631239
2023-09-10,PT,Portugal,3980,5617700,56,27374,0.48728127169482177
2023-09-17,PT,Portugal,3231,5620931,60,27434,0.48806861354462455
2023-09-24,PT,Portugal,2583,5623514,68,27502,0.4890536415486829
2023-10-01,PT,Portugal,2649,5626163,42,27544,0.48956988981655886
2023-10-08,PT,Portugal,1903,5628066,37,27581,0.4900617725520632
2023-10-15,PT,Portugal,1734,5629800,53,27634,0.49085225052399734
2023-10-22,PT,Portugal,1085,5630885,40,27674,0.4914680374399406
2023-10-29,PT,Portugal,744,5631629,28,27702,0.4919003009608765
2023-11-05,PT,Portugal,618,5632247,20,27722,0.4922014251150562
2023-11-12,PT,Portugal,695,5632942,16,27738,0.4924247400381541
2023-11-19,PT,Portugal,693,5633635,26,27764,0.49282568004494437
2023-11-26,PT,Portugal,770,5634405,19,27783,0.49309554425001395
2023-12-03,PT,Portugal,795,5635200,18,27801,0.4933454003407155
2023-12-10,PT,Portugal,845,5636045,27,27828,0.49375049347547795
2023-12-17,PT,Portugal,1065,5637110,26,27854,0.49411844012268696
2023-12-24,PT,Portugal,1173,5638283,32,27886,0.4945831913722671
2023-12-31,PT,Portugal,1170,5639453,43,27929,0.4952430670137689
2024-01-07,PT,Portugal,1043,5640496,47,27976,0.4959847502772806
2024-01-14,PT,Portugal,0,5640496,0,27976,0.4959847502772806
2022-01-09,PR,Puerto Rico,66268,391168,98,3429,0.8766054482984293
2022-01-16,PR,Puerto Rico,53195,444363,163,3592,0.8083481297947849
2022-01-23,PR,Puerto Rico,23235,467598,180,3772,0.806675819828143
2022-01-30,PR,Puerto Rico,12423,480021,136,3908,0.8141310484332978
2022-02-06,PR,Puerto Rico,6736,486757,87,3995,0.8207380684818091
2022-02-13,PR,Puerto Rico,4004,490761,69,4064,0.8281016625200455
2022-02-20,PR,Puerto Rico,2469,493230,43,4107,0.8326744115321453
2022-02-27,PR,Puerto Rico,1847,495077,29,4136,0.8354256004621504
2022-03-06,PR,Puerto Rico,1604,496681,22,4158,0.8371570484878625
2022-03-13,PR,Puerto Rico,1426,498107,9,4167,0.8365672435842098
2022-03-20,PR,Puerto Rico,1552,499659,2,4169,0.8343690396850653
2022-03-27,PR,Puerto Rico,2114,501773,4,4173,0.831650965675714
2022-04-03,PR,Puerto Rico,3456,505229,9,4182,0.8277434589067532
2022-04-10,PR,Puerto Rico,6088,511317,11,4193,0.8200392320224049
2022-04-17,PR,Puerto Rico,10770,522087,5,4198,0.804080545962646
2022-04-24,PR,Puerto Rico,23624,545711,8,4206,0.7707376248600449
2022-05-01,PR,Puerto Rico,29984,575695,17,4223,0.7335481461537794
2022-05-08,PR,Puerto Rico,33645,609340,27,4250,0.6974759575934617
2022-05-15,PR,Puerto Rico,35589,644929,38,4288,0.6648793898243063
2022-05-22,PR,Puerto Rico,33626,678555,51,4339,0.6394470602972493
2022-05-29,PR,Puerto Rico,30231,708786,49,4388,0.6190867201101602
2022-06-05,PR,Puerto Rico,28179,736965,39,4427,0.6007069535188239
2022-06-12,PR,Puerto Rico,25388,762353,41,4468,0.5860802016913425
2022-06-19,PR,Puerto Rico,24883,787236,41,4509,0.5727634406963097
2022-06-26,PR,Puerto Rico,24923,812159,64,4573,0.5630670841547036
2022-07-03,PR,Puerto Rico,22949,835108,51,4624,0.5537008386939175
2022-07-10,PR,Puerto Rico,18243,853351,41,4665,0.5466683697564074
2022-07-17,PR,Puerto Rico,18704,872055,44,4709,0.5399888768483639
2022-07-24,PR,Puerto Rico,20155,892210,45,4754,0.5328341982268748
2022-07-31,PR,Puerto Rico,18555,910765,47,4801,0.5271392730287175
2022-08-07,PR,Puerto Rico,22489,933254,47,4848,0.5194727266103334
2022-08-14,PR,Puerto Rico,18684,951938,50,4898,0.5145293075809558
2022-08-21,PR,Puerto Rico,15185,967123,39,4937,0.5104831546762925
2022-08-28,PR,Puerto Rico,15613,982736,53,4990,0.5077660734927794
2022-09-04,PR,Puerto Rico,13188,995924,40,5030,0.5050586189307618
2022-09-11,PR,Puerto Rico,10193,1006117,33,5063,0.5032217922965222
2022-09-18,PR,Puerto Rico,8459,1014576,47,5110,0.5036586712084654
2022-09-25,PR,Puerto Rico,4188,1018764,49,5159,0.5063979488870828
2022-10-02,PR,Puerto Rico,5078,1023842,20,5179,0.505839768245491
2022-10-09,PR,Puerto Rico,5375,1029217,27,5206,0.5058214156975642
2022-10-16,PR,Puerto Rico,5811,1035028,29,5235,0.5057834184195983
2022-10-23,PR,Puerto Rico,7360,1042388,23,5258,0.5044187001385281
2022-10-30,PR,Puerto Rico,7747,1050135,17,5275,0.5023163688478148
2022-11-06,PR,Puerto Rico,8047,1058182,20,5295,0.5003865119610804
2022-11-13,PR,Puerto Rico,7865,1066047,23,5318,0.49885230200919845
2022-11-20,PR,Puerto Rico,8840,1074887,28,5346,0.4973546056469192
2022-11-27,PR,Puerto Rico,7259,1082146,36,5382,0.4973450902188799
2022-12-04,PR,Puerto Rico,12431,1094577,42,5424,0.49553389117439883
2022-12-11,PR,Puerto Rico,12129,1106706,38,5462,0.493536675503702
2022-12-18,PR,Puerto Rico,13058,1119764,39,5501,0.49126423067717845
2022-12-25,PR,Puerto Rico,11275,1131039,40,5541,0.48990353117797
2023-01-01,PR,Puerto Rico,10107,1141146,36,5577,0.4887192348744157
2023-01-08,PR,Puerto Rico,7978,1149124,37,5614,0.48854605769264237
2023-01-15,PR,Puerto Rico,11238,1160362,34,5648,0.48674465382354815
2023-01-22,PR,Puerto Rico,8830,1169192,34,5682,0.48597664027807236
2023-01-29,PR,Puerto Rico,8127,1177319,32,5714,0.48533999706111935
2023-02-05,PR,Puerto Rico,6087,1183406,29,5743,0.48529414250054503
2023-02-12,PR,Puerto Rico,5033,1188439,32,5775,0.4859315454979179
2023-02-19,PR,Puerto Rico,4574,1193013,23,5798,0.4859963805926675
2023-02-26,PR,Puerto Rico,3700,1196713,15,5813,0.48574720923061754
2023-03-05,PR,Puerto Rico,3062,1199775,17,5830,0.48592444416661457
2023-03-12,PR,Puerto Rico,3086,1202861,14,5844,0.4858416724791976
2023-03-19,PR,Puerto Rico,3026,1205887,11,5855,0.48553471428085715
2023-03-26,PR,Puerto Rico,3117,1209004,6,5861,0.4847792066858339
2023-04-02,PR,Puerto Rico,2775,1211779,7,5868,0.48424671495379934
2023-04-09,PR,Puerto Rico,1887,1213666,6,5874,0.4839881812623901
2023-04-16,PR,Puerto Rico,3211,1216877,8,5882,0.4833684916388427
2023-04-23,PR,Puerto Rico,3521,1220398,8,5890,0.48262943728193586
2023-04-30,PR,Puerto Rico,3968,1224366,11,5901,0.48196372653275243
2023-05-07,PR,Puerto Rico,5044,1229410,11,5912,0.4808810730350331
2023-05-14,PR,Puerto Rico,6240,1235650,15,5927,0.4796665722494234
2023-05-21,PR,Puerto Rico,6916,1242566,11,5938,0.47788206018835216
2023-05-28,PR,Puerto Rico,6903,1249469,0,5938,0.47524188275179297
2023-06-04,PR,Puerto Rico,3244,1252713,0,5938,0.47401120607832764
2023-06-11,PR,Puerto Rico,0,1252713,0,5938,0.47401120607832764
2023-06-18,PR,Puerto Rico,0,1252713,0,5938,0.47401120607832764
2023-06-25,PR,Puerto Rico,0,1252713,0,5938,0.47401120607832764
2023-07-02,PR,Puerto Rico,0,1252713,0,5938,0.47401120607832764
2023-07-09,PR,Puerto Rico,0,1252713,0,5938,0.47401120607832764
2023-07-16,PR,Puerto Rico,0,1252713,0,5938,0.47401120607832764
2023-07-23,PR,Puerto Rico,0,1252713,0,5938,0.47401120607832764
2023-07-30,PR,Puerto Rico,0,1252713,0,5938,0.47401120607832764
2023-08-06,PR,Puerto Rico,0,1252713,0,5938,0.47401120607832764
2023-08-13,PR,Puerto Rico,0,1252713,0,5938,0.47401120607832764
2023-08-20,PR,Puerto Rico,0,1252713,0,5938,0.47401120607832764
2023-08-27,PR,Puerto Rico,0,1252713,0,5938,0.47401120607832764
2023-09-03,PR,Puerto Rico,0,1252713,0,5938,0.47401120607832764
2023-09-10,PR,Puerto Rico,0,1252713,0,5938,0.47401120607832764
2023-09-17,PR,Puerto Rico,0,1252713,0,5938,0.47401120607832764
2023-09-24,PR,Puerto Rico,0,1252713,0,5938,0.47401120607832764
2023-10-01,PR,Puerto Rico,0,1252713,0,5938,0.47401120607832764
2023-10-08,PR,Puerto Rico,0,1252713,0,5938,0.47401120607832764
2023-10-15,PR,Puerto Rico,0,1252713,0,5938,0.47401120607832764
2023-10-22,PR,Puerto Rico,0,1252713,0,5938,0.47401120607832764
2023-10-29,PR,Puerto Rico,0,1252713,0,5938,0.47401120607832764
2023-11-05,PR,Puerto Rico,0,1252713,0,5938,0.47401120607832764
2023-11-12,PR,Puerto Rico,0,1252713,0,5938,0.47401120607832764
2023-11-19,PR,Puerto Rico,0,1252713,0,5938,0.47401120607832764
2023-11-26,PR,Puerto Rico,0,1252713,0,5938,0.47401120607832764
2023-12-03,PR,Puerto Rico,0,1252713,0,5938,0.47401120607832764
2023-12-10,PR,Puerto Rico,0,1252713,0,5938,0.47401120607832764
2023-12-17,PR,Puerto Rico,0,1252713,0,5938,0.47401120607832764
2023-12-24,PR,Puerto Rico,0,1252713,0,5938,0.47401120607832764
2023-12-31,PR,Puerto Rico,0,1252713,0,5938,0.47401120607832764
2024-01-07,PR,Puerto Rico,0,1252713,0,5938,0.47401120607832764
2024-01-14,PR,Puerto Rico,0,1252713,0,5938,0.47401120607832764
2020-04-05,QA,Qatar,735,1325,3,3,0.22641509433962265
2020-04-12,QA,Qatar,1403,2728,3,6,0.21994134897360706
2020-04-19,QA,Qatar,2280,5008,2,8,0.1597444089456869
2020-04-26,QA,Qatar,4350,9358,2,10,0.10686044026501389
2020-05-03,QA,Qatar,5514,14872,2,12,0.08068854222700376
2020-05-10,QA,Qatar,6459,21331,1,13,0.06094416576813089
2020-05-17,QA,Qatar,9641,30972,2,15,0.048430840759395584
2020-05-24,QA,Qatar,11241,42213,6,21,0.049747708052021895
2020-05-31,QA,Qatar,13049,55262,15,36,0.06514422206941478
2020-06-07,QA,Qatar,11933,67195,15,51,0.07589850435300245
2020-06-14,QA,Qatar,11221,78416,19,70,0.08926749642930014
2020-06-21,QA,Qatar,8072,86488,24,94,0.10868559800203496
2020-06-28,QA,Qatar,7175,93663,16,110,0.1174423198061134
2020-07-05,QA,Qatar,5520,99183,13,123,0.12401318774386741
2020-07-12,QA,Qatar,3945,103128,23,146,0.14157163912807386
2020-07-19,QA,Qatar,3180,106308,8,154,0.14486209880723935
2020-07-26,QA,Qatar,2728,109036,10,164,0.15040903921640558
2020-08-02,QA,Qatar,1875,110911,10,174,0.15688254546438135
2020-08-09,QA,Qatar,1739,112650,8,182,0.1615623612960497
2020-08-16,QA,Qatar,2159,114809,10,192,0.16723427605849717
2020-08-23,QA,Qatar,1956,116765,1,193,0.1652892561983471
2020-08-30,QA,Qatar,1642,118407,3,196,0.16553075409393025
2020-09-06,QA,Qatar,1457,119864,6,202,0.1685243275712474
2020-09-13,QA,Qatar,1659,121523,3,205,0.16869234630481472
2020-09-20,QA,Qatar,1623,123146,4,209,0.16971724619557274
2020-09-27,QA,Qatar,1704,124850,5,214,0.17140568682418902
2020-10-04,QA,Qatar,1489,126339,2,216,0.17096858452259397
2020-10-11,QA,Qatar,1439,127778,3,219,0.17139100627651083
2020-10-18,QA,Qatar,1449,129227,4,223,0.17256455694243464
2020-10-25,QA,Qatar,1738,130965,6,229,0.17485587752452944
2020-11-01,QA,Qatar,1591,132556,3,232,0.17502036874981142
2020-11-08,QA,Qatar,1457,134013,0,232,0.17311753337362792
2020-11-15,QA,Qatar,1557,135570,2,234,0.17260455853064838
2020-11-22,QA,Qatar,1492,137062,1,235,0.17145525382673535
2020-11-29,QA,Qatar,1415,138477,2,237,0.17114755518967048
2020-12-06,QA,Qatar,1306,139783,2,239,0.17097930363491984
2020-12-13,QA,Qatar,1044,140827,1,240,0.17042186512529559
2020-12-20,QA,Qatar,1031,141858,3,243,0.17129805862200229
2020-12-27,QA,Qatar,1045,142903,1,244,0.1707451907937552
2021-01-03,QA,Qatar,1337,144240,1,245,0.16985579589572933
2021-01-10,QA,Qatar,1432,145672,1,246,0.1688725355593388
2021-01-17,QA,Qatar,1417,147089,0,246,0.16724568118622057
2021-01-24,QA,Qatar,1683,148772,2,248,0.16669803457639878
2021-01-31,QA,Qatar,2212,150984,0,248,0.16425581518571505
2021-02-07,QA,Qatar,2706,153690,2,250,0.16266510508165788
2021-02-14,QA,Qatar,3114,156804,5,255,0.16262340246422285
2021-02-21,QA,Qatar,3163,159967,1,256,0.1600330068076541
2021-02-28,QA,Qatar,3230,163197,1,257,0.15747838501933245
2021-03-07,QA,Qatar,3278,166475,5,262,0.15738098813635681
2021-03-14,QA,Qatar,3292,169767,3,265,0.1560962966889914
2021-03-21,QA,Qatar,3439,173206,7,272,0.15703843977691304
2021-03-28,QA,Qatar,3929,177135,12,284,0.1603296920427922
2021-04-04,QA,Qatar,5413,182548,17,301,0.1648881390100138
2021-04-11,QA,Qatar,6516,189064,30,331,0.1750729911564338
2021-04-18,QA,Qatar,6693,195757,45,376,0.19207486833165607
2021-04-25,QA,Qatar,5739,201496,42,418,0.20744828681462663
2021-05-02,QA,Qatar,4806,206302,47,465,0.22539771790869695
2021-05-09,QA,Qatar,4301,210603,37,502,0.2383631762130644
2021-05-16,QA,Qatar,2324,212927,24,526,0.24703302070662714
2021-05-23,QA,Qatar,2233,215160,17,543,0.25237032905744566
2021-05-30,QA,Qatar,1881,217041,11,554,0.25525131196409895
2021-06-06,QA,Qatar,1414,218455,12,566,0.25909226156416654
2021-06-13,QA,Qatar,1158,219613,10,576,0.2622795553997259
2021-06-20,QA,Qatar,1080,220693,6,582,0.26371475307327374
2021-06-27,QA,Qatar,897,221590,6,588,0.2653549347894761
2021-07-04,QA,Qatar,863,222453,4,592,0.2661236306096119
2021-07-11,QA,Qatar,819,223272,7,599,0.26828263284245224
2021-07-18,QA,Qatar,888,224160,0,599,0.2672198429693076
2021-07-25,QA,Qatar,912,225072,1,600,0.2665813606312647
2021-08-01,QA,Qatar,1167,226239,1,601,0.2656482746122463
2021-08-08,QA,Qatar,1233,227472,0,601,0.2642083421256243
2021-08-15,QA,Qatar,1509,228981,0,601,0.26246719160104987
2021-08-22,QA,Qatar,1651,230632,0,601,0.2605882965069895
2021-08-29,QA,Qatar,1555,232187,1,602,0.2592737750175505
2021-09-05,QA,Qatar,1250,233437,0,602,0.25788542518966573
2021-09-12,QA,Qatar,1072,234509,2,604,0.25755941136587507
2021-09-19,QA,Qatar,877,235386,0,604,0.2565997977789673
2021-09-26,QA,Qatar,845,236231,0,604,0.2556819384416101
2021-10-03,QA,Qatar,603,236834,2,606,0.25587542329226376
2021-10-10,QA,Qatar,525,237359,1,607,0.2557307706891249
2021-10-17,QA,Qatar,508,237867,1,608,0.25560502297502385
2021-10-24,QA,Qatar,569,238436,0,608,0.25499505108289017
2021-10-31,QA,Qatar,707,239143,2,610,0.2550775059274158
2021-11-07,QA,Qatar,852,239995,1,611,0.2545886372632763
2021-11-14,QA,Qatar,970,240965,0,611,0.253563795571971
2021-11-21,QA,Qatar,1004,241969,0,611,0.2525116853811852
2021-11-28,QA,Qatar,1010,242979,0,611,0.25146206050728664
2021-12-05,QA,Qatar,1092,244071,0,611,0.2503369921047564
2021-12-12,QA,Qatar,1117,245188,1,612,0.2496043852064538
2021-12-19,QA,Qatar,1179,246367,2,614,0.24922168959316793
2021-12-26,QA,Qatar,1429,247796,0,614,0.2477844678687307
2022-01-02,QA,Qatar,3565,251361,4,618,0.2458615298315968
2022-01-09,QA,Qatar,15601,266962,0,618,0.23149362081494743
2022-01-16,QA,Qatar,28259,295221,6,624,0.2113670775452966
2022-01-23,QA,Qatar,25143,320364,9,633,0.19758774394126682
2022-01-30,QA,Qatar,15717,336081,12,645,0.19191801976309283
2022-02-06,QA,Qatar,8630,344711,7,652,0.1891439495693494
2022-02-13,QA,Qatar,5477,350188,4,656,0.18732794955852286
2022-02-20,QA,Qatar,3592,353780,6,662,0.18712194018881792
2022-02-27,QA,Qatar,2583,356363,5,667,0.18716870157676302
2022-03-06,QA,Qatar,1720,358083,3,670,0.18710745832670078
2022-03-13,QA,Qatar,945,359028,5,675,0.188007620575554
2022-03-20,QA,Qatar,778,359806,2,677,0.1881569512459492
2022-03-27,QA,Qatar,898,360704,0,677,0.18768852022711144
2022-04-03,QA,Qatar,963,361667,0,677,0.18718876756795616
2022-04-10,QA,Qatar,956,362623,0,677,0.18669527305217815
2022-04-17,QA,Qatar,820,363443,0,677,0.18627405122673982
2022-04-24,QA,Qatar,646,364089,0,677,0.18594354677015784
2022-05-01,QA,Qatar,513,364602,0,677,0.18568192165703973
2022-05-08,QA,Qatar,456,365058,0,677,0.18544998329032647
2022-05-15,QA,Qatar,976,366034,0,677,0.18495549593753588
2022-05-22,QA,Qatar,918,366952,0,677,0.18449279469794413
2022-05-29,QA,Qatar,1135,368087,0,677,0.1839239092931834
2022-06-05,QA,Qatar,1549,369636,0,677,0.1831531560778712
2022-06-12,QA,Qatar,2210,371846,0,677,0.18206461814837324
2022-06-19,QA,Qatar,3077,374923,1,678,0.18083713189108164
2022-06-26,QA,Qatar,4354,379277,0,678,0.17876116927733554
2022-07-03,QA,Qatar,4530,383807,1,679,0.17691183329121146
2022-07-10,QA,Qatar,4574,388381,0,679,0.17482832579348628
2022-07-17,QA,Qatar,5453,393834,1,680,0.17266157822839065
2022-07-24,QA,Qatar,7488,401322,0,680,0.1694400007973647
2022-07-31,QA,Qatar,6427,407749,1,681,0.1670145113783234
2022-08-07,QA,Qatar,5740,413489,0,681,0.1646960378631596
2022-08-14,QA,Qatar,5133,418622,0,681,0.1626765912923831
2022-08-21,QA,Qatar,4496,423118,0,681,0.16094800977505092
2022-08-28,QA,Qatar,3883,427001,0,681,0.15948440401778918
2022-09-04,QA,Qatar,3944,430945,0,681,0.15802480594971516
2022-09-11,QA,Qatar,4247,435192,1,682,0.15671243956690378
2022-09-18,QA,Qatar,5388,440580,0,682,0.15479595079213765
2022-09-25,QA,Qatar,5697,446277,0,682,0.15281988540749356
2022-10-02,QA,Qatar,5398,451675,0,682,0.15099352410472133
2022-10-09,QA,Qatar,5144,456819,0,682,0.14929326494738615
2022-10-16,QA,Qatar,4579,461398,0,682,0.1478116506790233
2022-10-23,QA,Qatar,3732,465130,2,684,0.1470556618579752
2022-10-30,QA,Qatar,3172,468302,0,684,0.14605959402266058
2022-11-06,QA,Qatar,2702,471004,0,684,0.1452216966310265
2022-11-13,QA,Qatar,2436,473440,0,684,0.1444744846231835
2022-11-20,QA,Qatar,2186,475626,0,684,0.14381047293461668
2022-11-27,QA,Qatar,1794,477420,1,685,0.14347953583846507
2022-12-04,QA,Qatar,2679,480099,0,685,0.14267890580901024
2022-12-11,QA,Qatar,3722,483821,0,685,0.14158128729426794
2022-12-18,QA,Qatar,2406,486227,0,685,0.14088069975546402
2022-12-25,QA,Qatar,1760,487987,0,685,0.1403725918928168
2023-01-01,QA,Qatar,1441,489428,0,685,0.13995929942708632
2023-01-08,QA,Qatar,1065,490493,0,685,0.13965540792631087
2023-01-15,QA,Qatar,811,491304,0,685,0.1394248774689398
2023-01-22,QA,Qatar,606,491910,1,686,0.13945640462686262
2023-01-29,QA,Qatar,344,492254,0,686,0.13935894883535735
2023-02-05,QA,Qatar,341,492595,0,686,0.13926247728864483
2023-02-12,QA,Qatar,330,492925,0,686,0.1391692448141198
2023-02-19,QA,Qatar,427,493352,0,686,0.1390487927483825
2023-02-26,QA,Qatar,372,493724,0,686,0.1389440254069075
2023-03-05,QA,Qatar,653,494377,1,687,0.1389627753718316
2023-03-12,QA,Qatar,713,495090,1,688,0.1389646326930457
2023-03-19,QA,Qatar,766,495856,0,688,0.13874995966570938
2023-03-26,QA,Qatar,2056,497912,0,688,0.13817702726586226
2023-04-02,QA,Qatar,1939,499851,0,688,0.13764101702307288
2023-04-09,QA,Qatar,2257,502108,0,688,0.13702231392449432
2023-04-16,QA,Qatar,2744,504852,2,690,0.13667371823821634
2023-04-23,QA,Qatar,1471,506323,0,690,0.1362766455404949
2023-04-30,QA,Qatar,1684,508007,0,690,0.13582490005058984
2023-05-07,QA,Qatar,1433,509440,0,690,0.1354428391959799
2023-05-14,QA,Qatar,1539,510979,0,690,0.13503490358703585
2023-05-21,QA,Qatar,953,511932,0,690,0.13478352593703852
2023-05-28,QA,Qatar,1183,513115,0,690,0.13447277900665544
2023-06-04,QA,Qatar,465,513580,0,690,0.13435102613030103
2023-06-11,QA,Qatar,465,514045,0,690,0.1342294935268313
2023-06-18,QA,Qatar,291,514336,0,690,0.13415354943072233
2023-06-25,QA,Qatar,188,514524,0,690,0.1341045315670406
2023-07-02,QA,Qatar,0,514524,0,690,0.1341045315670406
2023-07-09,QA,Qatar,0,514524,0,690,0.1341045315670406
2023-07-16,QA,Qatar,0,514524,0,690,0.1341045315670406
2023-07-23,QA,Qatar,0,514524,0,690,0.1341045315670406
2023-07-30,QA,Qatar,0,514524,0,690,0.1341045315670406
2023-08-06,QA,Qatar,0,514524,0,690,0.1341045315670406
2023-08-13,QA,Qatar,0,514524,0,690,0.1341045315670406
2023-08-20,QA,Qatar,0,514524,0,690,0.1341045315670406
2023-08-27,QA,Qatar,0,514524,0,690,0.1341045315670406
2023-09-03,QA,Qatar,0,514524,0,690,0.1341045315670406
2023-09-10,QA,Qatar,0,514524,0,690,0.1341045315670406
2023-09-17,QA,Qatar,0,514524,0,690,0.1341045315670406
2023-09-24,QA,Qatar,0,514524,0,690,0.1341045315670406
2023-10-01,QA,Qatar,0,514524,0,690,0.1341045315670406
2023-10-08,QA,Qatar,0,514524,0,690,0.1341045315670406
2023-10-15,QA,Qatar,0,514524,0,690,0.1341045315670406
2023-10-22,QA,Qatar,0,514524,0,690,0.1341045315670406
2023-10-29,QA,Qatar,0,514524,0,690,0.1341045315670406
2023-11-05,QA,Qatar,0,514524,0,690,0.1341045315670406
2023-11-12,QA,Qatar,0,514524,0,690,0.1341045315670406
2023-11-19,QA,Qatar,0,514524,0,690,0.1341045315670406
2023-11-26,QA,Qatar,0,514524,0,690,0.1341045315670406
2023-12-03,QA,Qatar,0,514524,0,690,0.1341045315670406
2023-12-10,QA,Qatar,0,514524,0,690,0.1341045315670406
2023-12-17,QA,Qatar,0,514524,0,690,0.1341045315670406
2023-12-24,QA,Qatar,0,514524,0,690,0.1341045315670406
2023-12-31,QA,Qatar,0,514524,0,690,0.1341045315670406
2024-01-07,QA,Qatar,0,514524,0,690,0.1341045315670406
2024-01-14,QA,Qatar,0,514524,0,690,0.1341045315670406
2020-02-23,KR,Republic of Korea,526,556,3,3,0.539568345323741
2020-03-01,KR,Republic of Korea,2970,3526,14,17,0.4821327283040272
2020-03-08,KR,Republic of Korea,3608,7134,33,50,0.7008690776562938
2020-03-15,KR,Republic of Korea,1028,8162,25,75,0.9188924283263906
2021-08-15,KR,Republic of Korea,13034,225481,42,2167,0.9610565856990168
2021-08-22,KR,Republic of Korea,12297,237778,55,2222,0.934485107957843
2021-08-29,KR,Republic of Korea,12271,250049,62,2284,0.91342096948998
2021-09-05,KR,Republic of Korea,11728,261777,43,2327,0.8889245426450757
2021-09-12,KR,Republic of Korea,12636,274413,33,2360,0.8600175647655176
2021-09-19,KR,Republic of Korea,13121,287534,49,2409,0.8378139628704779
2021-09-26,KR,Republic of Korea,16019,303553,47,2456,0.8090844103006725
2021-10-03,KR,Republic of Korea,16224,319777,57,2513,0.7858601462894456
2021-10-10,KR,Republic of Korea,13039,332816,70,2583,0.7761045142060479
2021-10-17,KR,Republic of Korea,10629,343445,85,2668,0.7768347188050488
2021-10-24,KR,Republic of Korea,9644,353089,105,2773,0.7853544007318268
2021-10-31,KR,Republic of Korea,13296,366385,86,2859,0.7803267055146907
2021-11-07,KR,Republic of Korea,15307,381692,121,2980,0.7807342045418819
2021-11-14,KR,Republic of Korea,15774,397466,135,3115,0.7837148334700327
2021-11-21,KR,Republic of Korea,20785,418251,183,3298,0.7885217249928871
2021-11-28,KR,Republic of Korea,25947,444198,282,3580,0.8059468975546941
2021-12-05,KR,Republic of Korea,33158,477356,313,3893,0.8155338992282488
2021-12-12,KR,Republic of Korea,45729,523085,400,4293,0.8207079155395395
2021-12-19,KR,Republic of Korea,47328,570413,483,4776,0.8372880702228035
2021-12-26,KR,Republic of Korea,41254,611667,524,5300,0.866484541425318
2022-01-02,KR,Republic of Korea,30535,642202,430,5730,0.8922426277090386
2022-01-09,KR,Republic of Korea,25184,667386,341,6071,0.9096684677233265
2022-01-16,KR,Republic of Korea,28644,696030,262,6333,0.9098745743717943
2022-01-23,KR,Republic of Korea,45378,741408,232,6565,0.8854773619923173
2022-01-30,KR,Republic of Korea,104291,845699,190,6755,0.7987475449302884
2022-02-06,KR,Republic of Korea,199263,1044962,131,6886,0.6589713310149077
2022-02-13,KR,Republic of Korea,360282,1405244,216,7102,0.5053926577875444
2022-02-20,KR,Republic of Korea,652917,2058161,348,7450,0.36197362596998
2022-02-27,KR,Republic of Korea,1076295,3134456,608,8058,0.2570781022289035
2022-03-06,KR,Republic of Korea,1532514,4666970,1038,9096,0.1949016171091736
2022-03-13,KR,Republic of Korea,2199242,6866212,1499,10595,0.15430633368151173
2022-03-20,KR,Republic of Korea,2716348,9582560,2162,12757,0.13312726453056387
2022-03-27,KR,Republic of Korea,2420314,12002874,2429,15186,0.12651969853220152
2022-04-03,KR,Republic of Korea,1998392,14001266,2267,17453,0.1246530135203488
2022-04-10,KR,Republic of Korea,1423253,15424519,2226,19679,0.1275825845849715
2022-04-17,KR,Republic of Korea,928917,16353436,1545,21224,0.12978312325311941
2022-04-24,KR,Republic of Korea,576068,16929504,1019,22243,0.13138601107274023
2022-05-01,KR,Republic of Korea,366118,17295622,715,22958,0.13273879366697536
2022-05-08,KR,Republic of Korea,269340,17564962,442,23400,0.13321975874471007
2022-05-15,KR,Republic of Korea,230350,17795312,344,23744,0.1334283995695046
2022-05-22,KR,Republic of Korea,172329,17967641,243,23987,0.13350110902149034
2022-05-29,KR,Republic of Korea,118806,18086447,180,24167,0.13361938914812843
2022-06-05,KR,Republic of Korea,82261,18168708,132,24299,0.13374093523876326
2022-06-12,KR,Republic of Korea,60570,18229278,91,24390,0.133795754280559
2022-06-19,KR,Republic of Korea,50785,18280063,73,24463,0.1338233899959754
2022-06-26,KR,Republic of Korea,49360,18329423,67,24530,0.13382854441189992
2022-07-03,KR,Republic of Korea,60188,18389611,46,24576,0.13364067353028838
2022-07-10,KR,Republic of Korea,122234,18511845,92,24668,0.1332552211840581
2022-07-17,KR,Republic of Korea,249912,18761757,97,24765,0.13199723245536119
2022-07-24,KR,Republic of Korea,449856,19211613,142,24907,0.1296455430369121
2022-07-31,KR,Republic of Korea,564437,19776050,177,25084,0.12684029419424
2022-08-07,KR,Republic of Korea,713078,20489128,248,25332,0.12363630116420767
2022-08-14,KR,Republic of Korea,866830,21355958,378,25710,0.12038794981709554
2022-08-21,KR,Republic of Korea,884373,22240331,451,26161,0.11762864500532838
2022-08-28,KR,Republic of Korea,743487,22983818,528,26689,0.11612082901108944
2022-09-04,KR,Republic of Korea,585374,23569192,504,27193,0.11537518978164377
2022-09-11,KR,Republic of Korea,435695,24004887,340,27533,0.11469747805936349
2022-09-18,KR,Republic of Korea,389579,24394466,358,27891,0.11433330821834756
2022-09-25,KR,Republic of Korea,225662,24620128,381,28272,0.11483287170562233
2022-10-02,KR,Republic of Korea,199483,24819611,256,28528,0.11494136632520147
2022-10-09,KR,Republic of Korea,151178,24970789,180,28708,0.11496633126009755
2022-10-16,KR,Republic of Korea,149676,25120465,148,28856,0.11487048508059065
2022-10-23,KR,Republic of Korea,176869,25297334,161,29017,0.11470378657292503
2022-10-30,KR,Republic of Korea,241465,25538799,213,29230,0.11445330690765841
2022-11-06,KR,Republic of Korea,299440,25838239,190,29420,0.11386224889397455
2022-11-13,KR,Republic of Korea,355990,26194229,328,29748,0.11356699981511194
2022-11-20,KR,Republic of Korea,364536,26558765,363,30111,0.1133750006824489
2022-11-27,KR,Republic of Korea,378751,26937516,343,30454,0.11305422519285
2022-12-04,KR,Republic of Korea,370574,27308090,339,30793,0.11276145640357858
2022-12-11,KR,Republic of Korea,420392,27728482,335,31128,0.11226002202356408
2022-12-18,KR,Republic of Korea,459811,28188293,362,31490,0.11171304342551003
2022-12-25,KR,Republic of Korea,470762,28659055,392,31882,0.11124581742140485
2023-01-01,KR,Republic of Korea,457745,29116800,419,32301,0.11093595450049455
2023-01-08,KR,Republic of Korea,403800,29520600,195,32496,0.11007906343367005
2023-01-15,KR,Republic of Korea,286291,29806891,0,32496,0.10902176949618798
2023-01-22,KR,Republic of Korea,192638,29999529,0,32496,0.10832170065070022
2023-01-29,KR,Republic of Korea,150072,30149601,0,32496,0.10778252090301295
2023-02-05,KR,Republic of Korea,107810,30257411,1118,33614,0.11109344418132801
2023-02-12,KR,Republic of Korea,92788,30350199,133,33747,0.11119202216763059
2023-02-19,KR,Republic of Korea,79372,30429571,118,33865,0.11128977138718124
2023-02-26,KR,Republic of Korea,69307,30498878,96,33961,0.11135163726350851
2023-03-05,KR,Republic of Korea,66037,30564915,73,34034,0.11134989251565071
2023-03-12,KR,Republic of Korea,69816,30634731,81,34115,0.11136053389860026
2023-03-19,KR,Republic of Korea,64299,30699030,56,34171,0.11130970587670033
2023-03-26,KR,Republic of Korea,70226,30769256,52,34223,0.11122465879577978
2023-04-02,KR,Republic of Korea,71121,30840377,58,34281,0.11115622873222335
2023-04-09,KR,Republic of Korea,73678,30914055,51,34332,0.11105628168158463
2023-04-16,KR,Republic of Korea,75087,30989142,44,34376,0.11092917641927615
2023-04-23,KR,Republic of Korea,89417,31078559,51,34427,0.11077411922476843
2023-04-30,KR,Republic of Korea,92327,31170886,60,34487,0.11063849773150496
2023-05-07,KR,Republic of Korea,106860,31277746,47,34534,0.11041076936937846
2023-05-14,KR,Republic of Korea,130356,31408102,76,34610,0.1101944969485899
2023-05-21,KR,Republic of Korea,133183,31541285,77,34687,0.10997332543680449
2023-05-28,KR,Republic of Korea,105688,31646973,67,34754,0.10981776993332032
2023-06-04,KR,Republic of Korea,100866,31747839,73,34827,0.1096988050115789
2023-06-11,KR,Republic of Korea,135758,31883597,66,34893,0.10943871859878293
2023-06-18,KR,Republic of Korea,21070,31904667,67,34960,0.10957644535202327
2023-06-25,KR,Republic of Korea,113819,32018486,57,35017,0.10936494623762036
2023-07-02,KR,Republic of Korea,113120,32131606,54,35071,0.10914798345280347
2023-07-09,KR,Republic of Korea,124548,32256154,0,35071,0.10872653943802477
2023-07-16,KR,Republic of Korea,150444,32406598,88,35159,0.10849333830104599
2023-07-23,KR,Republic of Korea,204911,32611509,57,35216,0.10798641669724637
2023-07-30,KR,Republic of Korea,271581,32883090,97,35313,0.1073895427710717
2023-08-06,KR,Republic of Korea,651129,33534219,98,35411,0.10559661461028809
2023-08-13,KR,Republic of Korea,81573,33615792,0,35411,0.10534037097802128
2023-08-20,KR,Republic of Korea,281745,33897537,146,35557,0.10489552677529344
2023-08-27,KR,Republic of Korea,282263,34179800,255,35812,0.10477533513946834
2023-09-03,KR,Republic of Korea,256742,34436542,0,35812,0.10399418152960886
2023-09-10,KR,Republic of Korea,135331,34571873,122,35934,0.10393998612687255
2023-09-17,KR,Republic of Korea,0,34571873,0,35934,0.10393998612687255
2023-09-24,KR,Republic of Korea,0,34571873,0,35934,0.10393998612687255
2023-10-01,KR,Republic of Korea,0,34571873,0,35934,0.10393998612687255
2023-10-08,KR,Republic of Korea,0,34571873,0,35934,0.10393998612687255
2023-10-15,KR,Republic of Korea,0,34571873,0,35934,0.10393998612687255
2023-10-22,KR,Republic of Korea,0,34571873,0,35934,0.10393998612687255
2023-10-29,KR,Republic of Korea,0,34571873,0,35934,0.10393998612687255
2023-11-05,KR,Republic of Korea,0,34571873,0,35934,0.10393998612687255
2023-11-12,KR,Republic of Korea,0,34571873,0,35934,0.10393998612687255
2023-11-19,KR,Republic of Korea,0,34571873,0,35934,0.10393998612687255
2023-11-26,KR,Republic of Korea,0,34571873,0,35934,0.10393998612687255
2023-12-03,KR,Republic of Korea,0,34571873,0,35934,0.10393998612687255
2023-12-10,KR,Republic of Korea,0,34571873,0,35934,0.10393998612687255
2023-12-17,KR,Republic of Korea,0,34571873,0,35934,0.10393998612687255
2023-12-24,KR,Republic of Korea,0,34571873,0,35934,0.10393998612687255
2023-12-31,KR,Republic of Korea,0,34571873,0,35934,0.10393998612687255
2024-01-07,KR,Republic of Korea,0,34571873,0,35934,0.10393998612687255
2024-01-14,KR,Republic of Korea,0,34571873,0,35934,0.10393998612687255
2020-03-29,MD,Republic of Moldova,151,231,1,2,0.8658008658008658
2020-05-24,RE,Réunion,9,452,1,1,0.22123893805309736
2020-05-31,RE,Réunion,19,471,0,1,0.21231422505307856
2020-06-07,RE,Réunion,9,480,0,1,0.20833333333333334
2020-06-14,RE,Réunion,9,489,0,1,0.2044989775051125
2020-06-21,RE,Réunion,16,505,0,1,0.19801980198019803
2020-06-28,RE,Réunion,15,520,1,2,0.38461538461538464
2020-07-05,RE,Réunion,16,536,0,2,0.3731343283582089
2020-07-12,RE,Réunion,41,577,1,3,0.5199306759098787
2020-07-19,RE,Réunion,47,624,0,3,0.4807692307692308
2020-07-26,RE,Réunion,33,657,0,3,0.45662100456621
2020-08-02,RE,Réunion,7,664,1,4,0.6024096385542169
2020-08-09,RE,Réunion,17,681,1,5,0.7342143906020557
2020-08-16,RE,Réunion,107,788,0,5,0.6345177664974619
2020-08-23,RE,Réunion,329,1117,1,6,0.5371530886302597
2020-08-30,RE,Réunion,440,1557,-3,3,0.1926782273603083
2020-09-06,RE,Réunion,558,2115,3,6,0.28368794326241137
2020-09-13,RE,Réunion,608,2723,4,10,0.3672420124862284
2020-09-20,RE,Réunion,471,3194,0,10,0.31308703819661865
2020-09-27,RE,Réunion,491,3685,1,11,0.2985074626865672
2020-10-04,RE,Réunion,493,4178,5,16,0.3829583532790809
2020-10-11,RE,Réunion,313,4491,0,16,0.3562680917390336
2020-10-18,RE,Réunion,285,4776,1,17,0.35594639865996647
2020-10-25,RE,Réunion,373,5149,3,20,0.38842493688094776
2020-11-01,RE,Réunion,510,5659,2,22,0.3887612652412087
2020-11-08,RE,Réunion,605,6264,5,27,0.43103448275862066
2020-11-15,RE,Réunion,617,6881,2,29,0.4214503705856707
2020-11-22,RE,Réunion,620,7501,6,35,0.46660445273963475
2020-11-29,RE,Réunion,439,7940,5,40,0.5037783375314862
2020-12-06,RE,Réunion,260,8200,1,41,0.5
2020-12-13,RE,Réunion,145,8345,0,41,0.4913121629718394
2020-12-20,RE,Réunion,359,8704,1,42,0.48253676470588236
2020-12-27,RE,Réunion,205,8909,0,42,0.4714333819732855
2021-01-03,RE,Réunion,128,9037,0,42,0.46475600309837334
2021-01-10,RE,Réunion,210,9247,0,42,0.45420136260408783
2021-01-17,RE,Réunion,196,9443,3,45,0.47654347135444247
2021-01-24,RE,Réunion,258,9701,0,45,0.4638697041542109
2021-01-31,RE,Réunion,295,9996,1,46,0.4601840736294518
2021-02-07,RE,Réunion,491,10487,1,47,0.4481739296271574
2021-02-14,RE,Réunion,420,10907,0,47,0.4309159255523975
2021-02-21,RE,Réunion,655,11562,1,48,0.4151530877010898
2021-02-28,RE,Réunion,854,12416,4,52,0.41881443298969073
2021-03-07,RE,Réunion,709,13125,7,59,0.44952380952380955
2021-03-14,RE,Réunion,676,13801,12,71,0.514455474240997
2021-03-21,RE,Réunion,830,14631,16,87,0.5946278449866721
2021-03-28,RE,Réunion,930,15561,15,102,0.6554848660111818
2021-04-04,RE,Réunion,1025,16586,13,115,0.6933558422766188
2021-04-11,RE,Réunion,922,17508,8,123,0.7025359835503769
2021-04-18,RE,Réunion,917,18425,12,135,0.7327001356852103
2021-04-25,RE,Réunion,918,19343,6,141,0.7289458718916404
2021-05-02,RE,Réunion,1038,20381,7,148,0.7261665276482999
2021-05-09,RE,Réunion,1070,21451,2,150,0.6992680993893058
2021-05-16,RE,Réunion,1193,22644,19,169,0.7463345698639817
2021-05-23,RE,Réunion,922,23566,7,176,0.746838665874565
2021-05-30,RE,Réunion,1335,24901,13,189,0.7590056624231958
2021-06-06,RE,Réunion,1174,26075,14,203,0.7785234899328859
2021-06-13,RE,Réunion,1160,27235,9,212,0.7784101340187259
2021-06-20,RE,Réunion,1206,28441,8,220,0.7735311697900917
2021-06-27,RE,Réunion,1061,29502,6,226,0.76604975933835
2021-07-04,RE,Réunion,1081,30583,11,237,0.7749403263250826
2021-07-11,RE,Réunion,1262,31845,7,244,0.7662113361595226
2021-07-18,RE,Réunion,1450,33295,12,256,0.7688842168493768
2021-07-25,RE,Réunion,1320,34615,10,266,0.7684529828109201
2021-08-01,RE,Réunion,2616,37231,9,275,0.7386317853401736
2021-08-08,RE,Réunion,3014,40245,13,288,0.7156168468132688
2021-08-15,RE,Réunion,3590,43835,10,298,0.6798220599977187
2021-08-22,RE,Réunion,2919,46754,12,310,0.6630448731659323
2021-08-29,RE,Réunion,1929,48683,22,332,0.6819629028613684
2021-09-05,RE,Réunion,1663,50346,10,342,0.6792992491955666
2021-09-12,RE,Réunion,1305,51651,12,354,0.6853691119242609
2021-09-19,RE,Réunion,992,52643,4,358,0.6800524286229889
2021-09-26,RE,Réunion,598,53241,5,363,0.6818053755564321
2021-10-03,RE,Réunion,0,53241,3,366,0.6874401307263199
2021-10-10,RE,Réunion,722,53963,3,369,0.6838018642403129
2021-10-17,RE,Réunion,61,54024,1,370,0.6848807937213091
2021-10-24,RE,Réunion,414,54438,2,372,0.6833461919982365
2021-10-31,RE,Réunion,230,54668,2,374,0.6841296553742592
2021-11-07,RE,Réunion,457,55125,2,376,0.6820861678004535
2021-11-14,RE,Réunion,740,55865,0,376,0.6730511053432382
2021-11-21,RE,Réunion,1308,57173,3,379,0.6629003200811572
2021-11-28,RE,Réunion,1875,59048,2,381,0.6452377726595312
2021-12-05,RE,Réunion,2140,61188,3,384,0.6275740341243381
2021-12-12,RE,Réunion,2675,63863,7,391,0.6122480935753096
2021-12-19,RE,Réunion,3374,67237,2,393,0.5844996058717671
2021-12-26,RE,Réunion,4558,71795,8,401,0.5585347169022912
2022-01-02,RE,Réunion,4807,76602,8,409,0.533928618051748
2022-01-09,RE,Réunion,9358,85960,10,419,0.4874360167519777
2022-01-16,RE,Réunion,16256,102216,16,435,0.4255693824841512
2022-01-23,RE,Réunion,31401,133617,27,462,0.3457643862682144
2022-01-30,RE,Réunion,46914,180531,38,500,0.27696074358420436
2022-02-06,RE,Réunion,45474,226005,31,531,0.23495055419127894
2022-02-13,RE,Réunion,30782,256787,34,565,0.22002671474802074
2022-02-20,RE,Réunion,21707,278494,38,603,0.21652172039613063
2022-02-27,RE,Réunion,13632,292126,37,640,0.21908354614104875
2022-03-06,RE,Réunion,10036,302162,26,666,0.22041156730495562
2022-03-13,RE,Réunion,8019,310181,14,680,0.21922683852331382
2022-03-20,RE,Réunion,8514,318695,9,689,0.21619416683663065
2022-03-27,RE,Réunion,8494,327189,13,702,0.21455489029276656
2022-04-03,RE,Réunion,9756,336945,7,709,0.21042009823561708
2022-04-10,RE,Réunion,10996,347941,11,720,0.2069316349610997
2022-04-17,RE,Réunion,12504,360445,11,731,0.20280486620704963
2022-04-24,RE,Réunion,13850,374295,11,742,0.19823935665718218
2022-05-01,RE,Réunion,12889,387184,7,749,0.193448076366792
2022-05-08,RE,Réunion,10931,398115,7,756,0.18989487962021023
2022-05-15,RE,Réunion,7865,405980,6,762,0.1876939750726637
2022-05-22,RE,Réunion,5383,411363,8,770,0.18718261000624753
2022-05-29,RE,Réunion,3252,414615,7,777,0.1874027712456134
2022-06-05,RE,Réunion,2046,416661,7,784,0.18816255901080253
2022-06-12,RE,Réunion,1924,418585,12,796,0.19016448272154998
2022-06-19,RE,Réunion,1383,419968,3,799,0.19025259067357514
2022-06-26,RE,Réunion,1301,421269,8,807,0.19156406001865792
2022-07-03,RE,Réunion,1500,422769,5,812,0.19206706262758147
2022-07-10,RE,Réunion,2869,425638,7,819,0.19241703043431274
2022-07-17,RE,Réunion,3599,429237,6,825,0.1922015110533342
2022-07-24,RE,Réunion,4235,433472,6,831,0.19170788424627197
2022-07-31,RE,Réunion,5687,439159,7,838,0.1908192704692378
2022-08-07,RE,Réunion,5823,444982,7,845,0.18989532160851452
2022-08-14,RE,Réunion,4590,449572,8,853,0.18973601558815942
2022-08-21,RE,Réunion,5093,454665,2,855,0.18805054270726798
2022-08-28,RE,Réunion,5711,460376,6,861,0.18702104366865346
2022-09-04,RE,Réunion,7014,467390,13,874,0.18699587068615076
2022-09-11,RE,Réunion,4661,472051,5,879,0.18620869355217973
2022-09-18,RE,Réunion,2572,474623,5,884,0.18625308929402917
2022-09-25,RE,Réunion,1325,475948,6,890,0.18699521796498778
2022-10-02,RE,Réunion,623,476571,3,893,0.18738026443069344
2022-10-09,RE,Réunion,356,476927,1,894,0.18745007097522262
2022-10-16,RE,Réunion,336,477263,2,896,0.18773715959544318
2022-10-23,RE,Réunion,340,477603,2,898,0.188022269541858
2022-10-30,RE,Réunion,356,477959,1,899,0.18809144717433923
2022-11-06,RE,Réunion,387,478346,0,899,0.1879392740819407
2022-11-13,RE,Réunion,509,478855,0,899,0.1877395036075639
2022-11-20,RE,Réunion,575,479430,3,902,0.18814008301524726
2022-11-27,RE,Réunion,893,480323,0,902,0.18779029944433226
2022-12-04,RE,Réunion,1217,481540,1,903,0.1875233625451676
2022-12-11,RE,Réunion,1366,482906,2,905,0.187407073012139
2022-12-18,RE,Réunion,1830,484736,0,905,0.18669956429891735
2022-12-25,RE,Réunion,1923,486659,1,906,0.1861673163344354
2023-01-01,RE,Réunion,1849,488508,1,907,0.18566737903985195
2023-01-08,RE,Réunion,2104,490612,4,911,0.18568644876195445
2023-01-15,RE,Réunion,1213,491825,4,915,0.18604178315457734
2023-01-22,RE,Réunion,995,492820,1,916,0.1858690799886368
2023-01-29,RE,Réunion,1082,493902,3,919,0.18606930119740353
2023-02-05,RE,Réunion,693,494595,2,921,0.18621296212052285
2023-02-12,RE,Réunion,0,494595,0,921,0.18621296212052285
2023-02-19,RE,Réunion,0,494595,0,921,0.18621296212052285
2023-02-26,RE,Réunion,0,494595,0,921,0.18621296212052285
2023-03-05,RE,Réunion,0,494595,0,921,0.18621296212052285
2023-03-12,RE,Réunion,0,494595,0,921,0.18621296212052285
2023-03-19,RE,Réunion,0,494595,0,921,0.18621296212052285
2023-03-26,RE,Réunion,0,494595,0,921,0.18621296212052285
2023-04-02,RE,Réunion,0,494595,0,921,0.18621296212052285
2023-04-09,RE,Réunion,0,494595,0,921,0.18621296212052285
2023-04-16,RE,Réunion,0,494595,0,921,0.18621296212052285
2023-04-23,RE,Réunion,0,494595,0,921,0.18621296212052285
2023-04-30,RE,Réunion,0,494595,0,921,0.18621296212052285
2023-05-07,RE,Réunion,0,494595,0,921,0.18621296212052285
2023-05-14,RE,Réunion,0,494595,0,921,0.18621296212052285
2023-05-21,RE,Réunion,0,494595,0,921,0.18621296212052285
2023-05-28,RE,Réunion,0,494595,0,921,0.18621296212052285
2023-06-04,RE,Réunion,0,494595,0,921,0.18621296212052285
2023-06-11,RE,Réunion,0,494595,0,921,0.18621296212052285
2023-06-18,RE,Réunion,0,494595,0,921,0.18621296212052285
2023-06-25,RE,Réunion,0,494595,0,921,0.18621296212052285
2023-07-02,RE,Réunion,0,494595,0,921,0.18621296212052285
2023-07-09,RE,Réunion,0,494595,0,921,0.18621296212052285
2023-07-16,RE,Réunion,0,494595,0,921,0.18621296212052285
2023-07-23,RE,Réunion,0,494595,0,921,0.18621296212052285
2023-07-30,RE,Réunion,0,494595,0,921,0.18621296212052285
2023-08-06,RE,Réunion,0,494595,0,921,0.18621296212052285
2023-08-13,RE,Réunion,0,494595,0,921,0.18621296212052285
2023-08-20,RE,Réunion,0,494595,0,921,0.18621296212052285
2023-08-27,RE,Réunion,0,494595,0,921,0.18621296212052285
2023-09-03,RE,Réunion,0,494595,0,921,0.18621296212052285
2023-09-10,RE,Réunion,0,494595,0,921,0.18621296212052285
2023-09-17,RE,Réunion,0,494595,0,921,0.18621296212052285
2023-09-24,RE,Réunion,0,494595,0,921,0.18621296212052285
2023-10-01,RE,Réunion,0,494595,0,921,0.18621296212052285
2023-10-08,RE,Réunion,0,494595,0,921,0.18621296212052285
2023-10-15,RE,Réunion,0,494595,0,921,0.18621296212052285
2023-10-22,RE,Réunion,0,494595,0,921,0.18621296212052285
2023-10-29,RE,Réunion,0,494595,0,921,0.18621296212052285
2023-11-05,RE,Réunion,0,494595,0,921,0.18621296212052285
2023-11-12,RE,Réunion,0,494595,0,921,0.18621296212052285
2023-11-19,RE,Réunion,0,494595,0,921,0.18621296212052285
2023-11-26,RE,Réunion,0,494595,0,921,0.18621296212052285
2023-12-03,RE,Réunion,0,494595,0,921,0.18621296212052285
2023-12-10,RE,Réunion,0,494595,0,921,0.18621296212052285
2023-12-17,RE,Réunion,0,494595,0,921,0.18621296212052285
2023-12-24,RE,Réunion,0,494595,0,921,0.18621296212052285
2023-12-31,RE,Réunion,0,494595,0,921,0.18621296212052285
2024-01-07,RE,Réunion,0,494595,0,921,0.18621296212052285
2024-01-14,RE,Réunion,0,494595,0,921,0.18621296212052285
2020-03-29,RU,Russian Federation,1228,1534,8,8,0.5215123859191656
2020-04-05,RU,Russian Federation,3197,4731,35,43,0.9088987529063622
2020-04-12,RU,Russian Federation,11039,15770,87,130,0.8243500317057704
2020-04-19,RU,Russian Federation,27083,42853,231,361,0.8424147667607869
2020-04-26,RU,Russian Federation,38096,80949,386,747,0.9228032464885297
2020-05-03,RU,Russian Federation,53738,134687,533,1280,0.9503515558294416
2020-05-10,RU,Russian Federation,75001,209688,635,1915,0.9132616077219488
2020-05-17,RU,Russian Federation,72064,281752,716,2631,0.9337999375337176
2020-05-31,RW,Rwanda,34,359,1,1,0.2785515320334262
2020-06-07,RW,Rwanda,72,431,1,2,0.46403712296983757
2020-06-14,RW,Rwanda,110,541,0,2,0.36968576709796674
2020-06-21,RW,Rwanda,161,702,0,2,0.2849002849002849
2020-06-28,RW,Rwanda,176,878,0,2,0.22779043280182232
2020-07-05,RW,Rwanda,214,1092,1,3,0.27472527472527475
2020-07-12,RW,Rwanda,207,1299,1,4,0.30792917628945343
2020-07-19,RW,Rwanda,240,1539,1,5,0.3248862897985705
2020-07-26,RW,Rwanda,213,1752,0,5,0.28538812785388123
2020-08-02,RW,Rwanda,290,2042,0,5,0.2448579823702253
2020-08-09,RW,Rwanda,93,2135,1,6,0.2810304449648712
2020-08-16,RW,Rwanda,217,2352,2,8,0.3401360544217687
2020-08-23,RW,Rwanda,537,2889,3,11,0.380754586362063
2020-08-30,RW,Rwanda,954,3843,5,16,0.4163413999479573
2020-09-06,RW,Rwanda,506,4349,2,18,0.41388825017245345
2020-09-13,RW,Rwanda,216,4565,4,22,0.48192771084337355
2020-09-20,RW,Rwanda,124,4689,4,26,0.5544892301130305
2020-09-27,RW,Rwanda,122,4811,3,29,0.6027852837247973
2020-10-04,RW,Rwanda,40,4851,0,29,0.5978148835291692
2020-10-11,RW,Rwanda,41,4892,1,30,0.6132461161079313
2020-10-18,RW,Rwanda,79,4971,4,34,0.683967008650171
2020-10-25,RW,Rwanda,89,5060,0,34,0.6719367588932806
2020-11-01,RW,Rwanda,77,5137,1,35,0.6813315164492895
2020-11-08,RW,Rwanda,76,5213,1,36,0.6905812392096682
2020-11-15,RW,Rwanda,181,5394,6,42,0.778642936596218
2020-11-22,RW,Rwanda,226,5620,4,46,0.8185053380782918
2020-11-29,RW,Rwanda,271,5891,1,47,0.7978271940247836
2020-12-06,RW,Rwanda,193,6084,4,51,0.8382642998027613
2020-12-13,RW,Rwanda,444,6528,5,56,0.857843137254902
2020-12-20,RW,Rwanda,704,7232,3,59,0.8158185840707965
2020-12-27,RW,Rwanda,585,7817,14,73,0.9338620954330307
2021-03-14,BL,Saint Barthélemy,54,725,1,1,0.13793103448275862
2021-03-21,BL,Saint Barthélemy,51,776,0,1,0.12886597938144329
2021-03-28,BL,Saint Barthélemy,81,857,0,1,0.11668611435239205
2021-04-04,BL,Saint Barthélemy,53,910,0,1,0.10989010989010989
2021-04-11,BL,Saint Barthélemy,18,928,0,1,0.10775862068965517
2021-04-18,BL,Saint Barthélemy,26,954,0,1,0.10482180293501049
2021-04-25,BL,Saint Barthélemy,22,976,0,1,0.10245901639344263
2021-05-02,BL,Saint Barthélemy,12,988,0,1,0.10121457489878542
2021-05-09,BL,Saint Barthélemy,6,994,0,1,0.1006036217303823
2021-05-16,BL,Saint Barthélemy,16,1010,0,1,0.09900990099009901
2021-05-23,BL,Saint Barthélemy,6,1016,0,1,0.09842519685039369
2021-05-30,BL,Saint Barthélemy,7,1023,0,1,0.09775171065493646
2021-06-06,BL,Saint Barthélemy,6,1029,0,1,0.09718172983479105
2021-06-13,BL,Saint Barthélemy,3,1032,0,1,0.09689922480620156
2021-06-20,BL,Saint Barthélemy,8,1040,0,1,0.09615384615384616
2021-06-27,BL,Saint Barthélemy,3,1043,0,1,0.09587727708533077
2021-07-04,BL,Saint Barthélemy,3,1046,0,1,0.09560229445506692
2021-07-11,BL,Saint Barthélemy,6,1052,0,1,0.09505703422053231
2021-07-18,BL,Saint Barthélemy,5,1057,0,1,0.0946073793755913
2021-07-25,BL,Saint Barthélemy,8,1065,0,1,0.09389671361502347
2021-08-01,BL,Saint Barthélemy,270,1335,0,1,0.0749063670411985
2021-08-08,BL,Saint Barthélemy,64,1399,0,1,0.07147962830593281
2021-08-15,BL,Saint Barthélemy,80,1479,0,1,0.0676132521974307
2021-08-22,BL,Saint Barthélemy,74,1553,0,1,0.0643915003219575
2021-08-29,BL,Saint Barthélemy,39,1592,0,1,0.06281407035175879
2021-09-05,BL,Saint Barthélemy,15,1607,1,2,0.12445550715619166
2021-09-12,BL,Saint Barthélemy,6,1613,0,2,0.12399256044637322
2021-09-19,BL,Saint Barthélemy,11,1624,0,2,0.12315270935960591
2021-09-26,BL,Saint Barthélemy,10,1634,0,2,0.12239902080783352
2021-10-03,BL,Saint Barthélemy,15,1649,2,4,0.2425712553062462
2021-10-10,BL,Saint Barthélemy,9,1658,0,4,0.24125452352231602
2021-10-17,BL,Saint Barthélemy,1,1659,0,4,0.24110910186859552
2021-10-24,BL,Saint Barthélemy,0,1659,0,4,0.24110910186859552
2021-10-31,BL,Saint Barthélemy,1,1660,0,4,0.24096385542168677
2021-11-07,BL,Saint Barthélemy,1,1661,0,4,0.2408187838651415
2021-11-14,BL,Saint Barthélemy,0,1661,0,4,0.2408187838651415
2021-11-21,BL,Saint Barthélemy,5,1666,0,4,0.24009603841536614
2021-11-28,BL,Saint Barthélemy,6,1672,0,4,0.23923444976076555
2021-12-05,BL,Saint Barthélemy,2,1674,0,4,0.23894862604540024
2021-12-12,BL,Saint Barthélemy,9,1683,0,4,0.23767082590612004
2021-12-19,BL,Saint Barthélemy,9,1692,0,4,0.2364066193853428
2021-12-26,BL,Saint Barthélemy,34,1726,0,4,0.2317497103128621
2022-01-02,BL,Saint Barthélemy,229,1955,0,4,0.20460358056265981
2022-01-09,BL,Saint Barthélemy,495,2450,0,4,0.163265306122449
2022-01-16,BL,Saint Barthélemy,502,2952,0,4,0.13550135501355012
2022-01-23,BL,Saint Barthélemy,266,3218,0,4,0.1243008079552517
2022-01-30,BL,Saint Barthélemy,209,3427,0,4,0.11672016340822876
2022-02-06,BL,Saint Barthélemy,115,3542,0,4,0.1129305477131564
2022-02-13,BL,Saint Barthélemy,91,3633,0,4,0.11010184420589045
2022-02-20,BL,Saint Barthélemy,51,3684,0,4,0.10857763300760044
2022-02-27,BL,Saint Barthélemy,27,3711,0,4,0.10778765831312315
2022-03-06,BL,Saint Barthélemy,15,3726,0,4,0.10735373054213634
2022-03-13,BL,Saint Barthélemy,37,3763,0,4,0.10629816635663034
2022-03-20,BL,Saint Barthélemy,42,3805,0,4,0.10512483574244415
2022-03-27,BL,Saint Barthélemy,78,3883,0,4,0.10301313417460728
2022-04-03,BL,Saint Barthélemy,186,4069,0,4,0.09830425165888423
2022-04-10,BL,Saint Barthélemy,164,4233,0,4,0.09449562957713206
2022-04-17,BL,Saint Barthélemy,135,4368,0,4,0.09157509157509157
2022-04-24,BL,Saint Barthélemy,75,4443,0,4,0.09002925950934053
2022-05-01,BL,Saint Barthélemy,44,4487,0,4,0.08914642299977714
2022-05-08,BL,Saint Barthélemy,31,4518,0,4,0.08853474988933156
2022-05-15,BL,Saint Barthélemy,32,4550,0,4,0.0879120879120879
2022-05-22,BL,Saint Barthélemy,21,4571,0,4,0.08750820389411508
2022-05-29,BL,Saint Barthélemy,23,4594,0,4,0.087070091423596
2022-06-05,BL,Saint Barthélemy,20,4614,0,4,0.08669267446900737
2022-06-12,BL,Saint Barthélemy,32,4646,0,4,0.08609556607834697
2022-06-19,BL,Saint Barthélemy,25,4671,0,4,0.08563476771569258
2022-06-26,BL,Saint Barthélemy,26,4697,0,4,0.08516074089844582
2022-07-03,BL,Saint Barthélemy,43,4740,1,5,0.10548523206751054
2022-07-10,BL,Saint Barthélemy,105,4845,0,5,0.10319917440660474
2022-07-17,BL,Saint Barthélemy,109,4954,0,5,0.10092854259184497
2022-07-24,BL,Saint Barthélemy,101,5055,0,5,0.09891196834817012
2022-07-31,BL,Saint Barthélemy,83,5138,0,5,0.0973141300116777
2022-08-07,BL,Saint Barthélemy,39,5177,0,5,0.09658103148541626
2022-08-14,BL,Saint Barthélemy,31,5208,0,5,0.09600614439324116
2022-08-21,BL,Saint Barthélemy,23,5231,0,5,0.09558401835213153
2022-08-28,BL,Saint Barthélemy,32,5263,0,5,0.09500285008550256
2022-09-04,BL,Saint Barthélemy,0,5263,0,5,0.09500285008550256
2022-09-11,BL,Saint Barthélemy,0,5263,0,5,0.09500285008550256
2022-09-18,BL,Saint Barthélemy,0,5263,0,5,0.09500285008550256
2022-09-25,BL,Saint Barthélemy,22,5285,0,5,0.0946073793755913
2022-10-02,BL,Saint Barthélemy,0,5285,0,5,0.0946073793755913
2022-10-09,BL,Saint Barthélemy,17,5302,0,5,0.09430403621274991
2022-10-16,BL,Saint Barthélemy,11,5313,0,5,0.09410878976096368
2022-10-23,BL,Saint Barthélemy,10,5323,0,5,0.0939319932368965
2022-10-30,BL,Saint Barthélemy,0,5323,0,5,0.0939319932368965
2022-11-06,BL,Saint Barthélemy,9,5332,0,5,0.0937734433608402
2022-11-13,BL,Saint Barthélemy,4,5336,0,5,0.0937031484257871
2022-11-20,BL,Saint Barthélemy,5,5341,0,5,0.09361542782250515
2022-11-27,BL,Saint Barthélemy,7,5348,0,5,0.09349289454001496
2022-12-04,BL,Saint Barthélemy,12,5360,0,5,0.09328358208955223
2022-12-11,BL,Saint Barthélemy,22,5382,0,5,0.09290226681531029
2022-12-18,BL,Saint Barthélemy,9,5391,0,5,0.09274717121127805
2022-12-25,BL,Saint Barthélemy,11,5402,0,5,0.09255831173639394
2023-01-01,BL,Saint Barthélemy,6,5408,0,5,0.09245562130177515
2023-01-08,BL,Saint Barthélemy,10,5418,0,5,0.09228497600590624
2023-01-15,BL,Saint Barthélemy,0,5418,0,5,0.09228497600590624
2023-01-22,BL,Saint Barthélemy,2,5420,0,5,0.09225092250922509
2023-01-29,BL,Saint Barthélemy,6,5426,0,5,0.09214891264283082
2023-02-05,BL,Saint Barthélemy,5,5431,0,5,0.09206407659731174
2023-02-12,BL,Saint Barthélemy,4,5435,0,5,0.09199632014719411
2023-02-19,BL,Saint Barthélemy,4,5439,0,5,0.09192866335723479
2023-02-26,BL,Saint Barthélemy,1,5440,0,5,0.09191176470588235
2023-03-05,BL,Saint Barthélemy,1,5441,0,5,0.09189487226612755
2023-03-12,BL,Saint Barthélemy,8,5449,0,5,0.09175995595522114
2023-03-19,BL,Saint Barthélemy,18,5467,0,5,0.09145783793671117
2023-03-26,BL,Saint Barthélemy,11,5478,0,5,0.09127418765972983
2023-04-02,BL,Saint Barthélemy,0,5478,0,5,0.09127418765972983
2023-04-09,BL,Saint Barthélemy,0,5478,0,5,0.09127418765972983
2023-04-16,BL,Saint Barthélemy,6,5484,0,5,0.09117432530999271
2023-04-23,BL,Saint Barthélemy,1,5485,0,5,0.09115770282588878
2023-04-30,BL,Saint Barthélemy,1,5486,0,5,0.09114108640174991
2023-05-07,BL,Saint Barthélemy,0,5486,0,5,0.09114108640174991
2023-05-14,BL,Saint Barthélemy,0,5486,0,5,0.09114108640174991
2023-05-21,BL,Saint Barthélemy,8,5494,0,5,0.09100837277029487
2023-05-28,BL,Saint Barthélemy,0,5494,0,5,0.09100837277029487
2023-06-04,BL,Saint Barthélemy,0,5494,0,5,0.09100837277029487
2023-06-11,BL,Saint Barthélemy,0,5494,0,5,0.09100837277029487
2023-06-18,BL,Saint Barthélemy,0,5494,0,5,0.09100837277029487
2023-06-25,BL,Saint Barthélemy,13,5507,0,5,0.09079353550027239
2023-07-02,BL,Saint Barthélemy,0,5507,0,5,0.09079353550027239
2023-07-09,BL,Saint Barthélemy,0,5507,0,5,0.09079353550027239
2023-07-16,BL,Saint Barthélemy,0,5507,0,5,0.09079353550027239
2023-07-23,BL,Saint Barthélemy,0,5507,0,5,0.09079353550027239
2023-07-30,BL,Saint Barthélemy,0,5507,0,5,0.09079353550027239
2023-08-06,BL,Saint Barthélemy,0,5507,0,5,0.09079353550027239
2023-08-13,BL,Saint Barthélemy,0,5507,0,5,0.09079353550027239
2023-08-20,BL,Saint Barthélemy,0,5507,0,5,0.09079353550027239
2023-08-27,BL,Saint Barthélemy,0,5507,0,5,0.09079353550027239
2023-09-03,BL,Saint Barthélemy,0,5507,0,5,0.09079353550027239
2023-09-10,BL,Saint Barthélemy,0,5507,0,5,0.09079353550027239
2023-09-17,BL,Saint Barthélemy,0,5507,0,5,0.09079353550027239
2023-09-24,BL,Saint Barthélemy,0,5507,0,5,0.09079353550027239
2023-10-01,BL,Saint Barthélemy,0,5507,0,5,0.09079353550027239
2023-10-08,BL,Saint Barthélemy,0,5507,0,5,0.09079353550027239
2023-10-15,BL,Saint Barthélemy,0,5507,0,5,0.09079353550027239
2023-10-22,BL,Saint Barthélemy,0,5507,0,5,0.09079353550027239
2023-10-29,BL,Saint Barthélemy,0,5507,0,5,0.09079353550027239
2023-11-05,BL,Saint Barthélemy,0,5507,0,5,0.09079353550027239
2023-11-12,BL,Saint Barthélemy,0,5507,0,5,0.09079353550027239
2023-11-19,BL,Saint Barthélemy,0,5507,0,5,0.09079353550027239
2023-11-26,BL,Saint Barthélemy,0,5507,0,5,0.09079353550027239
2023-12-03,BL,Saint Barthélemy,0,5507,0,5,0.09079353550027239
2023-12-10,BL,Saint Barthélemy,0,5507,0,5,0.09079353550027239
2023-12-17,BL,Saint Barthélemy,0,5507,0,5,0.09079353550027239
2023-12-24,BL,Saint Barthélemy,0,5507,0,5,0.09079353550027239
2023-12-31,BL,Saint Barthélemy,0,5507,0,5,0.09079353550027239
2024-01-07,BL,Saint Barthélemy,0,5507,0,5,0.09079353550027239
2024-01-14,BL,Saint Barthélemy,0,5507,0,5,0.09079353550027239
2021-06-20,KN,Saint Kitts and Nevis,149,304,1,1,0.3289473684210526
2021-06-27,KN,Saint Kitts and Nevis,124,428,2,3,0.7009345794392523
2021-07-04,KN,Saint Kitts and Nevis,48,476,0,3,0.6302521008403361
2021-07-11,KN,Saint Kitts and Nevis,49,525,0,3,0.5714285714285714
2021-07-18,KN,Saint Kitts and Nevis,23,548,0,3,0.5474452554744526
2021-07-25,KN,Saint Kitts and Nevis,15,563,0,3,0.5328596802841918
2021-08-01,KN,Saint Kitts and Nevis,30,593,0,3,0.5059021922428331
2021-08-08,KN,Saint Kitts and Nevis,18,611,0,3,0.4909983633387889
2021-08-15,KN,Saint Kitts and Nevis,31,642,0,3,0.46728971962616817
2021-08-22,KN,Saint Kitts and Nevis,150,792,0,3,0.3787878787878788
2021-08-29,KN,Saint Kitts and Nevis,232,1024,0,3,0.29296875
2021-09-05,KN,Saint Kitts and Nevis,173,1197,2,5,0.4177109440267335
2021-09-12,KN,Saint Kitts and Nevis,242,1439,2,7,0.4864489228630994
2021-09-19,KN,Saint Kitts and Nevis,193,1632,2,9,0.5514705882352942
2021-09-26,KN,Saint Kitts and Nevis,203,1835,1,10,0.544959128065395
2021-10-03,KN,Saint Kitts and Nevis,130,1965,3,13,0.6615776081424937
2021-10-10,KN,Saint Kitts and Nevis,396,2361,4,17,0.7200338839474798
2021-10-17,KN,Saint Kitts and Nevis,185,2546,4,21,0.8248232521602514
2021-10-24,KN,Saint Kitts and Nevis,77,2623,0,21,0.8006099885627144
2021-10-31,KN,Saint Kitts and Nevis,45,2668,2,23,0.8620689655172413
2021-11-07,KN,Saint Kitts and Nevis,40,2708,2,25,0.9231905465288036
2021-11-14,KN,Saint Kitts and Nevis,37,2745,2,27,0.9836065573770493
2021-12-26,KN,Saint Kitts and Nevis,35,2836,0,28,0.9873060648801129
2022-01-02,KN,Saint Kitts and Nevis,207,3043,0,28,0.9201445941505093
2022-01-09,KN,Saint Kitts and Nevis,1013,4056,0,28,0.6903353057199211
2022-01-16,KN,Saint Kitts and Nevis,826,4882,0,28,0.5735354362965998
2022-01-23,KN,Saint Kitts and Nevis,348,5230,0,28,0.5353728489483747
2022-01-30,KN,Saint Kitts and Nevis,173,5403,5,33,0.6107717934480844
2022-02-06,KN,Saint Kitts and Nevis,66,5469,4,37,0.6765405010056683
2022-02-13,KN,Saint Kitts and Nevis,26,5495,2,39,0.7097361237488626
2022-02-20,KN,Saint Kitts and Nevis,16,5511,1,40,0.7258210851025223
2022-02-27,KN,Saint Kitts and Nevis,15,5526,2,42,0.760043431053203
2022-03-06,KN,Saint Kitts and Nevis,7,5533,0,42,0.7590818724019519
2022-03-13,KN,Saint Kitts and Nevis,5,5538,0,42,0.7583965330444203
2022-03-20,KN,Saint Kitts and Nevis,6,5544,0,42,0.7575757575757576
2022-03-27,KN,Saint Kitts and Nevis,4,5548,0,42,0.7570295602018745
2022-04-03,KN,Saint Kitts and Nevis,1,5549,1,43,0.7749143989908092
2022-04-10,KN,Saint Kitts and Nevis,3,5552,0,43,0.7744956772334294
2022-04-17,KN,Saint Kitts and Nevis,5,5557,0,43,0.7737988123087997
2022-04-24,KN,Saint Kitts and Nevis,5,5562,0,43,0.7731032002876663
2022-05-01,KN,Saint Kitts and Nevis,1,5563,0,43,0.7729642279345676
2022-05-08,KN,Saint Kitts and Nevis,20,5583,0,43,0.77019523553645
2022-05-15,KN,Saint Kitts and Nevis,22,5605,0,43,0.7671721677074042
2022-05-22,KN,Saint Kitts and Nevis,49,5654,0,43,0.7605235231694376
2022-05-29,KN,Saint Kitts and Nevis,53,5707,0,43,0.7534606623444893
2022-06-05,KN,Saint Kitts and Nevis,91,5798,0,43,0.741635046567782
2022-06-12,KN,Saint Kitts and Nevis,39,5837,0,43,0.7366798012677745
2022-06-19,KN,Saint Kitts and Nevis,73,5910,0,43,0.727580372250423
2022-06-26,KN,Saint Kitts and Nevis,37,5947,0,43,0.7230536404910038
2022-07-03,KN,Saint Kitts and Nevis,193,6140,0,43,0.7003257328990228
2022-07-10,KN,Saint Kitts and Nevis,153,6293,0,43,0.6832989035436199
2022-07-17,KN,Saint Kitts and Nevis,84,6377,2,45,0.7056609691077309
2022-07-24,KN,Saint Kitts and Nevis,45,6422,1,46,0.7162877608221737
2022-07-31,KN,Saint Kitts and Nevis,34,6456,0,46,0.7125154894671624
2022-08-07,KN,Saint Kitts and Nevis,21,6477,0,46,0.7102053419793114
2022-08-14,KN,Saint Kitts and Nevis,15,6492,0,46,0.7085643869377696
2022-08-21,KN,Saint Kitts and Nevis,6,6498,0,46,0.7079101261926747
2022-08-28,KN,Saint Kitts and Nevis,11,6509,0,46,0.7067137809187279
2022-09-04,KN,Saint Kitts and Nevis,10,6519,0,46,0.705629697806412
2022-09-11,KN,Saint Kitts and Nevis,10,6529,0,46,0.7045489355184561
2022-09-18,KN,Saint Kitts and Nevis,12,6541,0,46,0.7032563828160832
2022-09-25,KN,Saint Kitts and Nevis,2,6543,0,46,0.7030414183096438
2022-10-02,KN,Saint Kitts and Nevis,2,6545,0,46,0.7028265851795263
2022-10-09,KN,Saint Kitts and Nevis,1,6546,0,46,0.7027192178429575
2022-10-16,KN,Saint Kitts and Nevis,1,6547,0,46,0.7026118833053306
2022-10-23,KN,Saint Kitts and Nevis,1,6548,0,46,0.7025045815516188
2022-10-30,KN,Saint Kitts and Nevis,0,6548,0,46,0.7025045815516188
2022-11-06,KN,Saint Kitts and Nevis,1,6549,0,46,0.7023973125668042
2022-11-13,KN,Saint Kitts and Nevis,3,6552,0,46,0.7020757020757021
2022-11-20,KN,Saint Kitts and Nevis,0,6552,0,46,0.7020757020757021
2022-11-27,KN,Saint Kitts and Nevis,4,6556,0,46,0.7016473459426479
2022-12-04,KN,Saint Kitts and Nevis,3,6559,0,46,0.7013264217106266
2022-12-11,KN,Saint Kitts and Nevis,0,6559,0,46,0.7013264217106266
2022-12-18,KN,Saint Kitts and Nevis,1,6560,0,46,0.701219512195122
2022-12-25,KN,Saint Kitts and Nevis,2,6562,0,46,0.7010057909174032
2023-01-01,KN,Saint Kitts and Nevis,0,6562,0,46,0.7010057909174032
2023-01-08,KN,Saint Kitts and Nevis,9,6571,0,46,0.7000456551514229
2023-01-15,KN,Saint Kitts and Nevis,8,6579,0,46,0.6991944064447485
2023-01-22,KN,Saint Kitts and Nevis,6,6585,0,46,0.6985573272589218
2023-01-29,KN,Saint Kitts and Nevis,6,6591,0,46,0.6979214079805796
2023-02-05,KN,Saint Kitts and Nevis,1,6592,0,46,0.6978155339805826
2023-02-12,KN,Saint Kitts and Nevis,1,6593,0,46,0.6977096920976793
2023-02-19,KN,Saint Kitts and Nevis,3,6596,0,46,0.6973923590054579
2023-02-26,KN,Saint Kitts and Nevis,0,6596,0,46,0.6973923590054579
2023-03-05,KN,Saint Kitts and Nevis,1,6597,0,46,0.6972866454448992
2023-03-12,KN,Saint Kitts and Nevis,0,6597,0,46,0.6972866454448992
2023-03-19,KN,Saint Kitts and Nevis,0,6597,0,46,0.6972866454448992
2023-03-26,KN,Saint Kitts and Nevis,0,6597,0,46,0.6972866454448992
2023-04-02,KN,Saint Kitts and Nevis,1,6598,0,46,0.6971809639284632
2023-04-09,KN,Saint Kitts and Nevis,0,6598,0,46,0.6971809639284632
2023-04-16,KN,Saint Kitts and Nevis,0,6598,0,46,0.6971809639284632
2023-04-23,KN,Saint Kitts and Nevis,0,6598,0,46,0.6971809639284632
2023-04-30,KN,Saint Kitts and Nevis,0,6598,0,46,0.6971809639284632
2023-05-07,KN,Saint Kitts and Nevis,1,6599,0,46,0.6970753144415821
2023-05-14,KN,Saint Kitts and Nevis,1,6600,0,46,0.6969696969696969
2023-05-21,KN,Saint Kitts and Nevis,0,6600,0,46,0.6969696969696969
2023-05-28,KN,Saint Kitts and Nevis,2,6602,0,46,0.6967585580127235
2023-06-04,KN,Saint Kitts and Nevis,0,6602,0,46,0.6967585580127235
2023-06-11,KN,Saint Kitts and Nevis,0,6602,0,46,0.6967585580127235
2023-06-18,KN,Saint Kitts and Nevis,4,6606,0,46,0.696336663639116
2023-06-25,KN,Saint Kitts and Nevis,0,6606,0,46,0.696336663639116
2023-07-02,KN,Saint Kitts and Nevis,1,6607,0,46,0.6962312698652944
2023-07-09,KN,Saint Kitts and Nevis,0,6607,0,46,0.6962312698652944
2023-07-16,KN,Saint Kitts and Nevis,0,6607,0,46,0.6962312698652944
2023-07-23,KN,Saint Kitts and Nevis,0,6607,0,46,0.6962312698652944
2023-07-30,KN,Saint Kitts and Nevis,0,6607,0,46,0.6962312698652944
2023-08-06,KN,Saint Kitts and Nevis,0,6607,0,46,0.6962312698652944
2023-08-13,KN,Saint Kitts and Nevis,0,6607,0,46,0.6962312698652944
2023-08-20,KN,Saint Kitts and Nevis,0,6607,0,46,0.6962312698652944
2023-08-27,KN,Saint Kitts and Nevis,0,6607,0,46,0.6962312698652944
2023-09-03,KN,Saint Kitts and Nevis,0,6607,0,46,0.6962312698652944
2023-09-10,KN,Saint Kitts and Nevis,0,6607,0,46,0.6962312698652944
2023-09-17,KN,Saint Kitts and Nevis,0,6607,0,46,0.6962312698652944
2023-09-24,KN,Saint Kitts and Nevis,0,6607,0,46,0.6962312698652944
2023-10-01,KN,Saint Kitts and Nevis,0,6607,0,46,0.6962312698652944
2023-10-08,KN,Saint Kitts and Nevis,0,6607,0,46,0.6962312698652944
2023-10-15,KN,Saint Kitts and Nevis,0,6607,0,46,0.6962312698652944
2023-10-22,KN,Saint Kitts and Nevis,0,6607,0,46,0.6962312698652944
2023-10-29,KN,Saint Kitts and Nevis,0,6607,0,46,0.6962312698652944
2023-11-05,KN,Saint Kitts and Nevis,0,6607,0,46,0.6962312698652944
2023-11-12,KN,Saint Kitts and Nevis,0,6607,0,46,0.6962312698652944
2023-11-19,KN,Saint Kitts and Nevis,0,6607,0,46,0.6962312698652944
2023-11-26,KN,Saint Kitts and Nevis,0,6607,0,46,0.6962312698652944
2023-12-03,KN,Saint Kitts and Nevis,0,6607,0,46,0.6962312698652944
2023-12-10,KN,Saint Kitts and Nevis,0,6607,0,46,0.6962312698652944
2023-12-17,KN,Saint Kitts and Nevis,0,6607,0,46,0.6962312698652944
2023-12-24,KN,Saint Kitts and Nevis,0,6607,0,46,0.6962312698652944
2023-12-31,KN,Saint Kitts and Nevis,0,6607,0,46,0.6962312698652944
2024-01-07,KN,Saint Kitts and Nevis,0,6607,0,46,0.6962312698652944
2024-01-14,KN,Saint Kitts and Nevis,0,6607,0,46,0.6962312698652944
2020-11-22,LC,Saint Lucia,43,203,0,2,0.9852216748768473
2020-11-29,LC,Saint Lucia,43,246,0,2,0.8130081300813009
2020-12-06,LC,Saint Lucia,19,265,0,2,0.7547169811320755
2021-02-14,LC,Saint Lucia,674,2487,5,23,0.9248090068355449
2021-02-21,LC,Saint Lucia,373,2860,5,28,0.9790209790209791
2021-01-31,MF,Saint Martin (French part),98,1289,0,12,0.9309542280837859
2021-02-07,MF,Saint Martin (French part),0,1289,0,12,0.9309542280837859
2021-02-14,MF,Saint Martin (French part),167,1456,0,12,0.8241758241758242
2021-02-21,MF,Saint Martin (French part),0,1456,0,12,0.8241758241758242
2021-02-28,MF,Saint Martin (French part),98,1554,0,12,0.7722007722007722
2021-03-07,MF,Saint Martin (French part),27,1581,0,12,0.7590132827324478
2021-03-14,MF,Saint Martin (French part),31,1612,0,12,0.7444168734491315
2021-03-21,MF,Saint Martin (French part),21,1633,0,12,0.7348438456827924
2021-03-28,MF,Saint Martin (French part),24,1657,0,12,0.724200362100181
2021-04-04,MF,Saint Martin (French part),30,1687,1,13,0.7705986959098993
2021-04-11,MF,Saint Martin (French part),16,1703,0,13,0.7633587786259541
2021-04-18,MF,Saint Martin (French part),7,1710,0,13,0.7602339181286549
2021-04-25,MF,Saint Martin (French part),18,1728,0,13,0.7523148148148148
2021-05-02,MF,Saint Martin (French part),21,1749,1,14,0.8004574042309892
2021-05-09,MF,Saint Martin (French part),28,1777,0,14,0.7878446820483961
2021-05-16,MF,Saint Martin (French part),62,1839,0,14,0.7612833061446439
2021-05-23,MF,Saint Martin (French part),56,1895,1,15,0.79155672823219
2021-05-30,MF,Saint Martin (French part),114,2009,0,15,0.7466401194624191
2021-08-29,MF,Saint Martin (French part),209,3356,0,33,0.9833134684147794
2021-09-05,MF,Saint Martin (French part),188,3544,0,33,0.9311512415349887
2021-09-12,MF,Saint Martin (French part),115,3659,0,33,0.9018857611369226
2021-09-19,MF,Saint Martin (French part),81,3740,2,35,0.9358288770053476
2021-09-26,MF,Saint Martin (French part),55,3795,0,35,0.922266139657444
2021-10-03,MF,Saint Martin (French part),24,3819,1,36,0.9426551453260016
2021-10-10,MF,Saint Martin (French part),39,3858,1,37,0.9590461378952826
2021-10-17,MF,Saint Martin (French part),30,3888,0,37,0.9516460905349794
2021-10-24,MF,Saint Martin (French part),32,3920,0,37,0.9438775510204082
2021-10-31,MF,Saint Martin (French part),21,3941,0,37,0.9388480081197667
2021-11-07,MF,Saint Martin (French part),34,3975,1,38,0.9559748427672956
2021-11-14,MF,Saint Martin (French part),18,3993,0,38,0.9516654144753318
2021-11-21,MF,Saint Martin (French part),20,4013,0,38,0.946922501868926
2021-11-28,MF,Saint Martin (French part),18,4031,0,38,0.9426941205656165
2021-12-05,MF,Saint Martin (French part),9,4040,0,38,0.9405940594059405
2021-12-12,MF,Saint Martin (French part),19,4059,0,38,0.9361911800936191
2021-12-19,MF,Saint Martin (French part),16,4075,0,38,0.9325153374233128
2021-12-26,MF,Saint Martin (French part),43,4118,1,39,0.9470616804273919
2022-01-02,MF,Saint Martin (French part),129,4247,1,40,0.9418412997409937
2022-01-09,MF,Saint Martin (French part),975,5222,0,40,0.7659900421294523
2022-01-16,MF,Saint Martin (French part),2295,7517,0,40,0.5321271783956366
2022-01-23,MF,Saint Martin (French part),1396,8913,1,41,0.46000224391338496
2022-01-30,MF,Saint Martin (French part),520,9433,1,42,0.4452454150323333
2022-02-06,MF,Saint Martin (French part),173,9606,1,43,0.44763689360816156
2022-02-13,MF,Saint Martin (French part),126,9732,1,44,0.45211672831894784
2022-02-20,MF,Saint Martin (French part),58,9790,0,44,0.44943820224719105
2022-02-27,MF,Saint Martin (French part),52,9842,0,44,0.4470636049583418
2022-03-06,MF,Saint Martin (French part),28,9870,0,44,0.44579533941236066
2022-03-13,MF,Saint Martin (French part),38,9908,0,44,0.44408558740411785
2022-03-20,MF,Saint Martin (French part),31,9939,0,44,0.442700472884596
2022-03-27,MF,Saint Martin (French part),49,9988,0,44,0.4405286343612335
2022-04-03,MF,Saint Martin (French part),81,10069,0,44,0.4369848048465587
2022-04-10,MF,Saint Martin (French part),60,10129,0,44,0.43439628788626716
2022-04-17,MF,Saint Martin (French part),93,10222,0,44,0.430444140090002
2022-04-24,MF,Saint Martin (French part),94,10316,0,44,0.4265219077161691
2022-05-01,MF,Saint Martin (French part),102,10418,0,44,0.42234593971971585
2022-05-08,MF,Saint Martin (French part),69,10487,0,44,0.4195670830552112
2022-05-15,MF,Saint Martin (French part),65,10552,0,44,0.4169825625473844
2022-05-22,MF,Saint Martin (French part),66,10618,0,44,0.4143906573742701
2022-05-29,MF,Saint Martin (French part),70,10688,0,44,0.4116766467065869
2022-06-05,MF,Saint Martin (French part),38,10726,0,44,0.41021816147678536
2022-06-12,MF,Saint Martin (French part),74,10800,0,44,0.4074074074074074
2022-06-19,MF,Saint Martin (French part),75,10875,1,45,0.41379310344827586
2022-06-26,MF,Saint Martin (French part),77,10952,0,45,0.4108838568298028
2022-07-03,MF,Saint Martin (French part),109,11061,1,46,0.4158755989512702
2022-07-10,MF,Saint Martin (French part),163,11224,0,46,0.4098360655737705
2022-07-17,MF,Saint Martin (French part),186,11410,0,46,0.40315512708150747
2022-07-24,MF,Saint Martin (French part),125,11535,0,46,0.3987863025574339
2022-07-31,MF,Saint Martin (French part),132,11667,0,46,0.3942744493014485
2022-08-07,MF,Saint Martin (French part),107,11774,0,46,0.39069135383047393
2022-08-14,MF,Saint Martin (French part),83,11857,0,46,0.3879564814033904
2022-08-21,MF,Saint Martin (French part),54,11911,0,46,0.3861976324406011
2022-08-28,MF,Saint Martin (French part),30,11941,0,46,0.38522736789213635
2022-09-04,MF,Saint Martin (French part),0,11941,0,46,0.38522736789213635
2022-09-11,MF,Saint Martin (French part),0,11941,0,46,0.38522736789213635
2022-09-18,MF,Saint Martin (French part),0,11941,0,46,0.38522736789213635
2022-09-25,MF,Saint Martin (French part),37,11978,0,46,0.38403740190348973
2022-10-02,MF,Saint Martin (French part),0,11978,0,46,0.38403740190348973
2022-10-09,MF,Saint Martin (French part),14,11992,0,46,0.38358905937291526
2022-10-16,MF,Saint Martin (French part),17,12009,0,46,0.38304604879673576
2022-10-23,MF,Saint Martin (French part),17,12026,0,46,0.38250457342424743
2022-10-30,MF,Saint Martin (French part),0,12026,0,46,0.38250457342424743
2022-11-06,MF,Saint Martin (French part),6,12032,0,46,0.38231382978723405
2022-11-13,MF,Saint Martin (French part),2,12034,0,46,0.38225029084261264
2022-11-20,MF,Saint Martin (French part),7,12041,0,46,0.3820280707582427
2022-11-27,MF,Saint Martin (French part),17,12058,0,46,0.38148946757339525
2022-12-04,MF,Saint Martin (French part),17,12075,0,46,0.38095238095238093
2022-12-11,MF,Saint Martin (French part),29,12104,0,46,0.380039656311963
2022-12-18,MF,Saint Martin (French part),36,12140,0,46,0.37891268533772654
2022-12-25,MF,Saint Martin (French part),40,12180,0,46,0.37766830870279144
2023-01-01,MF,Saint Martin (French part),26,12206,0,46,0.37686383745698837
2023-01-08,MF,Saint Martin (French part),16,12222,0,46,0.37637047946326296
2023-01-15,MF,Saint Martin (French part),7,12229,0,46,0.3761550412952817
2023-01-22,MF,Saint Martin (French part),4,12233,0,46,0.3760320444698766
2023-01-29,MF,Saint Martin (French part),11,12244,0,46,0.3756942175759556
2023-02-05,MF,Saint Martin (French part),3,12247,0,46,0.37560218829101005
2023-02-12,MF,Saint Martin (French part),6,12253,0,46,0.37541826491471475
2023-02-19,MF,Saint Martin (French part),4,12257,0,46,0.37529574936770826
2023-02-26,MF,Saint Martin (French part),7,12264,0,46,0.3750815394651011
2023-03-05,MF,Saint Martin (French part),7,12271,0,46,0.37486757395485293
2023-03-12,MF,Saint Martin (French part),2,12273,0,46,0.3748064857817974
2023-03-19,MF,Saint Martin (French part),5,12278,0,46,0.3746538524189607
2023-03-26,MF,Saint Martin (French part),2,12280,0,46,0.3745928338762215
2023-04-02,MF,Saint Martin (French part),0,12280,0,46,0.3745928338762215
2023-04-09,MF,Saint Martin (French part),0,12280,0,46,0.3745928338762215
2023-04-16,MF,Saint Martin (French part),7,12287,0,46,0.37437942540896885
2023-04-23,MF,Saint Martin (French part),6,12293,0,46,0.37419669730741073
2023-04-30,MF,Saint Martin (French part),7,12300,0,46,0.37398373983739835
2023-05-07,MF,Saint Martin (French part),0,12300,0,46,0.37398373983739835
2023-05-14,MF,Saint Martin (French part),0,12300,0,46,0.37398373983739835
2023-05-21,MF,Saint Martin (French part),3,12303,0,46,0.37389254653336584
2023-05-28,MF,Saint Martin (French part),0,12303,0,46,0.37389254653336584
2023-06-04,MF,Saint Martin (French part),0,12303,0,46,0.37389254653336584
2023-06-11,MF,Saint Martin (French part),0,12303,0,46,0.37389254653336584
2023-06-18,MF,Saint Martin (French part),0,12303,0,46,0.37389254653336584
2023-06-25,MF,Saint Martin (French part),21,12324,0,46,0.3732554365465758
2023-07-02,MF,Saint Martin (French part),0,12324,0,46,0.3732554365465758
2023-07-09,MF,Saint Martin (French part),0,12324,0,46,0.3732554365465758
2023-07-16,MF,Saint Martin (French part),0,12324,0,46,0.3732554365465758
2023-07-23,MF,Saint Martin (French part),0,12324,0,46,0.3732554365465758
2023-07-30,MF,Saint Martin (French part),0,12324,0,46,0.3732554365465758
2023-08-06,MF,Saint Martin (French part),0,12324,0,46,0.3732554365465758
2023-08-13,MF,Saint Martin (French part),0,12324,0,46,0.3732554365465758
2023-08-20,MF,Saint Martin (French part),0,12324,0,46,0.3732554365465758
2023-08-27,MF,Saint Martin (French part),0,12324,0,46,0.3732554365465758
2023-09-03,MF,Saint Martin (French part),0,12324,0,46,0.3732554365465758
2023-09-10,MF,Saint Martin (French part),0,12324,0,46,0.3732554365465758
2023-09-17,MF,Saint Martin (French part),0,12324,0,46,0.3732554365465758
2023-09-24,MF,Saint Martin (French part),0,12324,0,46,0.3732554365465758
2023-10-01,MF,Saint Martin (French part),0,12324,0,46,0.3732554365465758
2023-10-08,MF,Saint Martin (French part),0,12324,0,46,0.3732554365465758
2023-10-15,MF,Saint Martin (French part),0,12324,0,46,0.3732554365465758
2023-10-22,MF,Saint Martin (French part),0,12324,0,46,0.3732554365465758
2023-10-29,MF,Saint Martin (French part),0,12324,0,46,0.3732554365465758
2023-11-05,MF,Saint Martin (French part),0,12324,0,46,0.3732554365465758
2023-11-12,MF,Saint Martin (French part),0,12324,0,46,0.3732554365465758
2023-11-19,MF,Saint Martin (French part),0,12324,0,46,0.3732554365465758
2023-11-26,MF,Saint Martin (French part),0,12324,0,46,0.3732554365465758
2023-12-03,MF,Saint Martin (French part),0,12324,0,46,0.3732554365465758
2023-12-10,MF,Saint Martin (French part),0,12324,0,46,0.3732554365465758
2023-12-17,MF,Saint Martin (French part),0,12324,0,46,0.3732554365465758
2023-12-24,MF,Saint Martin (French part),0,12324,0,46,0.3732554365465758
2023-12-31,MF,Saint Martin (French part),0,12324,0,46,0.3732554365465758
2024-01-07,MF,Saint Martin (French part),0,12324,0,46,0.3732554365465758
2024-01-14,MF,Saint Martin (French part),0,12324,0,46,0.3732554365465758
2022-02-06,PM,Saint Pierre and Miquelon,200,828,1,1,0.12077294685990338
2022-02-13,PM,Saint Pierre and Miquelon,93,921,0,1,0.10857763300760044
2022-02-20,PM,Saint Pierre and Miquelon,44,965,0,1,0.10362694300518134
2022-02-27,PM,Saint Pierre and Miquelon,30,995,0,1,0.10050251256281408
2022-03-06,PM,Saint Pierre and Miquelon,8,1003,0,1,0.09970089730807577
2022-03-13,PM,Saint Pierre and Miquelon,52,1055,0,1,0.09478672985781991
2022-03-20,PM,Saint Pierre and Miquelon,298,1353,0,1,0.07390983000739099
2022-03-27,PM,Saint Pierre and Miquelon,577,1930,0,1,0.05181347150259067
2022-04-03,PM,Saint Pierre and Miquelon,306,2236,0,1,0.044722719141323794
2022-04-10,PM,Saint Pierre and Miquelon,182,2418,0,1,0.0413564929693962
2022-04-17,PM,Saint Pierre and Miquelon,119,2537,0,1,0.039416633819471816
2022-04-24,PM,Saint Pierre and Miquelon,104,2641,0,1,0.03786444528587656
2022-05-01,PM,Saint Pierre and Miquelon,60,2701,0,1,0.037023324694557574
2022-05-08,PM,Saint Pierre and Miquelon,26,2727,0,1,0.03667033370003667
2022-05-15,PM,Saint Pierre and Miquelon,12,2739,0,1,0.03650967506389193
2022-05-22,PM,Saint Pierre and Miquelon,9,2748,0,1,0.0363901018922853
2022-05-29,PM,Saint Pierre and Miquelon,2,2750,0,1,0.03636363636363636
2022-06-05,PM,Saint Pierre and Miquelon,12,2762,0,1,0.03620564808110065
2022-06-12,PM,Saint Pierre and Miquelon,3,2765,0,1,0.03616636528028933
2022-06-19,PM,Saint Pierre and Miquelon,0,2765,0,1,0.03616636528028933
2022-06-26,PM,Saint Pierre and Miquelon,2,2767,0,1,0.03614022406938923
2022-07-03,PM,Saint Pierre and Miquelon,12,2779,0,1,0.035984166966534725
2022-07-10,PM,Saint Pierre and Miquelon,78,2857,0,1,0.03500175008750438
2022-07-17,PM,Saint Pierre and Miquelon,113,2970,0,1,0.03367003367003367
2022-07-24,PM,Saint Pierre and Miquelon,56,3026,0,1,0.033046926635822864
2022-07-31,PM,Saint Pierre and Miquelon,57,3083,0,1,0.03243593902043464
2022-08-07,PM,Saint Pierre and Miquelon,29,3112,0,1,0.032133676092544985
2022-08-14,PM,Saint Pierre and Miquelon,19,3131,0,1,0.031938677738741615
2022-08-21,PM,Saint Pierre and Miquelon,6,3137,0,1,0.0318775900541919
2022-08-28,PM,Saint Pierre and Miquelon,9,3146,0,1,0.03178639542275906
2022-09-04,PM,Saint Pierre and Miquelon,12,3158,0,1,0.031665611146295125
2022-09-11,PM,Saint Pierre and Miquelon,8,3166,0,1,0.03158559696778269
2022-09-18,PM,Saint Pierre and Miquelon,14,3180,0,1,0.031446540880503145
2022-09-25,PM,Saint Pierre and Miquelon,8,3188,0,1,0.031367628607277286
2022-10-02,PM,Saint Pierre and Miquelon,11,3199,0,1,0.03125976867771178
2022-10-09,PM,Saint Pierre and Miquelon,2,3201,0,1,0.031240237425804434
2022-10-16,PM,Saint Pierre and Miquelon,6,3207,0,1,0.031181789834736514
2022-10-23,PM,Saint Pierre and Miquelon,5,3212,0,1,0.031133250311332503
2022-10-30,PM,Saint Pierre and Miquelon,2,3214,0,1,0.031113876789047916
2022-11-06,PM,Saint Pierre and Miquelon,1,3215,0,1,0.031104199066874026
2022-11-13,PM,Saint Pierre and Miquelon,3,3218,0,1,0.031075201988812924
2022-11-20,PM,Saint Pierre and Miquelon,17,3235,0,1,0.030911901081916538
2022-11-27,PM,Saint Pierre and Miquelon,35,3270,0,1,0.03058103975535168
2022-12-04,PM,Saint Pierre and Miquelon,24,3294,1,2,0.060716454159077116
2022-12-11,PM,Saint Pierre and Miquelon,26,3320,0,2,0.06024096385542169
2022-12-18,PM,Saint Pierre and Miquelon,16,3336,0,2,0.05995203836930455
2022-12-25,PM,Saint Pierre and Miquelon,12,3348,0,2,0.05973715651135006
2023-01-01,PM,Saint Pierre and Miquelon,19,3367,0,2,0.05940005940005939
2023-01-08,PM,Saint Pierre and Miquelon,28,3395,0,2,0.05891016200294551
2023-01-15,PM,Saint Pierre and Miquelon,5,3400,0,2,0.0588235294117647
2023-01-22,PM,Saint Pierre and Miquelon,5,3405,0,2,0.05873715124816446
2023-01-29,PM,Saint Pierre and Miquelon,5,3410,0,2,0.05865102639296188
2023-02-05,PM,Saint Pierre and Miquelon,2,3412,0,2,0.058616647127784284
2023-02-12,PM,Saint Pierre and Miquelon,1,3413,0,2,0.05859947260474656
2023-02-19,PM,Saint Pierre and Miquelon,2,3415,0,2,0.05856515373352855
2023-02-26,PM,Saint Pierre and Miquelon,2,3417,0,2,0.058530875036581796
2023-03-05,PM,Saint Pierre and Miquelon,1,3418,0,2,0.058513750731421885
2023-03-12,PM,Saint Pierre and Miquelon,5,3423,0,2,0.05842827928717499
2023-03-19,PM,Saint Pierre and Miquelon,1,3424,0,2,0.05841121495327102
2023-03-26,PM,Saint Pierre and Miquelon,2,3426,0,2,0.05837711617046118
2023-04-02,PM,Saint Pierre and Miquelon,0,3426,0,2,0.05837711617046118
2023-04-09,PM,Saint Pierre and Miquelon,0,3426,0,2,0.05837711617046118
2023-04-16,PM,Saint Pierre and Miquelon,0,3426,0,2,0.05837711617046118
2023-04-23,PM,Saint Pierre and Miquelon,0,3426,0,2,0.05837711617046118
2023-04-30,PM,Saint Pierre and Miquelon,0,3426,0,2,0.05837711617046118
2023-05-07,PM,Saint Pierre and Miquelon,0,3426,0,2,0.05837711617046118
2023-05-14,PM,Saint Pierre and Miquelon,0,3426,0,2,0.05837711617046118
2023-05-21,PM,Saint Pierre and Miquelon,0,3426,0,2,0.05837711617046118
2023-05-28,PM,Saint Pierre and Miquelon,0,3426,0,2,0.05837711617046118
2023-06-04,PM,Saint Pierre and Miquelon,0,3426,0,2,0.05837711617046118
2023-06-11,PM,Saint Pierre and Miquelon,0,3426,0,2,0.05837711617046118
2023-06-18,PM,Saint Pierre and Miquelon,0,3426,0,2,0.05837711617046118
2023-06-25,PM,Saint Pierre and Miquelon,0,3426,0,2,0.05837711617046118
2023-07-02,PM,Saint Pierre and Miquelon,0,3426,0,2,0.05837711617046118
2023-07-09,PM,Saint Pierre and Miquelon,0,3426,0,2,0.05837711617046118
2023-07-16,PM,Saint Pierre and Miquelon,0,3426,0,2,0.05837711617046118
2023-07-23,PM,Saint Pierre and Miquelon,0,3426,0,2,0.05837711617046118
2023-07-30,PM,Saint Pierre and Miquelon,0,3426,0,2,0.05837711617046118
2023-08-06,PM,Saint Pierre and Miquelon,0,3426,0,2,0.05837711617046118
2023-08-13,PM,Saint Pierre and Miquelon,0,3426,0,2,0.05837711617046118
2023-08-20,PM,Saint Pierre and Miquelon,0,3426,0,2,0.05837711617046118
2023-08-27,PM,Saint Pierre and Miquelon,0,3426,0,2,0.05837711617046118
2023-09-03,PM,Saint Pierre and Miquelon,0,3426,0,2,0.05837711617046118
2023-09-10,PM,Saint Pierre and Miquelon,0,3426,0,2,0.05837711617046118
2023-09-17,PM,Saint Pierre and Miquelon,0,3426,0,2,0.05837711617046118
2023-09-24,PM,Saint Pierre and Miquelon,0,3426,0,2,0.05837711617046118
2023-10-01,PM,Saint Pierre and Miquelon,0,3426,0,2,0.05837711617046118
2023-10-08,PM,Saint Pierre and Miquelon,0,3426,0,2,0.05837711617046118
2023-10-15,PM,Saint Pierre and Miquelon,0,3426,0,2,0.05837711617046118
2023-10-22,PM,Saint Pierre and Miquelon,0,3426,0,2,0.05837711617046118
2023-10-29,PM,Saint Pierre and Miquelon,0,3426,0,2,0.05837711617046118
2023-11-05,PM,Saint Pierre and Miquelon,0,3426,0,2,0.05837711617046118
2023-11-12,PM,Saint Pierre and Miquelon,0,3426,0,2,0.05837711617046118
2023-11-19,PM,Saint Pierre and Miquelon,0,3426,0,2,0.05837711617046118
2023-11-26,PM,Saint Pierre and Miquelon,0,3426,0,2,0.05837711617046118
2023-12-03,PM,Saint Pierre and Miquelon,0,3426,0,2,0.05837711617046118
2023-12-10,PM,Saint Pierre and Miquelon,0,3426,0,2,0.05837711617046118
2023-12-17,PM,Saint Pierre and Miquelon,0,3426,0,2,0.05837711617046118
2023-12-24,PM,Saint Pierre and Miquelon,0,3426,0,2,0.05837711617046118
2023-12-31,PM,Saint Pierre and Miquelon,0,3426,0,2,0.05837711617046118
2024-01-07,PM,Saint Pierre and Miquelon,0,3426,0,2,0.05837711617046118
2024-01-14,PM,Saint Pierre and Miquelon,0,3426,0,2,0.05837711617046118
2021-01-17,VC,Saint Vincent and the Grenadines,246,450,1,1,0.2222222222222222
2021-01-24,VC,Saint Vincent and the Grenadines,270,720,1,2,0.2777777777777778
2021-01-31,VC,Saint Vincent and the Grenadines,176,896,0,2,0.2232142857142857
2021-02-07,VC,Saint Vincent and the Grenadines,274,1170,1,3,0.2564102564102564
2021-02-14,VC,Saint Vincent and the Grenadines,248,1418,3,6,0.4231311706629055
2021-02-21,VC,Saint Vincent and the Grenadines,80,1498,0,6,0.4005340453938585
2021-02-28,VC,Saint Vincent and the Grenadines,58,1556,2,8,0.5141388174807198
2021-03-07,VC,Saint Vincent and the Grenadines,102,1658,0,8,0.48250904704463204
2021-03-14,VC,Saint Vincent and the Grenadines,22,1680,0,8,0.4761904761904762
2021-03-21,VC,Saint Vincent and the Grenadines,14,1694,1,9,0.5312868949232585
2021-03-28,VC,Saint Vincent and the Grenadines,27,1721,1,10,0.5810575246949448
2021-04-04,VC,Saint Vincent and the Grenadines,34,1755,0,10,0.5698005698005698
2021-04-11,VC,Saint Vincent and the Grenadines,35,1790,0,10,0.5586592178770949
2021-04-18,VC,Saint Vincent and the Grenadines,29,1819,0,10,0.5497526113249038
2021-04-25,VC,Saint Vincent and the Grenadines,11,1830,0,10,0.546448087431694
2021-05-02,VC,Saint Vincent and the Grenadines,34,1864,1,11,0.5901287553648069
2021-05-09,VC,Saint Vincent and the Grenadines,48,1912,1,12,0.6276150627615062
2021-05-16,VC,Saint Vincent and the Grenadines,20,1932,0,12,0.6211180124223602
2021-05-23,VC,Saint Vincent and the Grenadines,41,1973,0,12,0.6082108464267613
2021-05-30,VC,Saint Vincent and the Grenadines,54,2027,0,12,0.5920078934385792
2021-06-06,VC,Saint Vincent and the Grenadines,41,2068,0,12,0.5802707930367506
2021-06-13,VC,Saint Vincent and the Grenadines,33,2101,0,12,0.5711565920990005
2021-06-20,VC,Saint Vincent and the Grenadines,91,2192,0,12,0.5474452554744526
2021-06-27,VC,Saint Vincent and the Grenadines,26,2218,0,12,0.5410279531109108
2021-07-04,VC,Saint Vincent and the Grenadines,11,2229,0,12,0.5383580080753702
2021-07-11,VC,Saint Vincent and the Grenadines,12,2241,0,12,0.535475234270415
2021-07-18,VC,Saint Vincent and the Grenadines,19,2260,0,12,0.5309734513274336
2021-07-25,VC,Saint Vincent and the Grenadines,11,2271,0,12,0.5284015852047557
2021-08-01,VC,Saint Vincent and the Grenadines,25,2296,0,12,0.5226480836236934
2021-08-08,VC,Saint Vincent and the Grenadines,2,2298,0,12,0.5221932114882507
2021-08-15,VC,Saint Vincent and the Grenadines,10,2308,0,12,0.5199306759098787
2021-08-22,VC,Saint Vincent and the Grenadines,12,2320,0,12,0.5172413793103449
2021-08-29,VC,Saint Vincent and the Grenadines,17,2337,0,12,0.5134788189987163
2021-09-05,VC,Saint Vincent and the Grenadines,42,2379,0,12,0.5044136191677175
2021-09-12,VC,Saint Vincent and the Grenadines,134,2513,0,12,0.47751691205730207
2021-09-19,VC,Saint Vincent and the Grenadines,317,2830,2,14,0.49469964664310956
2021-09-26,VC,Saint Vincent and the Grenadines,529,3359,3,17,0.5061030068472759
2021-10-03,VC,Saint Vincent and the Grenadines,479,3838,11,28,0.7295466388744137
2021-10-10,VC,Saint Vincent and the Grenadines,612,4450,5,33,0.7415730337078652
2022-04-03,WS,Samoa,1500,2787,2,2,0.07176175098672408
2022-04-10,WS,Samoa,1166,3953,5,7,0.17708069820389577
2022-04-17,WS,Samoa,427,4380,2,9,0.2054794520547945
2022-04-24,WS,Samoa,3092,7472,4,13,0.17398286937901497
2022-05-01,WS,Samoa,2408,9880,6,19,0.19230769230769232
2022-05-08,WS,Samoa,1067,10947,1,20,0.18269845619804514
2022-05-15,WS,Samoa,1012,11959,4,24,0.2006856760598712
2022-05-22,WS,Samoa,711,12670,1,25,0.1973164956590371
2022-05-29,WS,Samoa,998,13668,0,25,0.1829089844893181
2022-06-05,WS,Samoa,544,14212,2,27,0.18998029833943147
2022-06-12,WS,Samoa,498,14710,1,28,0.1903467029231815
2022-06-19,WS,Samoa,350,15060,0,28,0.18592297476759628
2022-06-26,WS,Samoa,71,15131,1,29,0.1916595069724407
2022-07-03,WS,Samoa,121,15252,0,29,0.19013899816417518
2022-07-10,WS,Samoa,88,15340,0,29,0.18904823989569752
2022-07-17,WS,Samoa,131,15471,0,29,0.18744748238640035
2022-07-24,WS,Samoa,135,15606,0,29,0.18582596437267718
2022-07-31,WS,Samoa,87,15693,0,29,0.18479576881412094
2022-08-07,WS,Samoa,0,15693,0,29,0.18479576881412094
2022-08-14,WS,Samoa,0,15693,0,29,0.18479576881412094
2022-08-21,WS,Samoa,298,15991,0,29,0.18135201050590957
2022-08-28,WS,Samoa,64,16055,0,29,0.1806290875116786
2022-09-04,WS,Samoa,122,16177,0,29,0.17926686035729741
2022-09-11,WS,Samoa,36,16213,0,29,0.1788688089804478
2022-09-18,WS,Samoa,9,16222,0,29,0.17876957218592038
2022-09-25,WS,Samoa,0,16222,0,29,0.17876957218592038
2022-10-02,WS,Samoa,8,16230,0,29,0.1786814540973506
2022-10-09,WS,Samoa,0,16230,0,29,0.1786814540973506
2022-10-16,WS,Samoa,0,16230,0,29,0.1786814540973506
2022-10-23,WS,Samoa,4,16234,0,29,0.17863742762104226
2022-10-30,WS,Samoa,0,16234,0,29,0.17863742762104226
2022-11-06,WS,Samoa,3,16237,0,29,0.17860442199913776
2022-11-13,WS,Samoa,0,16237,0,29,0.17860442199913776
2022-11-20,WS,Samoa,15,16252,0,29,0.17843957666748708
2022-11-27,WS,Samoa,3,16255,0,29,0.17840664410950477
2022-12-04,WS,Samoa,3,16258,0,29,0.1783737237052528
2022-12-11,WS,Samoa,5,16263,0,29,0.17831888335485457
2022-12-18,WS,Samoa,7,16270,0,29,0.17824216349108787
2022-12-25,WS,Samoa,0,16270,0,29,0.17824216349108787
2023-01-01,WS,Samoa,9,16279,0,29,0.17814362061551692
2023-01-08,WS,Samoa,0,16279,0,29,0.17814362061551692
2023-01-15,WS,Samoa,17,16296,0,29,0.17795778105056456
2023-01-22,WS,Samoa,14,16310,0,29,0.17780502759043532
2023-01-29,WS,Samoa,83,16393,0,29,0.17690477642896357
2023-02-05,WS,Samoa,4,16397,0,29,0.17686162102823688
2023-02-12,WS,Samoa,5,16402,0,29,0.17680770637727106
2023-02-19,WS,Samoa,13,16415,0,29,0.1766676819981724
2023-02-26,WS,Samoa,3,16418,0,29,0.17663540017054452
2023-03-05,WS,Samoa,9,16427,0,29,0.17653862543373713
2023-03-12,WS,Samoa,0,16427,2,31,0.18871370304985696
2023-03-19,WS,Samoa,246,16673,0,31,0.18592934684819767
2023-03-26,WS,Samoa,2,16675,0,31,0.18590704647676162
2023-04-02,WS,Samoa,0,16675,0,31,0.18590704647676162
2023-04-09,WS,Samoa,62,16737,0,31,0.18521837844297065
2023-04-16,WS,Samoa,0,16737,0,31,0.18521837844297065
2023-04-23,WS,Samoa,0,16737,0,31,0.18521837844297065
2023-04-30,WS,Samoa,20,16757,0,31,0.18499731455511131
2023-05-07,WS,Samoa,6,16763,0,31,0.18493109825210283
2023-05-14,WS,Samoa,0,16763,0,31,0.18493109825210283
2023-05-21,WS,Samoa,0,16763,0,31,0.18493109825210283
2023-05-28,WS,Samoa,0,16763,0,31,0.18493109825210283
2023-06-04,WS,Samoa,-20,16743,0,31,0.185152003822493
2023-06-11,WS,Samoa,0,16743,0,31,0.185152003822493
2023-06-18,WS,Samoa,21,16764,0,31,0.18492006680983059
2023-06-25,WS,Samoa,7,16771,0,31,0.18484288354898337
2023-07-02,WS,Samoa,0,16771,0,31,0.18484288354898337
2023-07-09,WS,Samoa,4,16775,0,31,0.18479880774962743
2023-07-16,WS,Samoa,0,16775,0,31,0.18479880774962743
2023-07-23,WS,Samoa,0,16775,0,31,0.18479880774962743
2023-07-30,WS,Samoa,0,16775,0,31,0.18479880774962743
2023-08-06,WS,Samoa,0,16775,0,31,0.18479880774962743
2023-08-13,WS,Samoa,3,16778,0,31,0.18476576469185838
2023-08-20,WS,Samoa,0,16778,0,31,0.18476576469185838
2023-08-27,WS,Samoa,0,16778,0,31,0.18476576469185838
2023-09-03,WS,Samoa,0,16778,0,31,0.18476576469185838
2023-09-10,WS,Samoa,0,16778,0,31,0.18476576469185838
2023-09-17,WS,Samoa,0,16778,0,31,0.18476576469185838
2023-09-24,WS,Samoa,0,16778,0,31,0.18476576469185838
2023-10-01,WS,Samoa,0,16778,0,31,0.18476576469185838
2023-10-08,WS,Samoa,0,16778,0,31,0.18476576469185838
2023-10-15,WS,Samoa,0,16778,0,31,0.18476576469185838
2023-10-22,WS,Samoa,0,16778,0,31,0.18476576469185838
2023-10-29,WS,Samoa,0,16778,0,31,0.18476576469185838
2023-11-05,WS,Samoa,0,16778,0,31,0.18476576469185838
2023-11-12,WS,Samoa,0,16778,0,31,0.18476576469185838
2023-11-19,WS,Samoa,2,16780,0,31,0.18474374255065554
2023-11-26,WS,Samoa,182,16962,0,31,0.1827614668081594
2023-12-03,WS,Samoa,0,16962,0,31,0.1827614668081594
2023-12-10,WS,Samoa,0,16962,0,31,0.1827614668081594
2023-12-17,WS,Samoa,0,16962,0,31,0.1827614668081594
2023-12-24,WS,Samoa,0,16962,0,31,0.1827614668081594
2023-12-31,WS,Samoa,0,16962,0,31,0.1827614668081594
2024-01-07,WS,Samoa,0,16962,0,31,0.1827614668081594
2024-01-14,WS,Samoa,0,16962,0,31,0.1827614668081594
2022-01-16,SM,San Marino,1110,10722,0,103,0.9606416713299757
2022-01-23,SM,San Marino,1147,11869,4,107,0.9015081304237931
2022-01-30,SM,San Marino,1112,12981,2,109,0.8396887759032433
2022-02-06,SM,San Marino,647,13628,0,109,0.7998238919870855
2022-02-13,SM,San Marino,404,14032,1,110,0.7839224629418473
2022-02-20,SM,San Marino,200,14232,2,112,0.7869589657110737
2022-02-27,SM,San Marino,165,14397,0,112,0.7779398485795652
2022-03-06,SM,San Marino,151,14548,0,112,0.769865273577124
2022-03-13,SM,San Marino,195,14743,0,112,0.7596825612154922
2022-03-20,SM,San Marino,250,14993,0,112,0.7470152737944374
2022-03-27,SM,San Marino,215,15208,1,113,0.7430299842188323
2022-04-03,SM,San Marino,224,15432,0,113,0.7322446863659927
2022-04-10,SM,San Marino,268,15700,1,114,0.7261146496815286
2022-04-17,SM,San Marino,303,16003,0,114,0.7123664312941324
2022-04-24,SM,San Marino,273,16276,0,114,0.7004177930695503
2022-05-01,SM,San Marino,229,16505,1,115,0.6967585580127235
2022-05-08,SM,San Marino,176,16681,0,115,0.6894071098854985
2022-05-15,SM,San Marino,224,16905,0,115,0.6802721088435374
2022-05-22,SM,San Marino,129,17034,0,115,0.6751203475402137
2022-05-29,SM,San Marino,86,17120,0,115,0.6717289719626168
2022-06-05,SM,San Marino,89,17209,0,115,0.6682549828578069
2022-06-12,SM,San Marino,90,17299,0,115,0.6647783108850223
2022-06-19,SM,San Marino,210,17509,0,115,0.656805071677423
2022-06-26,SM,San Marino,269,17778,0,115,0.646866914163573
2022-07-03,SM,San Marino,461,18239,0,115,0.6305170239596469
2022-07-10,SM,San Marino,492,18731,1,116,0.6192942181410496
2022-07-17,SM,San Marino,522,19253,1,117,0.6076975016880486
2022-07-24,SM,San Marino,368,19621,1,118,0.6013964629733448
2022-07-31,SM,San Marino,280,19901,0,118,0.5929350283905331
2022-08-07,SM,San Marino,145,20046,0,118,0.5886461139379427
2022-08-14,SM,San Marino,115,20161,0,118,0.5852884281533655
2022-08-21,SM,San Marino,86,20247,0,118,0.5828023904776016
2022-08-28,SM,San Marino,95,20342,0,118,0.5800806213744961
2022-09-04,SM,San Marino,74,20416,0,118,0.5779780564263323
2022-09-11,SM,San Marino,85,20501,0,118,0.5755816789424906
2022-09-18,SM,San Marino,66,20567,0,118,0.5737346234258764
2022-09-25,SM,San Marino,104,20671,0,118,0.5708480479899376
2022-10-02,SM,San Marino,157,20828,0,118,0.5665450355290954
2022-10-09,SM,San Marino,226,21054,0,118,0.5604635698679585
2022-10-16,SM,San Marino,241,21295,0,118,0.55412068560695
2022-10-23,SM,San Marino,175,21470,1,119,0.5542617605961807
2022-10-30,SM,San Marino,135,21605,0,119,0.5507984262902106
2022-11-06,SM,San Marino,79,21684,0,119,0.5487917358420955
2022-11-13,SM,San Marino,111,21795,0,119,0.5459967882541867
2022-11-20,SM,San Marino,152,21947,0,119,0.5422153369481022
2022-11-27,SM,San Marino,221,22168,0,119,0.5368098159509203
2022-12-04,SM,San Marino,239,22407,0,119,0.5310840362386754
2022-12-11,SM,San Marino,211,22618,1,120,0.5305508886727386
2022-12-18,SM,San Marino,199,22817,0,120,0.5259236534163124
2022-12-25,SM,San Marino,190,23007,1,121,0.5259268918155344
2023-01-01,SM,San Marino,170,23177,0,121,0.5220692928334125
2023-01-08,SM,San Marino,114,23291,0,121,0.5195139753552874
2023-01-15,SM,San Marino,81,23372,1,122,0.5219921273318501
2023-01-22,SM,San Marino,33,23405,0,122,0.521256141850032
2023-01-29,SM,San Marino,22,23427,0,122,0.5207666367866137
2023-02-05,SM,San Marino,41,23468,0,122,0.5198568263166866
2023-02-12,SM,San Marino,26,23494,0,122,0.5192815186856219
2023-02-19,SM,San Marino,43,23537,0,122,0.5183328376598547
2023-02-26,SM,San Marino,46,23583,0,122,0.5173217996014078
2023-03-05,SM,San Marino,33,23616,0,122,0.51659891598916
2023-03-12,SM,San Marino,48,23664,0,122,0.5155510480054091
2023-03-19,SM,San Marino,83,23747,1,123,0.5179601633890597
2023-03-26,SM,San Marino,52,23799,0,123,0.5168284381696711
2023-04-02,SM,San Marino,47,23846,0,123,0.5158097794179317
2023-04-09,SM,San Marino,37,23883,0,123,0.5150106770506218
2023-04-16,SM,San Marino,77,23960,0,123,0.513355592654424
2023-04-23,SM,San Marino,73,24033,1,124,0.5159572254816294
2023-04-30,SM,San Marino,100,24133,1,125,0.5179629552894377
2023-05-07,SM,San Marino,75,24208,0,125,0.5163582286847324
2023-05-14,SM,San Marino,37,24245,0,125,0.5155702206640544
2023-05-21,SM,San Marino,23,24268,0,125,0.5150815889236855
2023-05-28,SM,San Marino,17,24285,0,125,0.5147210212065061
2023-06-04,SM,San Marino,14,24299,0,125,0.5144244619120129
2023-06-11,SM,San Marino,12,24311,0,125,0.5141705400847354
2023-06-18,SM,San Marino,8,24319,0,125,0.5140013980838027
2023-06-25,SM,San Marino,7,24326,0,125,0.5138534900929047
2023-07-02,SM,San Marino,0,24326,0,125,0.5138534900929047
2023-07-09,SM,San Marino,0,24326,0,125,0.5138534900929047
2023-07-16,SM,San Marino,13,24339,0,125,0.5135790295410658
2023-07-23,SM,San Marino,10,24349,0,125,0.5133681054663436
2023-07-30,SM,San Marino,9,24358,0,125,0.513178421873717
2023-08-06,SM,San Marino,9,24367,0,125,0.5129888784011163
2023-08-13,SM,San Marino,15,24382,0,125,0.5126732835698466
2023-08-20,SM,San Marino,0,24382,0,125,0.5126732835698466
2023-08-27,SM,San Marino,34,24416,1,126,0.5160550458715597
2023-09-03,SM,San Marino,31,24447,0,126,0.5154006626579949
2023-09-10,SM,San Marino,57,24504,0,126,0.514201762977473
2023-09-17,SM,San Marino,36,24540,0,126,0.5134474327628362
2023-09-24,SM,San Marino,55,24595,0,126,0.5122992478145965
2023-10-01,SM,San Marino,49,24644,0,126,0.5112806362603474
2023-10-08,SM,San Marino,53,24697,0,126,0.5101834230878244
2023-10-15,SM,San Marino,0,24697,0,126,0.5101834230878244
2023-10-22,SM,San Marino,0,24697,0,126,0.5101834230878244
2023-10-29,SM,San Marino,63,24760,0,126,0.5088852988691438
2023-11-05,SM,San Marino,44,24804,0,126,0.5079825834542816
2023-11-12,SM,San Marino,66,24870,0,126,0.5066344993968637
2023-11-19,SM,San Marino,263,25133,0,126,0.5013329089245215
2023-11-26,SM,San Marino,159,25292,0,126,0.498181243080816
2023-12-03,SM,San Marino,0,25292,0,126,0.498181243080816
2023-12-10,SM,San Marino,0,25292,0,126,0.498181243080816
2023-12-17,SM,San Marino,0,25292,0,126,0.498181243080816
2023-12-24,SM,San Marino,0,25292,0,126,0.498181243080816
2023-12-31,SM,San Marino,0,25292,0,126,0.498181243080816
2024-01-07,SM,San Marino,0,25292,0,126,0.498181243080816
2024-01-14,SM,San Marino,0,25292,0,126,0.498181243080816
2020-03-29,SA,Saudi Arabia,811,1203,4,4,0.3325020781379884
2020-04-26,SA,Saudi Arabia,8025,16299,44,136,0.8344070188355113
2020-05-03,SA,Saudi Arabia,9160,25459,40,176,0.6913075925998664
2020-05-10,SA,Saudi Arabia,11677,37136,63,239,0.6435803532959931
2020-05-17,SA,Saudi Arabia,14880,52016,63,302,0.5805905875115349
2020-05-24,SA,Saudi Arabia,18145,70161,77,379,0.5401861432989837
2020-05-31,SA,Saudi Arabia,13223,83384,101,480,0.5756500047970834
2020-06-07,SA,Saudi Arabia,15485,98869,196,676,0.6837330204614187
2020-06-14,SA,Saudi Arabia,24439,123308,256,932,0.7558309274337431
2020-06-21,SA,Saudi Arabia,30925,154233,298,1230,0.7974946995779114
2020-06-28,SA,Saudi Arabia,24271,178504,281,1511,0.8464796307085555
2020-07-05,SA,Saudi Arabia,27425,205929,347,1858,0.9022527181698545
2020-07-12,SA,Saudi Arabia,23551,229480,323,2181,0.9504096217535297
2020-07-19,SA,Saudi Arabia,18936,248416,266,2447,0.9850412211773799
2020-03-22,RS,Serbia,125,171,1,1,0.5847953216374269
2020-11-29,RS,Serbia,46910,163035,316,1484,0.9102339988346061
2020-12-06,RS,Serbia,50808,213843,407,1891,0.8842936172799671
2020-12-13,RS,Serbia,47594,261437,384,2275,0.8701905239120705
2020-12-20,RS,Serbia,35091,296528,357,2632,0.8876058921923056
2020-12-27,RS,Serbia,26839,323367,351,2983,0.9224812674144239
2021-01-03,RS,Serbia,18537,341904,305,3288,0.961673452197108
2021-02-28,RS,Serbia,22328,456450,108,4429,0.9703143827363347
2021-03-07,RS,Serbia,25947,482397,113,4542,0.9415481439561191
2021-03-14,RS,Serbia,29654,512051,152,4694,0.9167055625318572
2021-03-21,RS,Serbia,34845,546896,206,4900,0.895965594921155
2021-03-28,RS,Serbia,34721,581617,251,5151,0.8856343607563053
2021-04-04,RS,Serbia,32748,614365,271,5422,0.8825372539125764
2021-04-11,RS,Serbia,25111,639476,278,5700,0.8913547967398308
2021-04-18,RS,Serbia,20823,660299,254,5954,0.9017127089394349
2021-04-25,RS,Serbia,17673,677972,242,6196,0.9139020490521732
2021-05-02,RS,Serbia,12959,690931,190,6386,0.9242601649079286
2021-05-09,RS,Serbia,8643,699574,153,6539,0.934711695974979
2021-05-16,RS,Serbia,6316,705890,125,6664,0.9440564393885733
2021-05-23,RS,Serbia,3783,709673,102,6766,0.9533968461530875
2021-05-30,RS,Serbia,2373,712046,78,6844,0.9611738567452103
2021-06-06,RS,Serbia,1516,713562,65,6909,0.968241021803291
2021-06-13,RS,Serbia,1191,714753,49,6958,0.9734831473250201
2021-06-20,RS,Serbia,940,715693,39,6997,0.9776538264311654
2021-06-27,RS,Serbia,545,716238,32,7029,0.9813776984745294
2021-07-04,RS,Serbia,558,716796,26,7055,0.984240983487631
2021-07-11,RS,Serbia,684,717480,15,7070,0.985393321068183
2021-07-18,RS,Serbia,985,718465,10,7080,0.9854342243533089
2021-07-25,RS,Serbia,1448,719913,23,7103,0.986646997623324
2021-08-01,RS,Serbia,2005,721918,11,7114,0.985430478253763
2021-08-08,RS,Serbia,3327,725245,21,7135,0.983805472633386
2021-08-15,RS,Serbia,5982,731227,28,7163,0.9795863664771679
2021-08-22,RS,Serbia,9844,741071,43,7206,0.972376465952655
2021-08-29,RS,Serbia,14824,755895,51,7257,0.9600539757506003
2021-09-05,RS,Serbia,21028,776923,101,7358,0.9470694006999406
2021-09-12,RS,Serbia,34986,811909,162,7520,0.9262121740244288
2021-09-19,RS,Serbia,48522,860431,213,7733,0.8987356336533667
2021-09-26,RS,Serbia,45246,905677,275,8008,0.8842004379044626
2021-10-03,RS,Serbia,49995,955672,323,8331,0.871742606249843
2021-10-10,RS,Serbia,44693,1000365,352,8683,0.86798318613706
2021-10-17,RS,Serbia,43393,1043758,369,9052,0.8672508378378897
2021-10-24,RS,Serbia,48718,1092476,396,9448,0.8648244904235882
2021-10-31,RS,Serbia,45344,1137820,442,9890,0.8692060255576454
2021-11-07,RS,Serbia,41317,1179137,446,10336,0.8765732904658238
2021-11-14,RS,Serbia,29249,1208386,445,10781,0.8921818028345248
2021-11-21,RS,Serbia,22590,1230976,385,11166,0.9070851097015701
2021-11-28,RS,Serbia,17743,1248719,371,11537,0.9239068197088376
2021-12-05,RS,Serbia,13700,1262419,339,11876,0.940733623305733
2021-12-12,RS,Serbia,10684,1273103,272,12148,0.9542040196276342
2021-12-19,RS,Serbia,8556,1281659,216,12364,0.9646871749818009
2021-12-26,RS,Serbia,7834,1289493,204,12568,0.9746466246811731
2022-01-02,RS,Serbia,11456,1300949,171,12739,0.9792082548970021
2022-01-09,RS,Serbia,41697,1342646,151,12890,0.960044568709846
2022-01-16,RS,Serbia,82501,1425147,155,13045,0.915344171513535
2022-01-23,RS,Serbia,107594,1532741,194,13239,0.8637467125887545
2022-01-30,RS,Serbia,116552,1649293,274,13513,0.8193207635029071
2022-02-06,RS,Serbia,108448,1757741,415,13928,0.7923806749686103
2022-02-13,RS,Serbia,77233,1834974,438,14366,0.7828993762309439
2022-02-20,RS,Serbia,44263,1879237,421,14787,0.7868619019314753
2022-02-27,RS,Serbia,26905,1906142,368,15155,0.7950614382349268
2022-03-06,RS,Serbia,17835,1923977,250,15405,0.8006852472768645
2022-03-13,RS,Serbia,15173,1939150,165,15570,0.8029291184281773
2022-03-20,RS,Serbia,14747,1953897,106,15676,0.8022940820319598
2022-03-27,RS,Serbia,13874,1967771,70,15746,0.8001947381072289
2022-04-03,RS,Serbia,11958,1979729,72,15818,0.7989982467297293
2022-04-10,RS,Serbia,8987,1988716,59,15877,0.7983543150454866
2022-04-17,RS,Serbia,6635,1995351,46,15923,0.7980049625354136
2022-04-24,RS,Serbia,5793,2001144,30,15953,0.7971940050291233
2022-05-01,RS,Serbia,5209,2006353,38,15991,0.797018271460705
2022-05-08,RS,Serbia,3324,2009677,33,16024,0.7973420604405583
2022-05-15,RS,Serbia,2920,2012597,22,16046,0.7972783423606414
2022-05-22,RS,Serbia,2303,2014900,17,16063,0.7972107796912998
2022-05-29,RS,Serbia,1893,2016793,15,16078,0.7972062576575782
2022-06-05,RS,Serbia,1644,2018437,9,16087,0.7970028294170193
2022-06-12,RS,Serbia,1736,2020173,12,16099,0.7969119476401278
2022-06-19,RS,Serbia,2079,2022252,9,16108,0.7965377213126752
2022-06-26,RS,Serbia,3325,2025577,12,16120,0.7958226223935204
2022-07-03,RS,Serbia,5594,2031171,9,16129,0.794073960291871
2022-07-10,RS,Serbia,9056,2040227,18,16147,0.7914315416862928
2022-07-17,RS,Serbia,14409,2054636,21,16168,0.7869033736389317
2022-07-24,RS,Serbia,25753,2080389,38,16206,0.7789889294742474
2022-07-31,RS,Serbia,38284,2118673,65,16271,0.7679807124553908
2022-08-07,RS,Serbia,41580,2160253,76,16347,0.7567169215827961
2022-08-14,RS,Serbia,42786,2203039,91,16438,0.7461511121682367
2022-08-21,RS,Serbia,37513,2240552,87,16525,0.7375414629966187
2022-08-28,RS,Serbia,28869,2269421,106,16631,0.732830091904499
2022-09-04,RS,Serbia,22749,2292170,87,16718,0.7293525349341454
2022-09-11,RS,Serbia,21176,2313346,91,16809,0.7266098542976278
2022-09-18,RS,Serbia,19163,2332509,65,16874,0.7234270049976227
2022-09-25,RS,Serbia,14997,2347506,66,16940,0.7216168989557429
2022-10-02,RS,Serbia,15882,2363388,72,17012,0.7198140973890026
2022-10-09,RS,Serbia,13311,2376699,65,17077,0.7185175741648395
2022-10-16,RS,Serbia,10983,2387682,51,17128,0.7173484576254292
2022-10-23,RS,Serbia,8205,2395887,48,17176,0.7168952458943181
2022-10-30,RS,Serbia,6867,2402754,52,17228,0.7170105637114744
2022-11-06,RS,Serbia,5376,2408130,47,17275,0.7173616042323296
2022-11-13,RS,Serbia,4620,2412750,33,17308,0.7173557144337375
2022-11-20,RS,Serbia,4520,2417270,35,17343,0.7174622611458381
2022-11-27,RS,Serbia,4004,2421274,22,17365,0.7171844243980648
2022-12-04,RS,Serbia,3803,2425077,34,17399,0.7174617548226304
2022-12-11,RS,Serbia,4443,2429520,34,17433,0.7175491455102242
2022-12-18,RS,Serbia,4757,2434277,32,17465,0.7174614885651879
2022-12-25,RS,Serbia,5453,2439730,30,17495,0.7170875465727765
2023-01-01,RS,Serbia,6523,2446253,26,17521,0.7162382631722884
2023-01-08,RS,Serbia,6240,2452493,39,17560,0.7160061211183886
2023-01-15,RS,Serbia,6492,2458985,40,17600,0.7157424709788796
2023-01-22,RS,Serbia,5524,2464509,49,17649,0.7161264170672536
2023-01-29,RS,Serbia,4563,2469072,39,17688,0.7163825113240926
2023-02-05,RS,Serbia,5123,2474195,30,17718,0.7161117050192083
2023-02-12,RS,Serbia,5108,2479303,20,17738,0.7154430095877753
2023-02-19,RS,Serbia,4966,2484269,28,17766,0.7151399465999858
2023-02-26,RS,Serbia,6062,2490331,41,17807,0.7150455100145322
2023-03-05,RS,Serbia,5477,2495808,40,17847,0.7150790445418879
2023-03-12,RS,Serbia,5846,2501654,41,17888,0.7150469249544501
2023-03-19,RS,Serbia,5909,2507563,37,17925,0.7148374736746395
2023-03-26,RS,Serbia,6124,2513687,31,17956,0.71432919054759
2023-04-02,RS,Serbia,5265,2518952,14,17970,0.7133919185439024
2023-04-09,RS,Serbia,4608,2523560,23,17993,0.7130006815768201
2023-04-16,RS,Serbia,4080,2527640,9,18002,0.7122058520991913
2023-04-23,RS,Serbia,3818,2531458,10,18012,0.7115267170144636
2023-04-30,RS,Serbia,2892,2534350,6,18018,0.710951526032316
2023-05-07,RS,Serbia,2442,2536792,8,18026,0.7105824994717738
2023-05-14,RS,Serbia,1752,2538544,10,18036,0.7104860108786769
2023-05-21,RS,Serbia,1443,2539987,11,18047,0.7105154475200071
2023-05-28,RS,Serbia,1261,2541248,4,18051,0.710320283577203
2023-06-04,RS,Serbia,966,2542214,2,18053,0.7101290449977854
2023-06-11,RS,Serbia,617,2542831,4,18057,0.7101140421836921
2023-06-18,RS,Serbia,354,2543185,0,18057,0.7100151974787521
2023-06-25,RS,Serbia,535,2543720,0,18057,0.7098658657399399
2023-07-02,RS,Serbia,281,2544001,0,18057,0.7097874568445531
2023-07-09,RS,Serbia,227,2544228,0,18057,0.7097241284979177
2023-07-16,RS,Serbia,163,2544391,0,18057,0.7096786618094467
2023-07-23,RS,Serbia,147,2544538,0,18057,0.7096376631042649
2023-07-30,RS,Serbia,203,2544741,0,18057,0.7095810536317841
2023-08-06,RS,Serbia,211,2544952,0,18057,0.7095222228159902
2023-08-13,RS,Serbia,0,2544952,0,18057,0.7095222228159902
2023-08-20,RS,Serbia,234,2545186,0,18057,0.709456990569648
2023-08-27,RS,Serbia,420,2545606,0,18057,0.7093399371308835
2023-09-03,RS,Serbia,590,2546196,0,18057,0.7091755701446393
2023-09-10,RS,Serbia,686,2546882,0,18057,0.7089845544473595
2023-09-17,RS,Serbia,964,2547846,0,18057,0.7087163038896386
2023-09-24,RS,Serbia,1529,2549375,0,18057,0.7082912478548664
2023-10-01,RS,Serbia,2803,2552178,0,18057,0.7075133474232597
2023-10-08,RS,Serbia,3848,2556026,0,18057,0.7064482129680997
2023-10-15,RS,Serbia,3998,2560024,0,18057,0.7053449498910948
2023-10-22,RS,Serbia,3970,2563994,0,18057,0.7042528180643168
2023-10-29,RS,Serbia,3968,2567962,0,18057,0.7031646106912797
2023-11-05,RS,Serbia,4378,2572340,0,18057,0.701967858059199
2023-11-12,RS,Serbia,3862,2576202,0,18057,0.7009155337974274
2023-11-19,RS,Serbia,3684,2579886,0,18057,0.6999146473913964
2023-11-26,RS,Serbia,3584,2583470,0,18057,0.6989436687865545
2023-12-03,RS,Serbia,0,2583470,0,18057,0.6989436687865545
2023-12-10,RS,Serbia,0,2583470,0,18057,0.6989436687865545
2023-12-17,RS,Serbia,0,2583470,0,18057,0.6989436687865545
2023-12-24,RS,Serbia,0,2583470,0,18057,0.6989436687865545
2023-12-31,RS,Serbia,0,2583470,0,18057,0.6989436687865545
2024-01-07,RS,Serbia,0,2583470,0,18057,0.6989436687865545
2024-01-14,RS,Serbia,0,2583470,0,18057,0.6989436687865545
2021-01-10,SC,Seychelles,218,502,1,1,0.199203187250996
2021-01-17,SC,Seychelles,186,688,0,1,0.14534883720930233
2021-01-24,SC,Seychelles,345,1033,2,3,0.29041626331074544
2021-01-31,SC,Seychelles,191,1224,0,3,0.24509803921568626
2021-02-07,SC,Seychelles,280,1504,3,6,0.39893617021276595
2021-02-14,SC,Seychelles,388,1892,2,8,0.42283298097251587
2021-02-21,SC,Seychelles,436,2328,2,10,0.429553264604811
2021-02-28,SC,Seychelles,290,2618,1,11,0.42016806722689076
2021-03-07,SC,Seychelles,332,2950,4,15,0.5084745762711864
2021-03-14,SC,Seychelles,223,3173,1,16,0.5042546485975418
2021-03-21,SC,Seychelles,443,3616,2,18,0.497787610619469
2021-03-28,SC,Seychelles,438,4054,0,18,0.4440059200789344
2021-04-04,SC,Seychelles,240,4294,4,22,0.5123428039124359
2021-04-11,SC,Seychelles,196,4490,2,24,0.5345211581291759
2021-04-18,SC,Seychelles,344,4834,1,25,0.517170045510964
2021-04-25,SC,Seychelles,182,5016,0,25,0.4984051036682616
2021-05-02,SC,Seychelles,1053,6069,3,28,0.461361014994233
2021-05-09,SC,Seychelles,2103,8172,0,28,0.34263338228095935
2021-05-16,SC,Seychelles,1371,9543,7,35,0.36676097663208634
2021-05-23,SC,Seychelles,1126,10669,3,38,0.3561720873558909
2021-05-30,SC,Seychelles,746,11415,2,40,0.3504161191414805
2021-06-06,SC,Seychelles,823,12238,2,42,0.3431933322438307
2021-06-13,SC,Seychelles,1176,13414,1,43,0.32056060831966604
2021-06-20,SC,Seychelles,1000,14414,9,52,0.360760371860691
2021-06-27,SC,Seychelles,1013,15427,3,55,0.35651779347896545
2021-07-04,SC,Seychelles,722,16149,2,57,0.3529630317666729
2021-07-11,SC,Seychelles,750,16899,11,68,0.402390674004379
2021-07-18,SC,Seychelles,536,17435,7,75,0.43016919988528823
2021-07-25,SC,Seychelles,621,18056,11,86,0.4762959680992468
2021-08-01,SC,Seychelles,306,18362,5,91,0.4955887158261627
2021-08-08,SC,Seychelles,383,18745,0,91,0.48546279007735393
2021-08-15,SC,Seychelles,404,19149,7,98,0.5117760718575383
2021-08-22,SC,Seychelles,437,19586,0,98,0.5003573981415297
2021-08-29,SC,Seychelles,406,19992,4,102,0.5102040816326531
2021-09-05,SC,Seychelles,348,20340,1,103,0.5063913470993117
2021-09-12,SC,Seychelles,425,20765,3,106,0.5104743558873104
2021-09-19,SC,Seychelles,370,21135,4,110,0.5204636858291932
2021-09-26,SC,Seychelles,269,21404,0,110,0.5139226312838722
2021-10-03,SC,Seychelles,172,21576,2,112,0.5190952910641453
2021-10-10,SC,Seychelles,221,21797,0,112,0.5138321787401936
2021-10-17,SC,Seychelles,163,21960,2,114,0.5191256830601093
2021-10-24,SC,Seychelles,188,22148,0,114,0.5147191620010836
2021-10-31,SC,Seychelles,130,22278,0,114,0.5117155938594129
2021-11-07,SC,Seychelles,161,22439,0,114,0.5080440304826418
2021-11-14,SC,Seychelles,234,22673,0,114,0.5028006880430468
2021-11-21,SC,Seychelles,301,22974,8,122,0.5310350831374597
2021-11-28,SC,Seychelles,375,23349,0,122,0.5225063171870316
2021-12-05,SC,Seychelles,302,23651,0,122,0.5158344256056826
2021-12-12,SC,Seychelles,217,23868,4,126,0.5279034690799397
2021-12-19,SC,Seychelles,231,24099,0,126,0.5228432715050417
2021-12-26,SC,Seychelles,282,24381,0,126,0.516795865633075
2022-01-02,SC,Seychelles,782,25163,0,126,0.5007352064539204
2022-01-09,SC,Seychelles,3095,28258,0,126,0.44589142897586526
2022-01-16,SC,Seychelles,3936,32194,0,126,0.3913772752686836
2022-01-23,SC,Seychelles,2984,35178,10,136,0.38660526465404516
2022-01-30,SC,Seychelles,1845,37023,6,142,0.3835453636928396
2022-02-06,SC,Seychelles,1003,38026,5,147,0.386577604796718
2022-02-13,SC,Seychelles,633,38659,3,150,0.3880079670969244
2022-02-20,SC,Seychelles,431,39090,1,151,0.3862880532105398
2022-02-27,SC,Seychelles,252,39342,12,163,0.41431548980733063
2022-03-06,SC,Seychelles,174,39516,0,163,0.41249114282822147
2022-03-13,SC,Seychelles,151,39667,0,163,0.4109209166309527
2022-03-20,SC,Seychelles,216,39883,0,163,0.40869543414487375
2022-03-27,SC,Seychelles,240,40123,0,163,0.40625077885502076
2022-04-03,SC,Seychelles,514,40637,0,163,0.40111228683219724
2022-04-10,SC,Seychelles,694,41331,0,163,0.39437710193317366
2022-04-17,SC,Seychelles,520,41851,0,163,0.3894769539557
2022-04-24,SC,Seychelles,425,42276,0,163,0.38556154792317154
2022-05-01,SC,Seychelles,357,42633,3,166,0.3893697370581475
2022-05-08,SC,Seychelles,447,43080,0,166,0.3853296193129062
2022-05-15,SC,Seychelles,393,43473,1,167,0.3841464817242886
2022-05-22,SC,Seychelles,324,43797,0,167,0.3813046555700162
2022-05-29,SC,Seychelles,208,44005,0,167,0.37950232928076355
2022-06-05,SC,Seychelles,187,44192,0,167,0.37789645184648807
2022-06-12,SC,Seychelles,205,44397,0,167,0.37615154177084037
2022-06-19,SC,Seychelles,88,44485,0,167,0.3754074407103518
2022-06-26,SC,Seychelles,184,44669,0,167,0.3738610669591887
2022-07-03,SC,Seychelles,249,44918,0,167,0.3717885925464179
2022-07-10,SC,Seychelles,171,45089,0,167,0.3703785845771696
2022-07-17,SC,Seychelles,173,45262,1,168,0.37117228580266004
2022-07-24,SC,Seychelles,7,45269,0,168,0.3711148909850008
2022-07-31,SC,Seychelles,160,45429,0,168,0.3698078320015849
2022-08-07,SC,Seychelles,111,45540,0,168,0.3689064558629776
2022-08-14,SC,Seychelles,152,45692,0,168,0.36767924363127025
2022-08-21,SC,Seychelles,160,45852,0,168,0.36639623135304894
2022-08-28,SC,Seychelles,0,45852,0,168,0.36639623135304894
2022-09-04,SC,Seychelles,229,46081,1,169,0.3667455133352141
2022-09-11,SC,Seychelles,94,46175,0,169,0.365998917162967
2022-09-18,SC,Seychelles,183,46358,0,169,0.36455412226584405
2022-09-25,SC,Seychelles,0,46358,0,169,0.36455412226584405
2022-10-02,SC,Seychelles,783,47141,0,169,0.35849897117159163
2022-10-09,SC,Seychelles,0,47141,0,169,0.35849897117159163
2022-10-16,SC,Seychelles,1042,48183,1,170,0.3528215345661333
2022-10-23,SC,Seychelles,852,49035,1,171,0.34873049862343225
2022-10-30,SC,Seychelles,345,49380,0,171,0.34629404617253945
2022-11-06,SC,Seychelles,266,49646,0,171,0.34443862546831566
2022-11-13,SC,Seychelles,216,49862,0,171,0.34294653242950546
2022-11-20,SC,Seychelles,206,50068,0,171,0.3415355117040825
2022-11-27,SC,Seychelles,0,50068,0,171,0.3415355117040825
2022-12-04,SC,Seychelles,287,50355,1,172,0.34157481878661505
2022-12-11,SC,Seychelles,0,50355,0,172,0.34157481878661505
2022-12-18,SC,Seychelles,0,50355,0,172,0.34157481878661505
2022-12-25,SC,Seychelles,0,50355,0,172,0.34157481878661505
2023-01-01,SC,Seychelles,310,50665,0,172,0.3394848514753775
2023-01-08,SC,Seychelles,0,50665,0,172,0.3394848514753775
2023-01-15,SC,Seychelles,0,50665,0,172,0.3394848514753775
2023-01-22,SC,Seychelles,0,50665,0,172,0.3394848514753775
2023-01-29,SC,Seychelles,0,50665,0,172,0.3394848514753775
2023-02-05,SC,Seychelles,0,50665,0,172,0.3394848514753775
2023-02-12,SC,Seychelles,0,50665,0,172,0.3394848514753775
2023-02-19,SC,Seychelles,0,50665,0,172,0.3394848514753775
2023-02-26,SC,Seychelles,0,50665,0,172,0.3394848514753775
2023-03-05,SC,Seychelles,272,50937,0,172,0.3376720262284783
2023-03-12,SC,Seychelles,0,50937,0,172,0.3376720262284783
2023-03-19,SC,Seychelles,0,50937,0,172,0.3376720262284783
2023-03-26,SC,Seychelles,0,50937,0,172,0.3376720262284783
2023-04-02,SC,Seychelles,0,50937,0,172,0.3376720262284783
2023-04-09,SC,Seychelles,0,50937,0,172,0.3376720262284783
2023-04-16,SC,Seychelles,0,50937,0,172,0.3376720262284783
2023-04-23,SC,Seychelles,0,50937,0,172,0.3376720262284783
2023-04-30,SC,Seychelles,0,50937,0,172,0.3376720262284783
2023-05-07,SC,Seychelles,0,50937,0,172,0.3376720262284783
2023-05-14,SC,Seychelles,0,50937,0,172,0.3376720262284783
2023-05-21,SC,Seychelles,0,50937,0,172,0.3376720262284783
2023-05-28,SC,Seychelles,0,50937,0,172,0.3376720262284783
2023-06-04,SC,Seychelles,0,50937,0,172,0.3376720262284783
2023-06-11,SC,Seychelles,0,50937,0,172,0.3376720262284783
2023-06-18,SC,Seychelles,0,50937,0,172,0.3376720262284783
2023-06-25,SC,Seychelles,0,50937,0,172,0.3376720262284783
2023-07-02,SC,Seychelles,0,50937,0,172,0.3376720262284783
2023-07-09,SC,Seychelles,0,50937,0,172,0.3376720262284783
2023-07-16,SC,Seychelles,0,50937,0,172,0.3376720262284783
2023-07-23,SC,Seychelles,0,50937,0,172,0.3376720262284783
2023-07-30,SC,Seychelles,0,50937,0,172,0.3376720262284783
2023-08-06,SC,Seychelles,0,50937,0,172,0.3376720262284783
2023-08-13,SC,Seychelles,0,50937,0,172,0.3376720262284783
2023-08-20,SC,Seychelles,0,50937,0,172,0.3376720262284783
2023-08-27,SC,Seychelles,0,50937,0,172,0.3376720262284783
2023-09-03,SC,Seychelles,0,50937,0,172,0.3376720262284783
2023-09-10,SC,Seychelles,0,50937,0,172,0.3376720262284783
2023-09-17,SC,Seychelles,0,50937,0,172,0.3376720262284783
2023-09-24,SC,Seychelles,0,50937,0,172,0.3376720262284783
2023-10-01,SC,Seychelles,0,50937,0,172,0.3376720262284783
2023-10-08,SC,Seychelles,17,50954,0,172,0.3375593672724418
2023-10-15,SC,Seychelles,11,50965,0,172,0.33748651035024035
2023-10-22,SC,Seychelles,0,50965,0,172,0.33748651035024035
2023-10-29,SC,Seychelles,12,50977,0,172,0.33740706593169467
2023-11-05,SC,Seychelles,24,51001,0,172,0.3372482892492304
2023-11-12,SC,Seychelles,44,51045,0,172,0.3369575864433343
2023-11-19,SC,Seychelles,41,51086,0,172,0.3366871549935403
2023-11-26,SC,Seychelles,53,51139,0,172,0.3363382154520034
2023-12-03,SC,Seychelles,81,51220,0,172,0.3358063256540414
2023-12-10,SC,Seychelles,0,51220,0,172,0.3358063256540414
2023-12-17,SC,Seychelles,0,51220,0,172,0.3358063256540414
2023-12-24,SC,Seychelles,0,51220,0,172,0.3358063256540414
2023-12-31,SC,Seychelles,-40,51180,0,172,0.33606877686596326
2024-01-07,SC,Seychelles,0,51180,0,172,0.33606877686596326
2024-01-14,SC,Seychelles,0,51180,0,172,0.33606877686596326
2020-03-22,SG,Singapore,220,432,2,2,0.4629629629629629
2020-03-29,SG,Singapore,370,802,0,2,0.24937655860349126
2020-04-05,SG,Singapore,387,1189,3,5,0.42052144659377627
2020-04-12,SG,Singapore,1110,2299,3,8,0.34797738147020446
2020-04-19,SG,Singapore,3693,5992,3,11,0.18357810413885178
2020-04-26,SG,Singapore,6701,12693,1,12,0.09454029780193808
2020-05-03,SG,Singapore,4855,17548,5,17,0.09687713699566902
2020-05-10,SG,Singapore,4912,22460,3,20,0.08904719501335707
2020-05-17,SG,Singapore,4896,27356,2,22,0.08042111419798216
2020-05-24,SG,Singapore,3712,31068,1,23,0.07403115746105317
2020-05-31,SG,Singapore,3298,34366,0,23,0.06692661351335623
2020-06-07,SG,Singapore,3161,37527,2,25,0.06661870120180137
2020-06-14,SG,Singapore,2670,40197,1,26,0.06468144388884743
2020-06-21,SG,Singapore,1636,41833,0,26,0.06215188965649129
2020-06-28,SG,Singapore,1413,43246,0,26,0.06012116727558618
2020-07-05,SG,Singapore,1418,44664,0,26,0.05821243059287122
2020-07-12,SG,Singapore,1118,45782,0,26,0.056790878511205276
2020-07-19,SG,Singapore,1873,47655,1,27,0.05665722379603399
2020-07-26,SG,Singapore,2233,49888,0,27,0.05412123155869147
2020-08-02,SG,Singapore,2624,52512,0,27,0.05141681901279707
2020-08-09,SG,Singapore,2417,54929,0,27,0.0491543629048408
2020-08-16,SG,Singapore,732,55661,0,27,0.04850793194516807
2020-08-23,SG,Singapore,605,56266,0,27,0.047986350549177124
2020-08-30,SG,Singapore,451,56717,0,27,0.047604774582576656
2020-09-06,SG,Singapore,265,56982,0,27,0.04738338422659787
2020-09-13,SG,Singapore,375,57357,0,27,0.04707359171504786
2020-09-20,SG,Singapore,201,57558,0,27,0.04690920462837486
2020-09-27,SG,Singapore,127,57685,0,27,0.046805928750975126
2020-10-04,SG,Singapore,115,57800,0,27,0.04671280276816609
2020-10-11,SG,Singapore,66,57866,0,27,0.04665952372723188
2020-10-18,SG,Singapore,38,57904,1,28,0.04835589941972921
2020-10-25,SG,Singapore,61,57965,0,28,0.048305011644958165
2020-11-01,SG,Singapore,50,58015,0,28,0.04826338016030337
2020-11-08,SG,Singapore,39,58054,0,28,0.04823095738450408
2020-11-15,SG,Singapore,62,58116,0,28,0.04817950306283984
2020-11-22,SG,Singapore,32,58148,0,28,0.04815298892481255
2020-11-29,SG,Singapore,57,58205,1,29,0.049823898290524866
2020-12-06,SG,Singapore,50,58255,0,29,0.04978113466655223
2020-12-13,SG,Singapore,58,58313,0,29,0.04973162073637097
2020-12-20,SG,Singapore,90,58403,0,29,0.04965498347687619
2020-12-27,SG,Singapore,116,58519,0,29,0.049556554281515404
2021-01-03,SG,Singapore,178,58697,0,29,0.049406272892992834
2021-01-10,SG,Singapore,210,58907,0,29,0.049230142427894814
2021-01-17,SG,Singapore,206,59113,0,29,0.04905858271446213
2021-01-24,SG,Singapore,195,59308,0,29,0.048897281985566865
2021-01-31,SG,Singapore,228,59536,0,29,0.048710024187046494
2021-02-07,SG,Singapore,163,59699,0,29,0.0485770280909228
2021-02-14,SG,Singapore,101,59800,0,29,0.04849498327759197
2021-02-21,SG,Singapore,69,59869,0,29,0.0484390920175717
2021-02-28,SG,Singapore,67,59936,0,29,0.04838494394020288
2021-03-07,SG,Singapore,97,60033,0,29,0.048306764612796295
2021-03-14,SG,Singapore,72,60105,0,29,0.048248897762249394
2021-03-21,SG,Singapore,91,60196,0,29,0.04817595853545086
2021-03-28,SG,Singapore,104,60300,0,29,0.04809286898839138
2021-04-04,SG,Singapore,178,60478,0,29,0.04795132114157214
2021-04-11,SG,Singapore,175,60653,0,29,0.04781296885562132
2021-04-18,SG,Singapore,178,60831,0,29,0.0476730614324933
2021-04-25,SG,Singapore,175,61006,0,29,0.047536307904140575
2021-05-02,SG,Singapore,212,61218,2,31,0.050638701035643115
2021-05-09,SG,Singapore,141,61359,0,31,0.050522335761664955
2021-05-16,SG,Singapore,226,61585,0,31,0.05033693269464967
2021-05-23,SG,Singapore,239,61824,1,32,0.051759834368530024
2021-05-30,SG,Singapore,204,62028,1,33,0.05320177984136197
2021-06-06,SG,Singapore,168,62196,0,33,0.05305807447424271
2021-06-13,SG,Singapore,80,62276,1,34,0.05459567088444987
2021-06-20,SG,Singapore,138,62414,0,34,0.054474957541577204
2021-06-27,SG,Singapore,130,62544,2,36,0.05755947812739831
2021-07-04,SG,Singapore,73,62617,0,36,0.057492374275356535
2021-07-11,SG,Singapore,75,62692,0,36,0.05742359471702928
2021-07-18,SG,Singapore,381,63073,0,36,0.057076720625307185
2021-07-25,SG,Singapore,1106,64179,1,37,0.05765125664158058
2021-08-01,SG,Singapore,923,65102,0,37,0.056833891431906855
2021-08-08,SG,Singapore,662,65764,5,42,0.06386472842284532
2021-08-15,SG,Singapore,408,66172,2,44,0.06649338088617542
2021-08-22,SG,Singapore,306,66478,5,49,0.07370859532476909
2021-08-29,SG,Singapore,826,67304,6,55,0.08171876857244739
2021-09-05,SG,Singapore,1356,68660,0,55,0.0801048645499563
2021-09-12,SG,Singapore,3027,71687,3,58,0.08090727747011313
2021-09-19,SG,Singapore,6117,77804,2,60,0.07711685774510309
2021-09-26,SG,Singapore,10088,87892,18,78,0.08874527829609066
2021-10-03,SG,Singapore,15951,103843,35,113,0.10881811966141194
2021-10-10,SG,Singapore,23123,126966,49,162,0.1275932139312887
2021-10-17,SG,Singapore,21212,148178,71,233,0.1572433154719324
2021-10-24,SG,Singapore,24466,172644,82,315,0.1824563842357684
2021-10-31,SG,Singapore,25730,198374,92,407,0.20516801596983475
2021-11-07,SG,Singapore,19959,218333,90,497,0.2276339353189852
2021-11-14,SG,Singapore,18870,237203,89,586,0.2470457793535495
2021-11-21,SG,Singapore,14985,252188,76,662,0.26250257744222566
2021-11-28,SG,Singapore,10195,262383,39,701,0.26716669906205814
2021-12-05,SG,Singapore,6828,269211,58,759,0.28193498779767545
2021-12-12,SG,Singapore,4151,273362,35,794,0.2904573422787366
2021-12-19,SG,Singapore,2548,275910,19,813,0.29466130259867346
2021-12-26,SG,Singapore,1854,277764,9,822,0.29593467836004667
2022-01-02,SG,Singapore,2526,280290,7,829,0.29576510043169574
2022-01-09,SG,Singapore,5357,285647,9,838,0.293369088420323
2022-01-16,SG,Singapore,6202,291849,5,843,0.2888480001644686
2022-01-23,SG,Singapore,21923,313772,5,848,0.2702599339647897
2022-01-30,SG,Singapore,34558,348330,6,854,0.24516981023741855
2022-02-06,SG,Singapore,49493,397823,17,871,0.21894158960140564
2022-02-13,SG,Singapore,71672,469495,26,897,0.1910563477779316
2022-02-20,SG,Singapore,113143,582638,48,945,0.16219333445466996
2022-02-27,SG,Singapore,128242,710880,62,1007,0.14165541300922802
2022-03-06,SG,Singapore,121941,832821,71,1078,0.12943957945344797
2022-03-13,SG,Singapore,106615,939436,67,1145,0.12188163962207112
2022-03-20,SG,Singapore,75581,1015017,53,1198,0.11802757983363826
2022-03-27,SG,Singapore,56988,1072005,48,1246,0.116230801162308
2022-04-03,SG,Singapore,37739,1109744,28,1274,0.11480125145979614
2022-04-10,SG,Singapore,28257,1138001,20,1294,0.11370816018615097
2022-04-17,SG,Singapore,22299,1160300,22,1316,0.11341894337671293
2022-04-24,SG,Singapore,21868,1182168,9,1325,0.11208220828173322
2022-05-01,SG,Singapore,17472,1199640,11,1336,0.11136674335634024
2022-05-08,SG,Singapore,18282,1217922,16,1352,0.11100875097091603
2022-05-15,SG,Singapore,24962,1242884,11,1363,0.1096642969094461
2022-05-22,SG,Singapore,26751,1269635,12,1375,0.10829884179311376
2022-05-29,SG,Singapore,26285,1295920,8,1383,0.10671955058954255
2022-06-05,SG,Singapore,23064,1318984,10,1393,0.10561159195259381
2022-06-12,SG,Singapore,22272,1341256,5,1398,0.10423066140990236
2022-06-19,SG,Singapore,26505,1367761,7,1405,0.10272262478605546
2022-06-26,SG,Singapore,40597,1408358,4,1409,0.10004558500040474
2022-07-03,SG,Singapore,52749,1461107,10,1419,0.09711814398261044
2022-07-10,SG,Singapore,62774,1523881,13,1432,0.09397059219191
2022-07-17,SG,Singapore,65218,1589099,25,1457,0.09168717619229512
2022-07-24,SG,Singapore,63882,1652981,26,1483,0.08971669970798213
2022-07-31,SG,Singapore,55969,1708950,37,1520,0.08894350332075251
2022-08-07,SG,Singapore,45827,1754777,21,1541,0.08781742637383554
2022-08-14,SG,Singapore,36269,1791046,19,1560,0.08709994048170733
2022-08-21,SG,Singapore,23871,1814917,24,1584,0.08727671843946583
2022-08-28,SG,Singapore,16415,1831332,7,1591,0.08687665589854816
2022-09-04,SG,Singapore,13453,1844785,5,1596,0.08651414663497371
2022-09-11,SG,Singapore,13712,1858497,6,1602,0.08619868635784723
2022-09-18,SG,Singapore,14793,1873290,6,1608,0.08583828451547812
2022-09-25,SG,Singapore,16254,1889544,7,1615,0.08547035686917055
2022-10-02,SG,Singapore,21873,1911417,7,1622,0.084858510727905
2022-10-09,SG,Singapore,36985,1948402,10,1632,0.08376094871592207
2022-10-16,SG,Singapore,57482,2005884,14,1646,0.0820585836469108
2022-10-23,SG,Singapore,53825,2059709,17,1663,0.08073956078261542
2022-10-30,SG,Singapore,36811,2096520,17,1680,0.08013279148302901
2022-11-06,SG,Singapore,24915,2121435,10,1690,0.07966305826009282
2022-11-13,SG,Singapore,16441,2137876,7,1697,0.07937784979110107
2022-11-20,SG,Singapore,10918,2148794,3,1700,0.07911414495759017
2022-11-27,SG,Singapore,13800,2162594,2,1702,0.07870178128673251
2022-12-04,SG,Singapore,8795,2171389,4,1706,0.07856722125791371
2022-12-11,SG,Singapore,8366,2179755,1,1707,0.07831155336264856
2022-12-18,SG,Singapore,8654,2188409,3,1710,0.0781389584853654
2022-12-25,SG,Singapore,5481,2193890,1,1711,0.0779893248977843
2023-01-01,SG,Singapore,8324,2202214,0,1711,0.07769453831462338
2023-01-08,SG,Singapore,5456,2207670,1,1712,0.07754782191178936
2023-01-15,SG,Singapore,3876,2211546,0,1712,0.0774119100394023
2023-01-22,SG,Singapore,2518,2214064,0,1712,0.07732387139667146
2023-01-29,SG,Singapore,1825,2215889,0,1712,0.0772601876718554
2023-02-05,SG,Singapore,2992,2218881,10,1722,0.07760668553203169
2023-02-12,SG,Singapore,2881,2221762,0,1722,0.07750605150326632
2023-02-19,SG,Singapore,244,2222006,0,1722,0.07749754051069169
2023-02-26,SG,Singapore,3849,2225855,0,1722,0.07736352996938255
2023-03-05,SG,Singapore,4471,2230326,0,1722,0.07720844396738415
2023-03-12,SG,Singapore,4426,2234752,0,1722,0.07705553009908929
2023-03-19,SG,Singapore,10352,2245104,0,1722,0.0767002330404293
2023-03-26,SG,Singapore,10464,2255568,0,1722,0.07634440637568896
2023-04-02,SG,Singapore,14467,2270035,0,1722,0.07585786122240405
2023-04-09,SG,Singapore,28410,2298445,12,1734,0.07544230990952579
2023-04-16,SG,Singapore,16018,2314463,0,1734,0.07492018666965079
2023-04-23,SG,Singapore,26072,2340535,0,1734,0.07408562572232416
2023-04-30,SG,Singapore,27818,2368353,0,1734,0.07321543705689143
2023-05-07,SG,Singapore,23417,2391770,54,1788,0.07475635199036697
2023-05-14,SG,Singapore,22624,2414394,0,1788,0.07405585003938876
2023-05-21,SG,Singapore,24296,2438690,0,1788,0.07331805190491616
2023-05-28,SG,Singapore,20767,2459457,0,1788,0.0726989737978749
2023-06-04,SG,Singapore,14851,2474308,53,1841,0.07440464162101079
2023-06-11,SG,Singapore,8531,2482839,0,1841,0.07414898831539217
2023-06-18,SG,Singapore,10432,2493271,4,1845,0.07399917618261312
2023-06-25,SG,Singapore,6717,2499988,27,1872,0.07488035942572524
2023-07-02,SG,Singapore,11736,2511724,0,1872,0.07453048185230543
2023-07-09,SG,Singapore,4302,2516026,0,1872,0.07440304670937423
2023-07-16,SG,Singapore,8544,2524570,0,1872,0.07415124159757899
2023-07-23,SG,Singapore,5632,2530202,0,1872,0.07398618766406793
2023-07-30,SG,Singapore,4738,2534940,0,1872,0.07384790172548464
2023-08-06,SG,Singapore,4951,2539891,0,1872,0.07370395028763045
2023-08-13,SG,Singapore,3485,2543376,7,1879,0.07387818395707123
2023-08-20,SG,Singapore,4951,2548327,0,1879,0.07373465022346033
2023-08-27,SG,Singapore,7045,2555372,0,1879,0.0735313684269844
2023-09-03,SG,Singapore,6650,2562022,0,1879,0.07334050995658897
2023-09-10,SG,Singapore,4295,2566317,10,1889,0.0736074304148708
2023-09-17,SG,Singapore,7248,2573565,0,1889,0.07340012783823219
2023-09-24,SG,Singapore,6401,2579966,0,1889,0.07321801915219037
2023-10-01,SG,Singapore,14843,2594809,0,1889,0.07279919254172465
2023-10-08,SG,Singapore,15336,2610145,17,1906,0.07302276310319925
2023-10-15,SG,Singapore,16250,2626395,0,1906,0.07257095752923685
2023-10-22,SG,Singapore,14801,2641196,0,1906,0.07216427709265044
2023-10-29,SG,Singapore,17123,2658319,0,1906,0.07169944615375357
2023-11-05,SG,Singapore,16062,2674381,0,1906,0.07126882818865375
2023-11-12,SG,Singapore,16395,2690776,27,1933,0.07183801252872778
2023-11-19,SG,Singapore,15441,2706217,0,1933,0.07142812272630022
2023-11-26,SG,Singapore,10726,2716943,0,1933,0.07114613740516457
2023-12-03,SG,Singapore,22094,2739037,0,1933,0.07057224856765353
2023-12-10,SG,Singapore,32035,2771072,21,1954,0.07051422698508014
2023-12-17,SG,Singapore,56043,2827115,0,1954,0.06911639604331624
2023-12-24,SG,Singapore,58300,2885415,0,1954,0.06771989471185254
2023-12-31,SG,Singapore,39100,2924515,0,1954,0.06681449744658516
2024-01-07,SG,Singapore,21200,2945715,0,1954,0.06633364055925302
2024-01-14,SG,Singapore,19800,2965515,0,1954,0.06589074747556495
2022-01-16,SX,Sint Maarten (Dutch part),2137,8250,0,75,0.9090909090909091
2022-01-23,SX,Sint Maarten (Dutch part),715,8965,2,77,0.8588957055214724
2022-01-30,SX,Sint Maarten (Dutch part),264,9229,2,79,0.855997399501571
2022-02-06,SX,Sint Maarten (Dutch part),144,9373,0,79,0.842846473914435
2022-02-13,SX,Sint Maarten (Dutch part),96,9469,4,83,0.8765445136762066
2022-02-20,SX,Sint Maarten (Dutch part),42,9511,1,84,0.8831878877089685
2022-02-27,SX,Sint Maarten (Dutch part),33,9544,1,85,0.8906119027661358
2022-03-06,SX,Sint Maarten (Dutch part),26,9570,0,85,0.8881922675026124
2022-03-13,SX,Sint Maarten (Dutch part),16,9586,0,85,0.8867097851032756
2022-03-20,SX,Sint Maarten (Dutch part),43,9629,0,85,0.8827500259632362
2022-03-27,SX,Sint Maarten (Dutch part),28,9657,1,86,0.890545718131925
2022-04-03,SX,Sint Maarten (Dutch part),41,9698,0,86,0.8867807795421737
2022-04-10,SX,Sint Maarten (Dutch part),89,9787,0,86,0.8787166649637274
2022-04-17,SX,Sint Maarten (Dutch part),86,9873,0,86,0.8710624936696041
2022-04-24,SX,Sint Maarten (Dutch part),47,9920,0,86,0.8669354838709677
2022-05-01,SX,Sint Maarten (Dutch part),98,10018,0,86,0.8584547813934917
2022-05-08,SX,Sint Maarten (Dutch part),47,10065,0,86,0.8544461003477397
2022-05-15,SX,Sint Maarten (Dutch part),58,10123,0,86,0.8495505284994567
2022-05-22,SX,Sint Maarten (Dutch part),0,10123,0,86,0.8495505284994567
2022-05-29,SX,Sint Maarten (Dutch part),156,10279,0,86,0.8366572623796089
2022-06-05,SX,Sint Maarten (Dutch part),74,10353,0,86,0.830677098425577
2022-06-12,SX,Sint Maarten (Dutch part),81,10434,0,86,0.8242284838029518
2022-06-19,SX,Sint Maarten (Dutch part),74,10508,0,86,0.8184240578606776
2022-06-26,SX,Sint Maarten (Dutch part),0,10508,0,86,0.8184240578606776
2022-07-03,SX,Sint Maarten (Dutch part),72,10580,0,86,0.8128544423440455
2022-07-10,SX,Sint Maarten (Dutch part),21,10601,1,87,0.8206772945948496
2022-07-17,SX,Sint Maarten (Dutch part),0,10601,0,87,0.8206772945948496
2022-07-24,SX,Sint Maarten (Dutch part),55,10656,0,87,0.8164414414414414
2022-07-31,SX,Sint Maarten (Dutch part),85,10741,0,87,0.8099804487477889
2022-08-07,SX,Sint Maarten (Dutch part),24,10765,0,87,0.8081746400371576
2022-08-14,SX,Sint Maarten (Dutch part),0,10765,0,87,0.8081746400371576
2022-08-21,SX,Sint Maarten (Dutch part),44,10809,0,87,0.8048848182070497
2022-08-28,SX,Sint Maarten (Dutch part),0,10809,0,87,0.8048848182070497
2022-09-04,SX,Sint Maarten (Dutch part),27,10836,0,87,0.8028792912513842
2022-09-11,SX,Sint Maarten (Dutch part),11,10847,0,87,0.8020650871208629
2022-09-18,SX,Sint Maarten (Dutch part),8,10855,0,87,0.8014739751266698
2022-09-25,SX,Sint Maarten (Dutch part),0,10855,0,87,0.8014739751266698
2022-10-02,SX,Sint Maarten (Dutch part),8,10863,0,87,0.8008837337752003
2022-10-09,SX,Sint Maarten (Dutch part),2,10865,0,87,0.8007363092498849
2022-10-16,SX,Sint Maarten (Dutch part),11,10876,0,87,0.7999264435454212
2022-10-23,SX,Sint Maarten (Dutch part),32,10908,0,87,0.7975797579757976
2022-10-30,SX,Sint Maarten (Dutch part),14,10922,1,88,0.8057132393334554
2022-11-06,SX,Sint Maarten (Dutch part),9,10931,1,89,0.8141981520446437
2022-11-13,SX,Sint Maarten (Dutch part),0,10931,0,89,0.8141981520446437
2022-11-20,SX,Sint Maarten (Dutch part),12,10943,0,89,0.8133053093301654
2022-11-27,SX,Sint Maarten (Dutch part),6,10949,0,89,0.812859621883277
2022-12-04,SX,Sint Maarten (Dutch part),5,10954,0,89,0.812488588643418
2022-12-11,SX,Sint Maarten (Dutch part),0,10954,0,89,0.812488588643418
2022-12-18,SX,Sint Maarten (Dutch part),10,10964,0,89,0.8117475373951112
2022-12-25,SX,Sint Maarten (Dutch part),24,10988,0,89,0.8099745176556243
2023-01-01,SX,Sint Maarten (Dutch part),4,10992,0,89,0.8096797671033478
2023-01-08,SX,Sint Maarten (Dutch part),0,10992,0,89,0.8096797671033478
2023-01-15,SX,Sint Maarten (Dutch part),13,11005,0,89,0.8087233075874602
2023-01-22,SX,Sint Maarten (Dutch part),5,11010,0,89,0.8083560399636693
2023-01-29,SX,Sint Maarten (Dutch part),0,11010,0,89,0.8083560399636693
2023-02-05,SX,Sint Maarten (Dutch part),4,11014,1,90,0.8171418195024513
2023-02-12,SX,Sint Maarten (Dutch part),2,11016,0,90,0.8169934640522877
2023-02-19,SX,Sint Maarten (Dutch part),0,11016,0,90,0.8169934640522877
2023-02-26,SX,Sint Maarten (Dutch part),4,11020,0,90,0.8166969147005444
2023-03-05,SX,Sint Maarten (Dutch part),0,11020,0,90,0.8166969147005444
2023-03-12,SX,Sint Maarten (Dutch part),3,11023,2,92,0.8346185249024767
2023-03-19,SX,Sint Maarten (Dutch part),3,11026,0,92,0.8343914384182841
2023-03-26,SX,Sint Maarten (Dutch part),3,11029,0,92,0.834164475473751
2023-04-02,SX,Sint Maarten (Dutch part),1,11030,0,92,0.8340888485947415
2023-04-09,SX,Sint Maarten (Dutch part),0,11030,0,92,0.8340888485947415
2023-04-16,SX,Sint Maarten (Dutch part),0,11030,0,92,0.8340888485947415
2023-04-23,SX,Sint Maarten (Dutch part),0,11030,0,92,0.8340888485947415
2023-04-30,SX,Sint Maarten (Dutch part),0,11030,0,92,0.8340888485947415
2023-05-07,SX,Sint Maarten (Dutch part),0,11030,0,92,0.8340888485947415
2023-05-14,SX,Sint Maarten (Dutch part),0,11030,0,92,0.8340888485947415
2023-05-21,SX,Sint Maarten (Dutch part),0,11030,0,92,0.8340888485947415
2023-05-28,SX,Sint Maarten (Dutch part),0,11030,0,92,0.8340888485947415
2023-06-04,SX,Sint Maarten (Dutch part),21,11051,0,92,0.8325038458058095
2023-06-11,SX,Sint Maarten (Dutch part),0,11051,0,92,0.8325038458058095
2023-06-18,SX,Sint Maarten (Dutch part),0,11051,0,92,0.8325038458058095
2023-06-25,SX,Sint Maarten (Dutch part),0,11051,0,92,0.8325038458058095
2023-07-02,SX,Sint Maarten (Dutch part),0,11051,0,92,0.8325038458058095
2023-07-09,SX,Sint Maarten (Dutch part),0,11051,0,92,0.8325038458058095
2023-07-16,SX,Sint Maarten (Dutch part),0,11051,0,92,0.8325038458058095
2023-07-23,SX,Sint Maarten (Dutch part),0,11051,0,92,0.8325038458058095
2023-07-30,SX,Sint Maarten (Dutch part),0,11051,0,92,0.8325038458058095
2023-08-06,SX,Sint Maarten (Dutch part),0,11051,0,92,0.8325038458058095
2023-08-13,SX,Sint Maarten (Dutch part),0,11051,0,92,0.8325038458058095
2023-08-20,SX,Sint Maarten (Dutch part),0,11051,0,92,0.8325038458058095
2023-08-27,SX,Sint Maarten (Dutch part),0,11051,0,92,0.8325038458058095
2023-09-03,SX,Sint Maarten (Dutch part),0,11051,0,92,0.8325038458058095
2023-09-10,SX,Sint Maarten (Dutch part),0,11051,0,92,0.8325038458058095
2023-09-17,SX,Sint Maarten (Dutch part),0,11051,0,92,0.8325038458058095
2023-09-24,SX,Sint Maarten (Dutch part),0,11051,0,92,0.8325038458058095
2023-10-01,SX,Sint Maarten (Dutch part),0,11051,0,92,0.8325038458058095
2023-10-08,SX,Sint Maarten (Dutch part),0,11051,0,92,0.8325038458058095
2023-10-15,SX,Sint Maarten (Dutch part),0,11051,0,92,0.8325038458058095
2023-10-22,SX,Sint Maarten (Dutch part),0,11051,0,92,0.8325038458058095
2023-10-29,SX,Sint Maarten (Dutch part),0,11051,0,92,0.8325038458058095
2023-11-05,SX,Sint Maarten (Dutch part),0,11051,0,92,0.8325038458058095
2023-11-12,SX,Sint Maarten (Dutch part),0,11051,0,92,0.8325038458058095
2023-11-19,SX,Sint Maarten (Dutch part),0,11051,0,92,0.8325038458058095
2023-11-26,SX,Sint Maarten (Dutch part),0,11051,0,92,0.8325038458058095
2023-12-03,SX,Sint Maarten (Dutch part),0,11051,0,92,0.8325038458058095
2023-12-10,SX,Sint Maarten (Dutch part),0,11051,0,92,0.8325038458058095
2023-12-17,SX,Sint Maarten (Dutch part),0,11051,0,92,0.8325038458058095
2023-12-24,SX,Sint Maarten (Dutch part),0,11051,0,92,0.8325038458058095
2023-12-31,SX,Sint Maarten (Dutch part),0,11051,0,92,0.8325038458058095
2024-01-07,SX,Sint Maarten (Dutch part),0,11051,0,92,0.8325038458058095
2024-01-14,SX,Sint Maarten (Dutch part),0,11051,0,92,0.8325038458058095
2020-04-05,SK,Slovakia,171,485,1,1,0.2061855670103093
2020-04-12,SK,Slovakia,257,742,1,2,0.2695417789757413
2020-08-23,SK,Slovakia,454,3356,2,33,0.9833134684147794
2020-08-30,SK,Slovakia,520,3876,0,33,0.8513931888544891
2020-09-06,SK,Slovakia,738,4614,4,37,0.8019072388383182
2020-09-13,SK,Slovakia,918,5532,1,38,0.6869125090383225
2020-09-20,SK,Slovakia,1145,6677,1,39,0.5840946532874045
2020-09-27,SK,Slovakia,2401,9078,5,44,0.4846882573254021
2020-10-04,SK,Slovakia,4061,13139,11,55,0.418601111195677
2020-10-11,SK,Slovakia,6712,19851,6,61,0.3072893053246688
2020-10-18,SK,Slovakia,9984,29835,27,88,0.2949555890732361
2020-10-25,SK,Slovakia,14008,43843,71,159,0.3626576648495769
2020-11-01,SK,Slovakia,16103,59946,60,219,0.3653287959163247
2020-11-08,SK,Slovakia,15549,75495,132,351,0.4649314524140672
2020-11-15,SK,Slovakia,11272,86767,159,510,0.5877810688395357
2020-11-22,SK,Slovakia,9474,96241,161,671,0.6972080506229154
2020-11-29,SK,Slovakia,9492,105733,145,816,0.7717552703507893
2020-12-06,SK,Slovakia,10998,116731,180,996,0.8532437827141033
2020-12-13,SK,Slovakia,16253,132984,179,1175,0.8835649401431752
2020-03-15,SI,Slovenia,230,250,1,1,0.4
2020-03-22,SI,Slovenia,192,442,1,2,0.4524886877828055
2022-01-30,SI,Slovenia,98826,711026,119,6464,0.9091088089605724
2022-02-06,SI,Slovenia,89441,800467,173,6637,0.8291409889477017
2022-02-13,SI,Slovenia,51552,852019,167,6804,0.7985737407264392
2022-02-20,SI,Slovenia,28450,880469,185,6989,0.7937814959981556
2022-02-27,SI,Slovenia,12487,892956,151,7140,0.7995914692325267
2022-03-06,SI,Slovenia,11796,904752,101,7241,0.8003298141369127
2022-03-13,SI,Slovenia,14385,919137,80,7321,0.7965080287269471
2022-03-20,SI,Slovenia,19377,938514,64,7385,0.7868822415009259
2022-03-27,SI,Slovenia,19975,958489,50,7435,0.775700086281637
2022-04-03,SI,Slovenia,17024,975513,60,7495,0.7683136975109506
2022-04-10,SI,Slovenia,12973,988486,56,7551,0.7638954927029822
2022-04-17,SI,Slovenia,9487,997973,51,7602,0.7617440551998902
2022-04-24,SI,Slovenia,6980,1004953,55,7657,0.7619261796322813
2022-05-01,SI,Slovenia,5976,1010929,40,7697,0.7613788901099879
2022-05-08,SI,Slovenia,5157,1016086,42,7739,0.76164812820962
2022-05-15,SI,Slovenia,3804,1019890,31,7770,0.7618468658384727
2022-05-22,SI,Slovenia,2754,1022644,18,7788,0.7615553408615315
2022-05-29,SI,Slovenia,2024,1024668,11,7799,0.761124578887991
2022-06-05,SI,Slovenia,1735,1026403,13,7812,0.7611045563974383
2022-06-12,SI,Slovenia,2006,1028409,9,7821,0.7604950948503951
2022-06-19,SI,Slovenia,2853,1031262,7,7828,0.7590699550647653
2022-06-26,SI,Slovenia,4205,1035467,4,7832,0.7563736941882262
2022-07-03,SI,Slovenia,6062,1041529,11,7843,0.7530275201170586
2022-07-10,SI,Slovenia,8766,1050295,20,7863,0.7486468087537311
2022-07-17,SI,Slovenia,10756,1061051,24,7887,0.7433195953823143
2022-07-24,SI,Slovenia,11499,1072550,53,7940,0.7402918278868118
2022-07-31,SI,Slovenia,11465,1084015,47,7987,0.7367979225379723
2022-08-07,SI,Slovenia,10282,1094297,50,8037,0.7344441225736705
2022-08-14,SI,Slovenia,9878,1104175,51,8088,0.732492584961623
2022-08-21,SI,Slovenia,9473,1113648,34,8122,0.729314828383834
2022-08-28,SI,Slovenia,9414,1123062,41,8163,0.7268521239254823
2022-09-04,SI,Slovenia,8906,1131968,28,8191,0.723607027760502
2022-09-11,SI,Slovenia,11450,1143418,23,8214,0.7183724587158852
2022-09-18,SI,Slovenia,14454,1157872,33,8247,0.7122548951870328
2022-09-25,SI,Slovenia,14000,1171872,21,8268,0.7055378061767839
2022-10-02,SI,Slovenia,15885,1187757,37,8305,0.6992170957527508
2022-10-09,SI,Slovenia,15708,1203465,49,8354,0.6941622731030815
2022-10-16,SI,Slovenia,12986,1216451,49,8403,0.6907799820954564
2022-10-23,SI,Slovenia,9803,1226254,49,8452,0.6892536130361246
2022-10-30,SI,Slovenia,7447,1233701,34,8486,0.6878490006897944
2022-11-06,SI,Slovenia,4567,1238268,33,8519,0.6879770776600864
2022-11-13,SI,Slovenia,4362,1242630,22,8541,0.6873325124936627
2022-11-20,SI,Slovenia,5422,1248052,22,8563,0.6861092326281276
2022-11-27,SI,Slovenia,6877,1254929,27,8590,0.6845008761451843
2022-12-04,SI,Slovenia,9278,1264207,34,8624,0.6821667654110442
2022-12-11,SI,Slovenia,12161,1276368,41,8665,0.6788794454263974
2022-12-18,SI,Slovenia,12766,1289134,61,8726,0.6768885158563811
2022-12-25,SI,Slovenia,11669,1300803,75,8801,0.6765820804533815
2023-01-01,SI,Slovenia,7698,1308501,70,8871,0.677951335153737
2023-01-08,SI,Slovenia,5940,1314441,71,8942,0.6802891875709902
2023-01-15,SI,Slovenia,3281,1317722,52,8994,0.6825415375929065
2023-01-22,SI,Slovenia,2025,1319747,50,9044,0.6852828610332132
2023-01-29,SI,Slovenia,1621,1321368,32,9076,0.6868639167892668
2023-02-05,SI,Slovenia,1384,1322752,11,9087,0.6869768482678537
2023-02-12,SI,Slovenia,1238,1323990,18,9105,0.6876940158158295
2023-02-19,SI,Slovenia,1653,1325643,18,9123,0.6881943328633727
2023-02-26,SI,Slovenia,2046,1327689,25,9148,0.6890167802851421
2023-03-05,SI,Slovenia,2355,1330044,13,9161,0.6887742059661185
2023-03-12,SI,Slovenia,2843,1332887,16,9177,0.6885054772084955
2023-03-19,SI,Slovenia,2888,1335775,23,9200,0.6887387471692463
2023-03-26,SI,Slovenia,3044,1338819,27,9227,0.689189502091022
2023-04-02,SI,Slovenia,2432,1341251,17,9244,0.6892073146636983
2023-04-09,SI,Slovenia,939,1342190,32,9276,0.6911093064320253
2023-04-16,SI,Slovenia,559,1342749,20,9296,0.6923110722852893
2023-04-23,SI,Slovenia,456,1343205,23,9319,0.693788364397095
2023-04-30,SI,Slovenia,309,1343514,20,9339,0.6951174308566936
2023-05-07,SI,Slovenia,201,1343715,20,9359,0.6965018623740897
2023-05-14,SI,Slovenia,182,1343897,18,9377,0.6977469255456333
2023-05-21,SI,Slovenia,182,1344079,7,9384,0.6981732472570437
2023-05-28,SI,Slovenia,191,1344270,9,9393,0.6987435559820572
2023-06-04,SI,Slovenia,110,1344380,6,9399,0.6991326856989839
2023-06-11,SI,Slovenia,85,1344465,7,9406,0.699609138207391
2023-06-18,SI,Slovenia,61,1344526,6,9412,0.7000236514578372
2023-06-25,SI,Slovenia,36,1344562,10,9422,0.7007486452837429
2023-07-02,SI,Slovenia,20,1344582,2,9424,0.7008869671020437
2023-07-09,SI,Slovenia,27,1344609,2,9426,0.7010216352857969
2023-07-16,SI,Slovenia,6,1344615,3,9429,0.7012416193482892
2023-07-23,SI,Slovenia,24,1344639,1,9430,0.7013034725305454
2023-07-30,SI,Slovenia,16,1344655,1,9431,0.7013694962648411
2023-08-06,SI,Slovenia,24,1344679,2,9433,0.7015057125157751
2023-08-13,SI,Slovenia,29,1344708,1,9434,0.7015649494165276
2023-08-20,SI,Slovenia,61,1344769,3,9437,0.7017562124052533
2023-08-27,SI,Slovenia,74,1344843,0,9437,0.7017175982623994
2023-09-03,SI,Slovenia,92,1344935,3,9440,0.7018926565224342
2023-09-10,SI,Slovenia,118,1345053,2,9442,0.7019797732877441
2023-09-17,SI,Slovenia,152,1345205,7,9449,0.7024208206184187
2023-09-24,SI,Slovenia,223,1345428,4,9453,0.7026016999794861
2023-10-01,SI,Slovenia,348,1345776,7,9460,0.7029401624044418
2023-10-08,SI,Slovenia,399,1346175,9,9469,0.7034003751369622
2023-10-15,SI,Slovenia,487,1346662,14,9483,0.70418560856399
2023-10-22,SI,Slovenia,402,1347064,4,9487,0.7042724027960068
2023-10-29,SI,Slovenia,0,1347064,0,9487,0.7042724027960068
2023-11-05,SI,Slovenia,434,1347498,23,9510,0.7057524389646589
2023-11-12,SI,Slovenia,489,1347987,26,9536,0.707425219976157
2023-11-19,SI,Slovenia,737,1348724,29,9565,0.7091888332972499
2023-11-26,SI,Slovenia,843,1349567,44,9609,0.7120061471568289
2023-12-03,SI,Slovenia,1092,1350659,49,9658,0.7150583529965743
2023-12-10,SI,Slovenia,1136,1351795,46,9704,0.7178603264548249
2023-12-17,SI,Slovenia,1098,1352893,52,9756,0.7211213303638943
2023-12-24,SI,Slovenia,850,1353743,39,9795,0.7235494477164425
2023-12-31,SI,Slovenia,631,1354374,36,9831,0.7258704021193555
2024-01-07,SI,Slovenia,433,1354807,6,9837,0.7260812794737553
2024-01-14,SI,Slovenia,0,1354807,0,9837,0.7260812794737553
2022-01-30,SB,Solomon Islands,894,1183,9,9,0.760777683854607
2022-04-24,SB,Solomon Islands,1897,14182,1,140,0.9871668311944718
2022-05-01,SB,Solomon Islands,1078,15260,1,141,0.9239842726081258
2022-05-08,SB,Solomon Islands,1181,16441,2,143,0.8697767775682744
2022-05-15,SB,Solomon Islands,1733,18174,3,146,0.8033454385385715
2022-05-22,SB,Solomon Islands,0,18174,0,146,0.8033454385385715
2022-05-29,SB,Solomon Islands,0,18174,0,146,0.8033454385385715
2022-06-05,SB,Solomon Islands,3063,21237,3,149,0.7016056881857137
2022-06-12,SB,Solomon Islands,307,21544,0,149,0.6916078722614185
2022-06-19,SB,Solomon Islands,0,21544,4,153,0.7101745265503157
2022-06-26,SB,Solomon Islands,0,21544,0,153,0.7101745265503157
2022-07-03,SB,Solomon Islands,0,21544,0,153,0.7101745265503157
2022-07-10,SB,Solomon Islands,0,21544,0,153,0.7101745265503157
2022-07-17,SB,Solomon Islands,0,21544,0,153,0.7101745265503157
2022-07-24,SB,Solomon Islands,0,21544,0,153,0.7101745265503157
2022-07-31,SB,Solomon Islands,0,21544,0,153,0.7101745265503157
2022-08-07,SB,Solomon Islands,0,21544,0,153,0.7101745265503157
2022-08-14,SB,Solomon Islands,0,21544,0,153,0.7101745265503157
2022-08-21,SB,Solomon Islands,0,21544,0,153,0.7101745265503157
2022-08-28,SB,Solomon Islands,0,21544,0,153,0.7101745265503157
2022-09-04,SB,Solomon Islands,0,21544,0,153,0.7101745265503157
2022-09-11,SB,Solomon Islands,0,21544,0,153,0.7101745265503157
2022-09-18,SB,Solomon Islands,0,21544,0,153,0.7101745265503157
2022-09-25,SB,Solomon Islands,0,21544,0,153,0.7101745265503157
2022-10-02,SB,Solomon Islands,0,21544,0,153,0.7101745265503157
2022-10-09,SB,Solomon Islands,0,21544,0,153,0.7101745265503157
2022-10-16,SB,Solomon Islands,0,21544,0,153,0.7101745265503157
2022-10-23,SB,Solomon Islands,0,21544,0,153,0.7101745265503157
2022-10-30,SB,Solomon Islands,0,21544,0,153,0.7101745265503157
2022-11-06,SB,Solomon Islands,19,21563,0,153,0.7095487640866298
2022-11-13,SB,Solomon Islands,0,21563,0,153,0.7095487640866298
2022-11-20,SB,Solomon Islands,48,21611,0,153,0.7079727916338902
2022-11-27,SB,Solomon Islands,0,21611,0,153,0.7079727916338902
2022-12-04,SB,Solomon Islands,0,21611,0,153,0.7079727916338902
2022-12-11,SB,Solomon Islands,0,21611,0,153,0.7079727916338902
2022-12-18,SB,Solomon Islands,0,21611,0,153,0.7079727916338902
2022-12-25,SB,Solomon Islands,0,21611,0,153,0.7079727916338902
2023-01-01,SB,Solomon Islands,0,21611,0,153,0.7079727916338902
2023-01-08,SB,Solomon Islands,0,21611,0,153,0.7079727916338902
2023-01-15,SB,Solomon Islands,0,21611,0,153,0.7079727916338902
2023-01-22,SB,Solomon Islands,0,21611,0,153,0.7079727916338902
2023-01-29,SB,Solomon Islands,0,21611,0,153,0.7079727916338902
2023-02-05,SB,Solomon Islands,0,21611,0,153,0.7079727916338902
2023-02-12,SB,Solomon Islands,0,21611,0,153,0.7079727916338902
2023-02-19,SB,Solomon Islands,0,21611,0,153,0.7079727916338902
2023-02-26,SB,Solomon Islands,0,21611,0,153,0.7079727916338902
2023-03-05,SB,Solomon Islands,0,21611,0,153,0.7079727916338902
2023-03-12,SB,Solomon Islands,0,21611,0,153,0.7079727916338902
2023-03-19,SB,Solomon Islands,0,21611,0,153,0.7079727916338902
2023-03-26,SB,Solomon Islands,0,21611,0,153,0.7079727916338902
2023-04-02,SB,Solomon Islands,0,21611,0,153,0.7079727916338902
2023-04-09,SB,Solomon Islands,0,21611,0,153,0.7079727916338902
2023-04-16,SB,Solomon Islands,0,21611,0,153,0.7079727916338902
2023-04-23,SB,Solomon Islands,0,21611,0,153,0.7079727916338902
2023-04-30,SB,Solomon Islands,0,21611,0,153,0.7079727916338902
2023-05-07,SB,Solomon Islands,0,21611,0,153,0.7079727916338902
2023-05-14,SB,Solomon Islands,0,21611,0,153,0.7079727916338902
2023-05-21,SB,Solomon Islands,0,21611,0,153,0.7079727916338902
2023-05-28,SB,Solomon Islands,0,21611,0,153,0.7079727916338902
2023-06-04,SB,Solomon Islands,0,21611,0,153,0.7079727916338902
2023-06-11,SB,Solomon Islands,0,21611,0,153,0.7079727916338902
2023-06-18,SB,Solomon Islands,0,21611,0,153,0.7079727916338902
2023-06-25,SB,Solomon Islands,0,21611,0,153,0.7079727916338902
2023-07-02,SB,Solomon Islands,0,21611,0,153,0.7079727916338902
2023-07-09,SB,Solomon Islands,0,21611,0,153,0.7079727916338902
2023-07-16,SB,Solomon Islands,0,21611,0,153,0.7079727916338902
2023-07-23,SB,Solomon Islands,0,21611,0,153,0.7079727916338902
2023-07-30,SB,Solomon Islands,0,21611,0,153,0.7079727916338902
2023-08-06,SB,Solomon Islands,0,21611,0,153,0.7079727916338902
2023-08-13,SB,Solomon Islands,0,21611,0,153,0.7079727916338902
2023-08-20,SB,Solomon Islands,0,21611,0,153,0.7079727916338902
2023-08-27,SB,Solomon Islands,0,21611,0,153,0.7079727916338902
2023-09-03,SB,Solomon Islands,0,21611,0,153,0.7079727916338902
2023-09-10,SB,Solomon Islands,0,21611,0,153,0.7079727916338902
2023-09-17,SB,Solomon Islands,0,21611,0,153,0.7079727916338902
2023-09-24,SB,Solomon Islands,0,21611,0,153,0.7079727916338902
2023-10-01,SB,Solomon Islands,0,21611,46,199,0.9208273564388506
2023-10-08,SB,Solomon Islands,4343,25954,0,199,0.7667411574323804
2023-10-15,SB,Solomon Islands,0,25954,0,199,0.7667411574323804
2023-10-22,SB,Solomon Islands,0,25954,0,199,0.7667411574323804
2023-10-29,SB,Solomon Islands,0,25954,0,199,0.7667411574323804
2023-11-05,SB,Solomon Islands,0,25954,0,199,0.7667411574323804
2023-11-12,SB,Solomon Islands,0,25954,0,199,0.7667411574323804
2023-11-19,SB,Solomon Islands,0,25954,0,199,0.7667411574323804
2023-11-26,SB,Solomon Islands,0,25954,0,199,0.7667411574323804
2023-12-03,SB,Solomon Islands,0,25954,0,199,0.7667411574323804
2023-12-10,SB,Solomon Islands,0,25954,0,199,0.7667411574323804
2023-12-17,SB,Solomon Islands,0,25954,0,199,0.7667411574323804
2023-12-24,SB,Solomon Islands,0,25954,0,199,0.7667411574323804
2023-12-31,SB,Solomon Islands,0,25954,0,199,0.7667411574323804
2024-01-07,SB,Solomon Islands,0,25954,0,199,0.7667411574323804
2024-01-14,SB,Solomon Islands,0,25954,0,199,0.7667411574323804
2020-03-29,ZA,South Africa,947,1187,1,1,0.08424599831508003
2020-04-05,ZA,South Africa,398,1585,8,9,0.5678233438485805
2021-12-19,SS,South Sudan,568,13459,0,133,0.9881863437105282
2021-12-26,SS,South Sudan,1351,14810,2,135,0.9115462525320729
2022-01-02,SS,South Sudan,828,15638,1,136,0.8696764292108965
2022-01-09,SS,South Sudan,572,16210,0,136,0.8389882788402222
2022-01-16,SS,South Sudan,312,16522,0,136,0.8231448977121414
2022-01-23,SS,South Sudan,171,16693,1,137,0.8207032888036903
2022-01-30,SS,South Sudan,95,16788,0,137,0.8160590898260662
2022-02-06,SS,South Sudan,61,16849,0,137,0.8131046352899283
2022-02-13,SS,South Sudan,47,16896,0,137,0.810842803030303
2022-02-20,SS,South Sudan,34,16930,0,137,0.809214412285883
2022-02-27,SS,South Sudan,36,16966,0,137,0.8074973476364494
2022-03-06,SS,South Sudan,45,17011,0,137,0.8053612368467463
2022-03-13,SS,South Sudan,50,17061,1,138,0.8088623175663794
2022-03-20,SS,South Sudan,68,17129,0,138,0.8056512347480881
2022-03-27,SS,South Sudan,84,17213,0,138,0.8017196305118225
2022-04-03,SS,South Sudan,73,17286,0,138,0.7983339118361681
2022-04-10,SS,South Sudan,64,17350,0,138,0.7953890489913545
2022-04-17,SS,South Sudan,52,17402,0,138,0.7930122974370762
2022-04-24,SS,South Sudan,36,17438,0,138,0.7913751577015713
2022-05-01,SS,South Sudan,41,17479,0,138,0.7895188511928599
2022-05-08,SS,South Sudan,29,17508,0,138,0.7882111034955449
2022-05-15,SS,South Sudan,39,17547,0,138,0.78645922379894
2022-05-22,SS,South Sudan,27,17574,0,138,0.7852509388869922
2022-05-29,SS,South Sudan,16,17590,0,138,0.7845366685616828
2022-06-05,SS,South Sudan,40,17630,0,138,0.7827566647759502
2022-06-12,SS,South Sudan,18,17648,0,138,0.7819582955575702
2022-06-19,SS,South Sudan,36,17684,0,138,0.7803664329337254
2022-06-26,SS,South Sudan,25,17709,0,138,0.7792647806200237
2022-07-03,SS,South Sudan,27,17736,0,138,0.7780784844384303
2022-07-10,SS,South Sudan,18,17754,0,138,0.777289624873268
2022-07-17,SS,South Sudan,12,17766,0,138,0.7767646065518407
2022-07-24,SS,South Sudan,13,17779,0,138,0.7761966364812419
2022-07-31,SS,South Sudan,1,17780,0,138,0.7761529808773904
2022-08-07,SS,South Sudan,0,17780,0,138,0.7761529808773904
2022-08-14,SS,South Sudan,0,17780,0,138,0.7761529808773904
2022-08-21,SS,South Sudan,0,17780,0,138,0.7761529808773904
2022-08-28,SS,South Sudan,0,17780,0,138,0.7761529808773904
2022-09-04,SS,South Sudan,0,17780,0,138,0.7761529808773904
2022-09-11,SS,South Sudan,0,17780,0,138,0.7761529808773904
2022-09-18,SS,South Sudan,280,18060,0,138,0.7641196013289037
2022-09-25,SS,South Sudan,55,18115,0,138,0.7617996135799061
2022-10-02,SS,South Sudan,0,18115,0,138,0.7617996135799061
2022-10-09,SS,South Sudan,132,18247,0,138,0.7562887049926016
2022-10-16,SS,South Sudan,14,18261,0,138,0.7557088877936586
2022-10-23,SS,South Sudan,31,18292,0,138,0.7544281653181719
2022-10-30,SS,South Sudan,21,18313,0,138,0.7535630426472997
2022-11-06,SS,South Sudan,16,18329,0,138,0.7529052321457799
2022-11-13,SS,South Sudan,12,18341,0,138,0.7524126274467041
2022-11-20,SS,South Sudan,7,18348,0,138,0.7521255722694572
2022-11-27,SS,South Sudan,2,18350,0,138,0.7520435967302452
2022-12-04,SS,South Sudan,2,18352,0,138,0.7519616390584133
2022-12-11,SS,South Sudan,16,18368,0,138,0.7513066202090593
2022-12-18,SS,South Sudan,0,18368,0,138,0.7513066202090593
2022-12-25,SS,South Sudan,0,18368,0,138,0.7513066202090593
2023-01-01,SS,South Sudan,0,18368,0,138,0.7513066202090593
2023-01-08,SS,South Sudan,0,18368,0,138,0.7513066202090593
2023-01-15,SS,South Sudan,0,18368,0,138,0.7513066202090593
2023-01-22,SS,South Sudan,0,18368,0,138,0.7513066202090593
2023-01-29,SS,South Sudan,0,18368,0,138,0.7513066202090593
2023-02-05,SS,South Sudan,0,18368,0,138,0.7513066202090593
2023-02-12,SS,South Sudan,0,18368,0,138,0.7513066202090593
2023-02-19,SS,South Sudan,0,18368,0,138,0.7513066202090593
2023-02-26,SS,South Sudan,0,18368,0,138,0.7513066202090593
2023-03-05,SS,South Sudan,0,18368,0,138,0.7513066202090593
2023-03-12,SS,South Sudan,0,18368,0,138,0.7513066202090593
2023-03-19,SS,South Sudan,0,18368,0,138,0.7513066202090593
2023-03-26,SS,South Sudan,0,18368,0,138,0.7513066202090593
2023-04-02,SS,South Sudan,0,18368,0,138,0.7513066202090593
2023-04-09,SS,South Sudan,0,18368,0,138,0.7513066202090593
2023-04-16,SS,South Sudan,0,18368,0,138,0.7513066202090593
2023-04-23,SS,South Sudan,0,18368,0,138,0.7513066202090593
2023-04-30,SS,South Sudan,0,18368,0,138,0.7513066202090593
2023-05-07,SS,South Sudan,0,18368,0,138,0.7513066202090593
2023-05-14,SS,South Sudan,0,18368,0,138,0.7513066202090593
2023-05-21,SS,South Sudan,0,18368,0,138,0.7513066202090593
2023-05-28,SS,South Sudan,0,18368,0,138,0.7513066202090593
2023-06-04,SS,South Sudan,0,18368,0,138,0.7513066202090593
2023-06-11,SS,South Sudan,0,18368,0,138,0.7513066202090593
2023-06-18,SS,South Sudan,0,18368,0,138,0.7513066202090593
2023-06-25,SS,South Sudan,0,18368,0,138,0.7513066202090593
2023-07-02,SS,South Sudan,0,18368,0,138,0.7513066202090593
2023-07-09,SS,South Sudan,0,18368,0,138,0.7513066202090593
2023-07-16,SS,South Sudan,0,18368,0,138,0.7513066202090593
2023-07-23,SS,South Sudan,0,18368,0,138,0.7513066202090593
2023-07-30,SS,South Sudan,0,18368,0,138,0.7513066202090593
2023-08-06,SS,South Sudan,0,18368,0,138,0.7513066202090593
2023-08-13,SS,South Sudan,0,18368,0,138,0.7513066202090593
2023-08-20,SS,South Sudan,0,18368,0,138,0.7513066202090593
2023-08-27,SS,South Sudan,0,18368,0,138,0.7513066202090593
2023-09-03,SS,South Sudan,0,18368,0,138,0.7513066202090593
2023-09-10,SS,South Sudan,0,18368,0,138,0.7513066202090593
2023-09-17,SS,South Sudan,0,18368,0,138,0.7513066202090593
2023-09-24,SS,South Sudan,0,18368,0,138,0.7513066202090593
2023-10-01,SS,South Sudan,0,18368,0,138,0.7513066202090593
2023-10-08,SS,South Sudan,31,18399,9,147,0.7989564650252732
2023-10-15,SS,South Sudan,137,18536,0,147,0.7930513595166163
2023-10-22,SS,South Sudan,59,18595,0,147,0.790535090077978
2023-10-29,SS,South Sudan,101,18696,0,147,0.7862644415917843
2023-11-05,SS,South Sudan,26,18722,0,147,0.7851725243029591
2023-11-12,SS,South Sudan,36,18758,0,147,0.7836656359953087
2023-11-19,SS,South Sudan,5,18763,0,147,0.783456803283057
2023-11-26,SS,South Sudan,2,18765,0,147,0.7833733013589129
2023-12-03,SS,South Sudan,54,18819,0,147,0.7811254583134066
2023-12-10,SS,South Sudan,0,18819,0,147,0.7811254583134066
2023-12-17,SS,South Sudan,0,18819,0,147,0.7811254583134066
2023-12-24,SS,South Sudan,0,18819,0,147,0.7811254583134066
2023-12-31,SS,South Sudan,0,18819,0,147,0.7811254583134066
2024-01-07,SS,South Sudan,0,18819,0,147,0.7811254583134066
2024-01-14,SS,South Sudan,0,18819,0,147,0.7811254583134066
2020-03-01,ES,Spain,129,148,0,1,0.6756756756756757
2022-01-30,ES,Spain,625727,10215638,1769,97777,0.957130626594247
2022-02-06,ES,Spain,383768,10599406,1706,99483,0.9385714633442667
2022-02-13,ES,Spain,244929,10844335,1400,100883,0.9302829541876011
2022-02-20,ES,Spain,158925,11003260,943,101826,0.9254166492475867
2022-02-27,ES,Spain,117945,11121205,662,102488,0.921554813529649
2022-03-06,ES,Spain,111287,11232492,528,103016,0.9171250689517518
2022-03-13,ES,Spain,110619,11343111,444,103460,0.9120954559996811
2022-03-20,ES,Spain,118670,11461781,373,103833,0.9059063334049045
2022-03-27,ES,Spain,123403,11585184,311,104144,0.8989412684338893
2022-04-03,ES,Spain,67059,11652243,313,104457,0.8964540131887053
2022-04-10,ES,Spain,72198,11724441,336,104793,0.893799542340654
2022-04-17,ES,Spain,74154,11798595,385,105178,0.8914451254577346
2022-04-24,ES,Spain,102380,11900975,419,105597,0.8872970491913478
2022-05-01,ES,Spain,119043,12020018,417,106014,0.8819787125110794
2022-05-08,ES,Spain,120608,12140626,494,106508,0.8772858994256144
2022-05-15,ES,Spain,123129,12263755,552,107060,0.8729789530205064
2022-05-22,ES,Spain,100265,12364020,532,107592,0.8702024098958107
2022-05-29,ES,Spain,78838,12442858,454,108046,0.8683374832373719
2022-06-05,ES,Spain,77617,12520475,442,108488,0.8664846980645702
2022-06-12,ES,Spain,79575,12600050,427,108915,0.8644013317407471
2022-06-19,ES,Spain,95721,12695771,497,109412,0.8617987832326214
2022-06-26,ES,Spain,129495,12825266,525,109937,0.8571907982259394
2022-07-03,ES,Spain,159628,12984894,643,110580,0.8516049495667812
2022-07-10,ES,Spain,146154,13131048,853,111433,0.8486222881829387
2022-07-17,ES,Spain,101461,13232509,1104,112537,0.8504585184865546
2022-07-24,ES,Spain,68057,13300566,958,113495,0.8533095508867818
2022-07-31,ES,Spain,45541,13346107,788,114283,0.8563021411412332
2022-08-07,ES,Spain,32376,13378483,597,114880,0.8586922747519281
2022-08-14,ES,Spain,23157,13401640,498,115378,0.8609244838691384
2022-08-21,ES,Spain,17529,13419169,339,115717,0.8623261246653947
2022-08-28,ES,Spain,17231,13436400,305,116022,0.8634902205948023
2022-09-04,ES,Spain,15221,13451621,252,116274,0.8643865300694987
2022-09-11,ES,Spain,13517,13465138,171,116445,0.864788760427112
2022-09-18,ES,Spain,15587,13480725,165,116610,0.8650128238651853
2022-09-25,ES,Spain,16469,13497194,107,116717,0.8647501102821815
2022-10-02,ES,Spain,17740,13514934,126,116843,0.864547322243675
2022-10-09,ES,Spain,22273,13537207,150,116993,0.8642329248566563
2022-10-16,ES,Spain,21512,13558719,147,117140,0.8639459229149892
2022-10-23,ES,Spain,22259,13580978,179,117319,0.8638479496837415
2022-10-30,ES,Spain,20302,13601280,166,117485,0.8637789972708451
2022-11-06,ES,Spain,18527,13619807,142,117627,0.8636465993974805
2022-11-13,ES,Spain,20387,13640194,147,117774,0.8634334672952598
2022-11-20,ES,Spain,21950,13662144,163,117937,0.8632393275901644
2022-11-27,ES,Spain,19892,13682036,175,118112,0.8632633330302595
2022-12-04,ES,Spain,19294,13701330,183,118295,0.8633833357783515
2022-12-11,ES,Spain,16989,13718319,190,118485,0.8636991164879603
2022-12-18,ES,Spain,19638,13737957,241,118726,0.8642187481006092
2022-12-25,ES,Spain,17005,13754962,217,118943,0.8647279432687637
2023-01-01,ES,Spain,14823,13769785,210,119153,0.8653221528150222
2023-01-08,ES,Spain,12663,13782448,202,119355,0.8659927467166937
2023-01-15,ES,Spain,11960,13794408,178,119533,0.8665322933756926
2023-01-22,ES,Spain,7480,13801888,197,119730,0.8674900129605457
2023-01-29,ES,Spain,5787,13807675,136,119866,0.8681113945686004
2023-02-05,ES,Spain,5699,13813374,116,119982,0.8685930026943454
2023-02-12,ES,Spain,6074,13819448,103,120085,0.8689565603488649
2023-02-19,ES,Spain,6051,13825499,85,120170,0.8691910505364038
2023-02-26,ES,Spain,6455,13831954,91,120261,0.8694433194326702
2023-03-05,ES,Spain,6566,13838520,82,120343,0.8696233412243506
2023-03-12,ES,Spain,8286,13846806,97,120440,0.8698034767006918
2023-03-19,ES,Spain,7421,13854227,123,120563,0.8702253831989326
2023-03-26,ES,Spain,7577,13861804,95,120658,0.8704350458280898
2023-04-02,ES,Spain,7962,13869766,84,120742,0.8705410026384006
2023-04-09,ES,Spain,6617,13876383,86,120828,0.8707456402723965
2023-04-16,ES,Spain,10278,13886661,80,120908,0.8706772635984994
2023-04-23,ES,Spain,10867,13897528,112,121020,0.870802347007324
2023-04-30,ES,Spain,11183,13908711,128,121148,0.8710224836794724
2023-05-07,ES,Spain,10603,13919314,98,121246,0.8710630423309655
2023-05-14,ES,Spain,11262,13930576,102,121348,0.8710910446201219
2023-05-21,ES,Spain,11023,13941599,100,121448,0.8711195896539558
2023-05-28,ES,Spain,11262,13952861,99,121547,0.8711260006101975
2023-06-04,ES,Spain,8917,13961778,98,121645,0.8712715529497748
2023-06-11,ES,Spain,6866,13968644,89,121734,0.8714804386166617
2023-06-18,ES,Spain,5430,13974074,65,121799,0.8716069486965649
2023-06-25,ES,Spain,4502,13978576,42,121841,0.8716266950224402
2023-07-02,ES,Spain,1764,13980340,11,121852,0.8715953975368267
2023-07-09,ES,Spain,0,13980340,0,121852,0.8715953975368267
2023-07-16,ES,Spain,0,13980340,0,121852,0.8715953975368267
2023-07-23,ES,Spain,0,13980340,0,121852,0.8715953975368267
2023-07-30,ES,Spain,0,13980340,0,121852,0.8715953975368267
2023-08-06,ES,Spain,0,13980340,0,121852,0.8715953975368267
2023-08-13,ES,Spain,0,13980340,0,121852,0.8715953975368267
2023-08-20,ES,Spain,0,13980340,0,121852,0.8715953975368267
2023-08-27,ES,Spain,0,13980340,0,121852,0.8715953975368267
2023-09-03,ES,Spain,0,13980340,0,121852,0.8715953975368267
2023-09-10,ES,Spain,0,13980340,0,121852,0.8715953975368267
2023-09-17,ES,Spain,0,13980340,0,121852,0.8715953975368267
2023-09-24,ES,Spain,0,13980340,0,121852,0.8715953975368267
2023-10-01,ES,Spain,0,13980340,0,121852,0.8715953975368267
2023-10-08,ES,Spain,0,13980340,0,121852,0.8715953975368267
2023-10-15,ES,Spain,0,13980340,0,121852,0.8715953975368267
2023-10-22,ES,Spain,0,13980340,0,121852,0.8715953975368267
2023-10-29,ES,Spain,0,13980340,0,121852,0.8715953975368267
2023-11-05,ES,Spain,0,13980340,0,121852,0.8715953975368267
2023-11-12,ES,Spain,0,13980340,0,121852,0.8715953975368267
2023-11-19,ES,Spain,0,13980340,0,121852,0.8715953975368267
2023-11-26,ES,Spain,0,13980340,0,121852,0.8715953975368267
2023-12-03,ES,Spain,0,13980340,0,121852,0.8715953975368267
2023-12-10,ES,Spain,0,13980340,0,121852,0.8715953975368267
2023-12-17,ES,Spain,0,13980340,0,121852,0.8715953975368267
2023-12-24,ES,Spain,0,13980340,0,121852,0.8715953975368267
2023-12-31,ES,Spain,0,13980340,0,121852,0.8715953975368267
2024-01-07,ES,Spain,0,13980340,0,121852,0.8715953975368267
2024-01-14,ES,Spain,0,13980340,0,121852,0.8715953975368267
2020-03-29,LK,Sri Lanka,33,115,1,1,0.8695652173913043
2020-05-17,LK,Sri Lanka,134,981,0,9,0.9174311926605505
2020-05-24,LK,Sri Lanka,160,1141,0,9,0.7887817703768624
2020-05-31,LK,Sri Lanka,492,1633,1,10,0.612369871402327
2020-06-07,LK,Sri Lanka,202,1835,1,11,0.5994550408719346
2020-06-14,LK,Sri Lanka,54,1889,0,11,0.5823186871360508
2020-06-21,LK,Sri Lanka,61,1950,0,11,0.5641025641025641
2020-06-28,LK,Sri Lanka,87,2037,0,11,0.5400098183603338
2020-07-05,LK,Sri Lanka,39,2076,0,11,0.5298651252408477
2020-07-12,LK,Sri Lanka,541,2617,0,11,0.42032862055789066
2020-07-19,LK,Sri Lanka,107,2724,0,11,0.4038179148311307
2020-07-26,LK,Sri Lanka,58,2782,0,11,0.39539899352983465
2020-08-02,LK,Sri Lanka,41,2823,0,11,0.3896563939071909
2020-08-09,LK,Sri Lanka,21,2844,0,11,0.3867791842475387
2020-08-16,LK,Sri Lanka,46,2890,0,11,0.3806228373702422
2020-08-23,LK,Sri Lanka,57,2947,1,12,0.40719375636240246
2020-08-30,LK,Sri Lanka,65,3012,0,12,0.398406374501992
2020-09-06,LK,Sri Lanka,111,3123,0,12,0.38424591738712777
2020-09-13,LK,Sri Lanka,111,3234,0,12,0.3710575139146568
2020-09-20,LK,Sri Lanka,53,3287,1,13,0.39549741405536964
2020-09-27,LK,Sri Lanka,73,3360,0,13,0.3869047619047619
2020-10-04,LK,Sri Lanka,42,3402,0,13,0.3821281599059377
2020-10-11,LK,Sri Lanka,1350,4752,0,13,0.2735690235690236
2020-10-18,LK,Sri Lanka,786,5538,0,13,0.2347417840375587
2020-10-25,LK,Sri Lanka,2334,7872,2,15,0.19054878048780488
2020-11-01,LK,Sri Lanka,3188,11060,6,21,0.18987341772151897
2020-11-08,LK,Sri Lanka,2869,13929,14,35,0.2512743197645201
2020-11-15,LK,Sri Lanka,3358,17287,23,58,0.3355122346271765
2020-11-22,LK,Sri Lanka,2884,20171,29,87,0.4313122800059492
2020-11-29,LK,Sri Lanka,3313,23484,29,116,0.49395332992675867
2020-12-06,LK,Sri Lanka,4393,27877,24,140,0.5022061197402876
2020-12-13,LK,Sri Lanka,4913,32790,12,152,0.4635559621835926
2020-12-20,LK,Sri Lanka,4471,37261,24,176,0.47234373741982233
2020-12-27,LK,Sri Lanka,3793,41054,15,191,0.465240902226336
2021-01-03,LK,Sri Lanka,3720,44774,22,213,0.4757225175324965
2021-01-10,LK,Sri Lanka,3606,48380,19,232,0.4795369987598181
2021-01-17,LK,Sri Lanka,4682,53062,32,264,0.49753118992876255
2021-01-24,LK,Sri Lanka,5368,58430,19,283,0.48434023618004446
2021-01-31,LK,Sri Lanka,5727,64157,33,316,0.4925417335598609
2021-02-07,LK,Sri Lanka,5191,69348,40,356,0.5133529445694179
2021-02-14,LK,Sri Lanka,6306,75654,41,397,0.5247574483834299
2021-02-21,LK,Sri Lanka,4345,79999,48,445,0.5562569532119152
2021-02-28,LK,Sri Lanka,3243,83242,26,471,0.565820138872204
2021-03-07,LK,Sri Lanka,2453,85695,31,502,0.5857984713227142
2021-03-14,LK,Sri Lanka,2212,87907,25,527,0.5994971959002127
2021-03-21,LK,Sri Lanka,2293,90200,19,546,0.6053215077605322
2021-03-28,LK,Sri Lanka,1888,92088,15,561,0.6091998957518895
2021-04-04,LK,Sri Lanka,1348,93436,20,581,0.6218160023973629
2021-04-11,LK,Sri Lanka,1695,95131,17,598,0.6286068684235422
2021-04-18,LK,Sri Lanka,1665,96796,20,618,0.6384561345510145
2021-04-25,LK,Sri Lanka,4583,101379,24,642,0.633267244695647
2021-05-02,LK,Sri Lanka,10374,111753,45,687,0.6147485973530912
2021-05-09,LK,Sri Lanka,14153,125906,114,801,0.6361889028322717
2021-05-16,LK,Sri Lanka,16840,142746,161,962,0.673924313115604
2021-05-23,LK,Sri Lanka,21455,164201,248,1210,0.7369017241064305
2021-05-30,LK,Sri Lanka,19251,183452,231,1441,0.7854915727274709
2021-06-06,LK,Sri Lanka,21881,205333,301,1742,0.8483780006136374
2021-06-13,LK,Sri Lanka,18305,223638,394,2136,0.9551149625734445
2020-03-15,SE,Sweden,815,994,3,3,0.30181086519114686
2022-01-16,SE,Sweden,159272,1615907,153,15644,0.968125022046442
2022-01-23,SE,Sweden,247473,1863380,247,15891,0.8528051175820284
2022-01-30,SE,Sweden,281038,2144418,296,16187,0.7548435053240553
2022-02-06,SE,Sweden,190729,2335147,351,16538,0.7082209385533331
2022-02-13,SE,Sweden,71262,2406409,331,16869,0.7010030298257695
2022-02-20,SE,Sweden,22263,2428672,373,17242,0.7099353062084959
2022-02-27,SE,Sweden,17695,2446367,322,17564,0.7179625951461902
2022-03-06,SE,Sweden,13503,2459870,271,17835,0.7250383150329083
2022-03-13,SE,Sweden,10035,2469905,207,18042,0.730473439261834
2022-03-20,SE,Sweden,8568,2478473,208,18250,0.7363404806104404
2022-03-27,SE,Sweden,7138,2485611,164,18414,0.74082388595802
2022-04-03,SE,Sweden,5017,2490628,118,18532,0.744069367243924
2022-04-10,SE,Sweden,4089,2494717,121,18653,0.7477000397239446
2022-04-17,SE,Sweden,3147,2497864,77,18730,0.7498406638632047
2022-04-24,SE,Sweden,2568,2500432,75,18805,0.7520700422966912
2022-05-01,SE,Sweden,2302,2502734,51,18856,0.7534160641921994
2022-05-08,SE,Sweden,1972,2504706,50,18906,0.7548191284725632
2022-05-15,SE,Sweden,1643,2506349,42,18948,0.7560000622419304
2022-05-22,SE,Sweden,1830,2508179,46,18994,0.7572824746559157
2022-05-29,SE,Sweden,1324,2509503,27,19021,0.7579588468314244
2022-06-05,SE,Sweden,1256,2510759,26,19047,0.758615223524042
2022-06-12,SE,Sweden,1865,2512624,21,19068,0.7588879195613829
2022-06-19,SE,Sweden,2103,2514727,29,19097,0.7594064882589642
2022-06-26,SE,Sweden,3091,2517818,32,19129,0.759745144406784
2022-07-03,SE,Sweden,4074,2521892,38,19167,0.760024616438769
2022-07-10,SE,Sweden,4171,2526063,61,19228,0.7611844993573003
2022-07-17,SE,Sweden,5417,2531480,59,19287,0.7618863273658097
2022-07-24,SE,Sweden,5974,2537454,110,19397,0.7644276507081508
2022-07-31,SE,Sweden,5709,2543163,96,19493,0.7664864580052477
2022-08-07,SE,Sweden,6223,2549386,113,19606,0.7690479197736239
2022-08-14,SE,Sweden,6644,2556030,115,19721,0.7715480647723227
2022-08-21,SE,Sweden,6640,2562670,135,19856,0.7748168901965528
2022-08-28,SE,Sweden,5067,2567737,93,19949,0.7769097847637823
2022-09-04,SE,Sweden,4770,2572507,98,20047,0.7792787347128696
2022-09-11,SE,Sweden,5077,2577584,82,20129,0.7809250833338506
2022-09-18,SE,Sweden,5055,2582639,95,20224,0.7830749864770106
2022-09-25,SE,Sweden,4963,2587602,96,20320,0.7852830535762455
2022-10-02,SE,Sweden,13579,2601181,97,20417,0.7849126992700622
2022-10-09,SE,Sweden,3965,2605146,98,20515,0.7874798571749914
2022-10-16,SE,Sweden,3427,2608573,91,20606,0.7899338067211461
2022-10-23,SE,Sweden,3297,2611870,91,20697,0.7924207560100618
2022-10-30,SE,Sweden,3482,2615352,89,20786,0.7947687347630452
2022-11-06,SE,Sweden,3412,2618764,69,20855,0.796368057602747
2022-11-13,SE,Sweden,3759,2622523,94,20949,0.7988109160529765
2022-11-20,SE,Sweden,3632,2626155,87,21036,0.8010189802201316
2022-11-27,SE,Sweden,4231,2630386,93,21129,0.8032661366050458
2022-12-04,SE,Sweden,6562,2636948,108,21237,0.8053628664653228
2022-12-11,SE,Sweden,9637,2646585,158,21395,0.8084002592019527
2022-12-18,SE,Sweden,12616,2659201,247,21642,0.813853484561716
2022-12-25,SE,Sweden,12680,2671881,361,22003,0.8235022442990538
2023-01-01,SE,Sweden,9197,2681078,370,22373,0.8344777734926025
2023-01-08,SE,Sweden,5953,2687031,403,22776,0.8476269905334177
2023-01-15,SE,Sweden,3815,2690846,302,23078,0.8576484867584395
2023-01-22,SE,Sweden,2002,2692848,230,23308,0.8655520103622633
2023-01-29,SE,Sweden,1411,2694259,145,23453,0.8704805291547695
2023-02-05,SE,Sweden,1339,2695598,97,23550,0.8736465897363034
2023-02-12,SE,Sweden,1066,2696664,70,23620,0.8758970342615915
2023-02-19,SE,Sweden,823,2697487,50,23670,0.8774833761942133
2023-02-26,SE,Sweden,642,2698129,38,23708,0.878682968827658
2023-03-05,SE,Sweden,710,2698839,51,23759,0.8803415098121822
2023-03-12,SE,Sweden,858,2699697,29,23788,0.881135920068067
2023-03-19,SE,Sweden,878,2700575,33,23821,0.8820714107180877
2023-03-26,SE,Sweden,64,2700639,4,23825,0.8821986204005792
2023-04-02,SE,Sweden,1048,2701687,54,23879,0.8838551616082839
2023-04-09,SE,Sweden,1016,2702703,47,23926,0.8852619026211906
2023-04-16,SE,Sweden,1048,2703751,51,23977,0.8868050349311013
2023-04-23,SE,Sweden,1197,2704948,55,24032,0.8884459146719271
2023-04-30,SE,Sweden,1171,2706119,70,24102,0.8906481939633843
2023-05-07,SE,Sweden,1050,2707169,79,24181,0.893220925623779
2023-05-14,SE,Sweden,948,2708117,74,24255,0.8956407717982643
2023-05-21,SE,Sweden,922,2709039,66,24321,0.8977722358371363
2023-05-28,SE,Sweden,776,2709815,62,24383,0.8998031230914287
2023-06-04,SE,Sweden,613,2710428,48,24431,0.9013705584505473
2023-06-11,SE,Sweden,518,2710946,37,24468,0.902563164297629
2023-06-18,SE,Sweden,480,2711426,44,24512,0.9040261471270098
2023-06-25,SE,Sweden,437,2711863,29,24541,0.9049498444427317
2023-07-02,SE,Sweden,290,2712153,24,24565,0.9057379874955431
2023-07-09,SE,Sweden,266,2712419,23,24588,0.9064971156742376
2023-07-16,SE,Sweden,211,2712630,28,24616,0.9074588130338453
2023-07-23,SE,Sweden,156,2712786,12,24628,0.9078489788726423
2023-07-30,SE,Sweden,173,2712959,21,24649,0.9085651497129149
2023-08-06,SE,Sweden,225,2713184,14,24663,0.909005802776369
2023-08-13,SE,Sweden,233,2713417,7,24670,0.9091857241257058
2023-08-20,SE,Sweden,257,2713674,12,24682,0.9095418241100441
2023-08-27,SE,Sweden,408,2714082,22,24704,0.910215682503329
2023-09-03,SE,Sweden,496,2714578,19,24723,0.9107492951022221
2023-09-10,SE,Sweden,569,2715147,20,24743,0.9112950422205501
2023-09-17,SE,Sweden,664,2715811,28,24771,0.9121032354607888
2023-09-24,SE,Sweden,656,2716467,41,24812,0.9133922849053568
2023-10-01,SE,Sweden,676,2717143,25,24837,0.9140851254424225
2023-10-08,SE,Sweden,595,2717738,38,24875,0.9152832245050847
2023-10-15,SE,Sweden,698,2718436,34,24909,0.916298930708687
2023-10-22,SE,Sweden,964,2719400,51,24960,0.9178495256306538
2023-10-29,SE,Sweden,1286,2720686,52,25012,0.9193269638613203
2023-11-05,SE,Sweden,2730,2723416,105,25117,0.9222608665000132
2023-11-12,SE,Sweden,3523,2726939,169,25286,0.9272667998807453
2023-11-19,SE,Sweden,3344,2730283,193,25479,0.9331999649853148
2023-11-26,SE,Sweden,3281,2733564,216,25695,0.939981650329021
2023-12-03,SE,Sweden,2592,2736156,243,25938,0.9479722647392911
2023-12-10,SE,Sweden,3292,2739448,197,26135,0.9540243143874241
2023-12-17,SE,Sweden,2936,2742384,199,26334,0.9602593947455936
2023-12-24,SE,Sweden,2370,2744754,154,26488,0.965040947203283
2023-12-31,SE,Sweden,1864,2746618,93,26581,0.9677720017854685
2024-01-07,SE,Sweden,1284,2747902,0,26581,0.9673197952474288
2024-01-14,SE,Sweden,0,2747902,0,26581,0.9673197952474288
2020-03-08,CH,Switzerland,320,365,2,2,0.547945205479452
2020-03-15,CH,Switzerland,2008,2373,18,20,0.8428150021070375
2021-12-19,CH,Switzerland,60637,1188690,195,11676,0.9822577795724705
2021-12-26,CH,Switzerland,64940,1253630,152,11828,0.943500075779935
2022-01-02,CH,Switzerland,106733,1360363,135,11963,0.87939763136751
2022-01-09,CH,Switzerland,180267,1540630,104,12067,0.7832510077046403
2022-01-16,CH,Switzerland,183977,1724607,96,12163,0.7052621263858955
2022-01-23,CH,Switzerland,233883,1958490,115,12278,0.6269115492037233
2022-01-30,CH,Switzerland,248789,2207279,93,12371,0.5604638108730251
2022-02-06,CH,Switzerland,205272,2412551,105,12476,0.5171289643203397
2022-02-13,CH,Switzerland,154937,2567488,106,12582,0.49005097589550567
2022-02-20,CH,Switzerland,112509,2679997,72,12654,0.4721647076470608
2022-02-27,CH,Switzerland,103924,2783921,83,12737,0.4575201667001327
2022-03-06,CH,Switzerland,146239,2930160,58,12795,0.43666557457613236
2022-03-13,CH,Switzerland,188362,3118522,64,12859,0.4123427700686415
2022-03-20,CH,Switzerland,186746,3305268,96,12955,0.3919500627483157
2022-03-27,CH,Switzerland,126868,3432136,89,13044,0.3800548696205512
2022-04-03,CH,Switzerland,70767,3502903,59,13103,0.3740611715482844
2022-04-10,CH,Switzerland,41402,3544305,54,13157,0.3712152311948323
2022-04-17,CH,Switzerland,31721,3576026,37,13194,0.36895704897000187
2022-04-24,CH,Switzerland,22683,3598709,32,13226,0.36752068589041237
2022-05-01,CH,Switzerland,17277,3615986,14,13240,0.3661518601012283
2022-05-08,CH,Switzerland,13324,3629310,20,13260,0.3653587045471453
2022-05-15,CH,Switzerland,11335,3640645,12,13272,0.36455078701713567
2022-05-22,CH,Switzerland,8659,3649304,12,13284,0.36401461758187315
2022-05-29,CH,Switzerland,6620,3655924,5,13289,0.3634922388977451
2022-06-05,CH,Switzerland,9943,3665867,8,13297,0.3627245614748162
2022-06-12,CH,Switzerland,14545,3680412,5,13302,0.36142692720271535
2022-06-19,CH,Switzerland,23006,3703418,8,13310,0.35939772394042474
2022-06-26,CH,Switzerland,30968,3734386,16,13326,0.35684581079727695
2022-07-03,CH,Switzerland,43611,3777997,17,13343,0.3531765641952601
2022-07-10,CH,Switzerland,55105,3833102,36,13379,0.3490384550163288
2022-07-17,CH,Switzerland,51484,3884586,32,13411,0.34523627485657415
2022-07-24,CH,Switzerland,40113,3924699,33,13444,0.34254856232286857
2022-07-31,CH,Switzerland,27191,3951890,41,13485,0.34122913340199246
2022-08-07,CH,Switzerland,20033,3971923,26,13511,0.3401626869403057
2022-08-14,CH,Switzerland,19141,3991064,19,13530,0.3390073424029281
2022-08-21,CH,Switzerland,16800,4007864,16,13546,0.33798552046676233
2022-08-28,CH,Switzerland,15322,4023186,12,13558,0.3369965992126638
2022-09-04,CH,Switzerland,14883,4038069,9,13567,0.3359774189098799
2022-09-11,CH,Switzerland,13697,4051766,9,13576,0.335063772192175
2022-09-18,CH,Switzerland,13919,4065685,7,13583,0.33408884357740454
2022-09-25,CH,Switzerland,15166,4080851,12,13595,0.3331412982243165
2022-10-02,CH,Switzerland,23043,4103894,15,13610,0.3316362459654172
2022-10-09,CH,Switzerland,33930,4137824,15,13625,0.32927935069253794
2022-10-16,CH,Switzerland,37233,4175057,23,13648,0.3268937406124036
2022-10-23,CH,Switzerland,31654,4206711,31,13679,0.3251708995459874
2022-10-30,CH,Switzerland,24730,4231441,27,13706,0.3239085692084564
2022-11-06,CH,Switzerland,21366,4252807,22,13728,0.3227985657472818
2022-11-13,CH,Switzerland,20553,4273360,12,13740,0.32152685474661624
2022-11-20,CH,Switzerland,21343,4294703,21,13761,0.32041796603862943
2022-11-27,CH,Switzerland,19531,4314234,20,13781,0.319430981258782
2022-12-04,CH,Switzerland,18634,4332868,19,13800,0.31849574000408043
2022-12-11,CH,Switzerland,16715,4349583,24,13824,0.3178235706733266
2022-12-18,CH,Switzerland,13777,4363360,26,13850,0.31741593634263504
2022-12-25,CH,Switzerland,11725,4375085,15,13865,0.31690812864207213
2023-01-01,CH,Switzerland,5948,4381033,19,13884,0.31691155944271593
2023-01-08,CH,Switzerland,2275,4383308,23,13907,0.31727179563927516
2023-01-15,CH,Switzerland,1366,4384674,14,13921,0.31749224685803323
2023-01-22,CH,Switzerland,117,4384791,2,13923,0.31752938737558983
2023-01-29,CH,Switzerland,926,4385717,8,13931,0.3176447545521063
2023-02-05,CH,Switzerland,847,4386564,7,13938,0.3177429988483013
2023-02-12,CH,Switzerland,912,4387476,5,13943,0.3177909121326248
2023-02-19,CH,Switzerland,971,4388447,4,13947,0.317811745248376
2023-02-26,CH,Switzerland,1218,4389665,6,13953,0.3178602467386463
2023-03-05,CH,Switzerland,1361,4391026,3,13956,0.3178300470095144
2023-03-12,CH,Switzerland,1491,4392517,6,13962,0.31785875842939254
2023-03-19,CH,Switzerland,1797,4394314,6,13968,0.3178653141309429
2023-03-26,CH,Switzerland,1785,4396099,10,13978,0.31796372192709943
2023-04-02,CH,Switzerland,1585,4397684,9,13987,0.31805377557823616
2023-04-09,CH,Switzerland,1435,4399119,8,13995,0.3181318804969813
2023-04-16,CH,Switzerland,1180,4400299,3,13998,0.3181147462933769
2023-04-23,CH,Switzerland,1114,4401413,6,14004,0.31817055113891834
2023-04-30,CH,Switzerland,1062,4402475,6,14010,0.3182300864854428
2023-05-07,CH,Switzerland,1016,4403491,5,14015,0.3182702087957032
2023-05-14,CH,Switzerland,851,4404342,12,14027,0.31848117153481725
2023-05-21,CH,Switzerland,584,4404926,4,14031,0.31852975509690745
2023-05-28,CH,Switzerland,512,4405438,2,14033,0.3185381340061987
2023-06-04,CH,Switzerland,511,4405949,2,14035,0.3185465832673052
2023-06-11,CH,Switzerland,379,4406328,2,14037,0.3185645734952096
2023-06-18,CH,Switzerland,282,4406610,1,14038,0.31856688020950347
2023-06-25,CH,Switzerland,204,4406814,1,14039,0.31857482525924624
2023-07-02,CH,Switzerland,181,4406995,0,14039,0.3185617410503075
2023-07-09,CH,Switzerland,118,4407113,1,14040,0.31857590218358367
2023-07-16,CH,Switzerland,134,4407247,0,14040,0.31856621605278757
2023-07-23,CH,Switzerland,150,4407397,1,14041,0.31857806319693915
2023-07-30,CH,Switzerland,175,4407572,1,14042,0.3185881024745597
2023-08-06,CH,Switzerland,213,4407785,2,14044,0.3186180814173105
2023-08-13,CH,Switzerland,261,4408046,3,14047,0.3186672734358943
2023-08-20,CH,Switzerland,446,4408492,0,14047,0.31863503438363955
2023-08-27,CH,Switzerland,625,4409117,2,14049,0.3186352278698887
2023-09-03,CH,Switzerland,660,4409777,3,14052,0.3186555692045199
2023-09-10,CH,Switzerland,724,4410501,1,14053,0.318625933879167
2023-09-17,CH,Switzerland,1133,4411634,4,14057,0.3186347734195539
2023-09-24,CH,Switzerland,942,4412576,2,14059,0.3186120760299652
2023-10-01,CH,Switzerland,888,4413464,4,14063,0.3186386022407796
2023-10-08,CH,Switzerland,1007,4414471,4,14067,0.31865652758846985
2023-10-15,CH,Switzerland,1214,4415685,5,14072,0.3186821523727349
2023-10-22,CH,Switzerland,1457,4417142,6,14078,0.3187128690904662
2023-10-29,CH,Switzerland,1612,4418754,4,14082,0.3186871231120809
2023-11-05,CH,Switzerland,2183,4420937,4,14086,0.3186202381983729
2023-11-12,CH,Switzerland,2900,4423837,10,14096,0.3186374181508044
2023-11-19,CH,Switzerland,3554,4427391,17,14113,0.3187656116209298
2023-11-26,CH,Switzerland,3471,4430862,17,14130,0.31889957304018945
2023-12-03,CH,Switzerland,3652,4434514,14,14144,0.3189526518576782
2023-12-10,CH,Switzerland,3713,4438227,14,14158,0.31900125883601715
2023-12-17,CH,Switzerland,3636,4441863,12,14170,0.3190102891511963
2023-12-24,CH,Switzerland,3016,4444879,4,14174,0.31888382113438857
2023-12-31,CH,Switzerland,2079,4446958,0,14174,0.31873473956803733
2024-01-07,CH,Switzerland,1495,4448453,0,14174,0.3186276217822241
2024-01-14,CH,Switzerland,0,4448453,0,14174,0.3186276217822241
2020-06-21,TJ,Tajikistan,428,5399,2,52,0.9631413224671235
2020-06-28,TJ,Tajikistan,400,5799,0,52,0.8967063286773581
2020-07-05,TJ,Tajikistan,360,6159,0,52,0.8442929046923201
2020-07-12,TJ,Tajikistan,346,6505,3,55,0.8455034588777863
2020-07-19,TJ,Tajikistan,329,6834,2,57,0.8340649692712907
2020-07-26,TJ,Tajikistan,316,7150,2,59,0.8251748251748252
2020-08-02,TJ,Tajikistan,301,7451,1,60,0.8052610387867399
2020-08-09,TJ,Tajikistan,294,7745,2,62,0.8005164622336991
2020-08-16,TJ,Tajikistan,284,8029,2,64,0.7971104745298293
2020-08-23,TJ,Tajikistan,248,8277,2,66,0.7973903588256614
2020-08-30,TJ,Tajikistan,239,8516,2,68,0.7984969469234382
2020-09-06,TJ,Tajikistan,241,8757,2,70,0.7993605115907274
2020-09-13,TJ,Tajikistan,257,9014,2,72,0.7987574883514533
2020-09-20,TJ,Tajikistan,289,9303,1,73,0.7846931097495432
2020-09-27,TJ,Tajikistan,302,9605,2,75,0.7808433107756376
2020-10-04,TJ,Tajikistan,290,9895,2,77,0.7781707933299646
2020-10-11,TJ,Tajikistan,285,10180,2,79,0.7760314341846758
2020-10-18,TJ,Tajikistan,275,10455,1,80,0.7651841224294597
2020-10-25,TJ,Tajikistan,281,10736,1,81,0.7544709388971684
2020-11-01,TJ,Tajikistan,281,11017,1,82,0.7443042570572751
2020-11-08,TJ,Tajikistan,277,11294,1,83,0.734903488578006
2020-11-15,TJ,Tajikistan,279,11573,2,85,0.7344681586451223
2020-11-22,TJ,Tajikistan,281,11854,1,86,0.7254935043023452
2020-11-29,TJ,Tajikistan,264,12118,0,86,0.7096880673378445
2020-12-06,TJ,Tajikistan,271,12389,1,87,0.7022358543869561
2020-12-13,TJ,Tajikistan,468,12857,0,87,0.6766741852687252
2020-12-20,TJ,Tajikistan,382,13239,2,89,0.6722562127048871
2020-12-27,TJ,Tajikistan,316,13555,1,90,0.6639616377720399
2021-01-03,TJ,Tajikistan,119,13674,1,91,0.6654965628199503
2021-01-10,TJ,Tajikistan,33,13707,0,91,0.6638943605457066
2021-01-17,TJ,Tajikistan,7,13714,0,91,0.6635554907393904
2021-01-24,TJ,Tajikistan,0,13714,0,91,0.6635554907393904
2021-01-31,TJ,Tajikistan,0,13714,0,91,0.6635554907393904
2021-02-07,TJ,Tajikistan,0,13714,0,91,0.6635554907393904
2021-02-14,TJ,Tajikistan,0,13714,0,91,0.6635554907393904
2021-02-21,TJ,Tajikistan,0,13714,0,91,0.6635554907393904
2021-02-28,TJ,Tajikistan,0,13714,0,91,0.6635554907393904
2021-03-07,TJ,Tajikistan,0,13714,0,91,0.6635554907393904
2021-03-14,TJ,Tajikistan,0,13714,0,91,0.6635554907393904
2021-03-21,TJ,Tajikistan,0,13714,0,91,0.6635554907393904
2021-03-28,TJ,Tajikistan,0,13714,0,91,0.6635554907393904
2021-04-04,TJ,Tajikistan,0,13714,0,91,0.6635554907393904
2021-04-11,TJ,Tajikistan,0,13714,0,91,0.6635554907393904
2021-04-18,TJ,Tajikistan,0,13714,0,91,0.6635554907393904
2021-04-25,TJ,Tajikistan,0,13714,0,91,0.6635554907393904
2021-05-02,TJ,Tajikistan,0,13714,0,91,0.6635554907393904
2021-05-09,TJ,Tajikistan,0,13714,0,91,0.6635554907393904
2021-05-16,TJ,Tajikistan,0,13714,0,91,0.6635554907393904
2021-05-23,TJ,Tajikistan,0,13714,0,91,0.6635554907393904
2021-05-30,TJ,Tajikistan,0,13714,0,91,0.6635554907393904
2021-06-06,TJ,Tajikistan,0,13714,0,91,0.6635554907393904
2021-06-13,TJ,Tajikistan,0,13714,0,91,0.6635554907393904
2021-06-20,TJ,Tajikistan,0,13714,0,91,0.6635554907393904
2021-06-27,TJ,Tajikistan,131,13845,0,91,0.6572769953051643
2021-07-04,TJ,Tajikistan,158,14003,3,94,0.6712847247018496
2021-07-11,TJ,Tajikistan,237,14240,10,104,0.7303370786516854
2021-07-18,TJ,Tajikistan,287,14527,8,112,0.7709781785640532
2021-07-25,TJ,Tajikistan,477,15004,6,118,0.7864569448147161
2021-08-01,TJ,Tajikistan,546,15550,4,122,0.7845659163987138
2021-08-08,TJ,Tajikistan,501,16051,1,123,0.7663073951778706
2021-08-15,TJ,Tajikistan,470,16521,2,125,0.7566127958356031
2021-08-22,TJ,Tajikistan,347,16868,0,125,0.7410481384870761
2021-08-29,TJ,Tajikistan,310,17178,0,125,0.7276749330539062
2021-09-05,TJ,Tajikistan,135,17313,0,125,0.7220008086409057
2021-09-12,TJ,Tajikistan,129,17442,0,125,0.7166609333791997
2021-09-19,TJ,Tajikistan,42,17484,0,125,0.7149393731411576
2021-09-26,TJ,Tajikistan,0,17484,0,125,0.7149393731411576
2021-10-03,TJ,Tajikistan,0,17484,0,125,0.7149393731411576
2021-10-10,TJ,Tajikistan,0,17484,0,125,0.7149393731411576
2021-10-17,TJ,Tajikistan,0,17484,0,125,0.7149393731411576
2021-10-24,TJ,Tajikistan,2,17486,0,125,0.7148576003660071
2021-10-31,TJ,Tajikistan,0,17486,0,125,0.7148576003660071
2021-11-07,TJ,Tajikistan,0,17486,0,125,0.7148576003660071
2021-11-14,TJ,Tajikistan,2,17488,0,125,0.714775846294602
2021-11-21,TJ,Tajikistan,1,17489,0,125,0.7147349762707987
2021-11-28,TJ,Tajikistan,4,17493,0,125,0.7145715429028755
2021-12-05,TJ,Tajikistan,0,17493,0,125,0.7145715429028755
2021-12-12,TJ,Tajikistan,0,17493,0,125,0.7145715429028755
2021-12-19,TJ,Tajikistan,0,17493,0,125,0.7145715429028755
2021-12-26,TJ,Tajikistan,0,17493,0,125,0.7145715429028755
2022-01-02,TJ,Tajikistan,0,17493,0,125,0.7145715429028755
2022-01-09,TJ,Tajikistan,0,17493,0,125,0.7145715429028755
2022-01-16,TJ,Tajikistan,0,17493,0,125,0.7145715429028755
2022-01-23,TJ,Tajikistan,59,17552,0,125,0.7121695533272562
2022-01-30,TJ,Tajikistan,143,17695,0,125,0.7064142413111049
2022-02-06,TJ,Tajikistan,47,17742,0,125,0.7045428925712997
2022-02-13,TJ,Tajikistan,31,17773,0,125,0.7033140156417037
2022-02-20,TJ,Tajikistan,13,17786,0,125,0.7027999550208028
2022-02-27,TJ,Tajikistan,0,17786,0,125,0.7027999550208028
2022-03-06,TJ,Tajikistan,0,17786,0,125,0.7027999550208028
2022-03-13,TJ,Tajikistan,0,17786,0,125,0.7027999550208028
2022-03-20,TJ,Tajikistan,0,17786,0,125,0.7027999550208028
2022-03-27,TJ,Tajikistan,0,17786,0,125,0.7027999550208028
2022-04-03,TJ,Tajikistan,0,17786,0,125,0.7027999550208028
2022-04-10,TJ,Tajikistan,0,17786,0,125,0.7027999550208028
2022-04-17,TJ,Tajikistan,0,17786,0,125,0.7027999550208028
2022-04-24,TJ,Tajikistan,0,17786,0,125,0.7027999550208028
2022-05-01,TJ,Tajikistan,0,17786,0,125,0.7027999550208028
2022-05-08,TJ,Tajikistan,0,17786,0,125,0.7027999550208028
2022-05-15,TJ,Tajikistan,0,17786,0,125,0.7027999550208028
2022-05-22,TJ,Tajikistan,0,17786,0,125,0.7027999550208028
2022-05-29,TJ,Tajikistan,0,17786,0,125,0.7027999550208028
2022-06-05,TJ,Tajikistan,0,17786,0,125,0.7027999550208028
2022-06-12,TJ,Tajikistan,0,17786,0,125,0.7027999550208028
2022-06-19,TJ,Tajikistan,0,17786,0,125,0.7027999550208028
2022-06-26,TJ,Tajikistan,0,17786,0,125,0.7027999550208028
2022-07-03,TJ,Tajikistan,0,17786,0,125,0.7027999550208028
2022-07-10,TJ,Tajikistan,0,17786,0,125,0.7027999550208028
2022-07-17,TJ,Tajikistan,0,17786,0,125,0.7027999550208028
2022-07-24,TJ,Tajikistan,0,17786,0,125,0.7027999550208028
2022-07-31,TJ,Tajikistan,0,17786,0,125,0.7027999550208028
2022-08-07,TJ,Tajikistan,0,17786,0,125,0.7027999550208028
2022-08-14,TJ,Tajikistan,0,17786,0,125,0.7027999550208028
2022-08-21,TJ,Tajikistan,0,17786,0,125,0.7027999550208028
2022-08-28,TJ,Tajikistan,0,17786,0,125,0.7027999550208028
2022-09-04,TJ,Tajikistan,0,17786,0,125,0.7027999550208028
2022-09-11,TJ,Tajikistan,0,17786,0,125,0.7027999550208028
2022-09-18,TJ,Tajikistan,0,17786,0,125,0.7027999550208028
2022-09-25,TJ,Tajikistan,0,17786,0,125,0.7027999550208028
2022-10-02,TJ,Tajikistan,0,17786,0,125,0.7027999550208028
2022-10-09,TJ,Tajikistan,0,17786,0,125,0.7027999550208028
2022-10-16,TJ,Tajikistan,0,17786,0,125,0.7027999550208028
2022-10-23,TJ,Tajikistan,0,17786,0,125,0.7027999550208028
2022-10-30,TJ,Tajikistan,0,17786,0,125,0.7027999550208028
2022-11-06,TJ,Tajikistan,0,17786,0,125,0.7027999550208028
2022-11-13,TJ,Tajikistan,0,17786,0,125,0.7027999550208028
2022-11-20,TJ,Tajikistan,0,17786,0,125,0.7027999550208028
2022-11-27,TJ,Tajikistan,0,17786,0,125,0.7027999550208028
2022-12-04,TJ,Tajikistan,0,17786,0,125,0.7027999550208028
2022-12-11,TJ,Tajikistan,0,17786,0,125,0.7027999550208028
2022-12-18,TJ,Tajikistan,0,17786,0,125,0.7027999550208028
2022-12-25,TJ,Tajikistan,0,17786,0,125,0.7027999550208028
2023-01-01,TJ,Tajikistan,0,17786,0,125,0.7027999550208028
2023-01-08,TJ,Tajikistan,0,17786,0,125,0.7027999550208028
2023-01-15,TJ,Tajikistan,0,17786,0,125,0.7027999550208028
2023-01-22,TJ,Tajikistan,0,17786,0,125,0.7027999550208028
2023-01-29,TJ,Tajikistan,0,17786,0,125,0.7027999550208028
2023-02-05,TJ,Tajikistan,0,17786,0,125,0.7027999550208028
2023-02-12,TJ,Tajikistan,0,17786,0,125,0.7027999550208028
2023-02-19,TJ,Tajikistan,0,17786,0,125,0.7027999550208028
2023-02-26,TJ,Tajikistan,0,17786,0,125,0.7027999550208028
2023-03-05,TJ,Tajikistan,0,17786,0,125,0.7027999550208028
2023-03-12,TJ,Tajikistan,0,17786,0,125,0.7027999550208028
2023-03-19,TJ,Tajikistan,0,17786,0,125,0.7027999550208028
2023-03-26,TJ,Tajikistan,0,17786,0,125,0.7027999550208028
2023-04-02,TJ,Tajikistan,0,17786,0,125,0.7027999550208028
2023-04-09,TJ,Tajikistan,0,17786,0,125,0.7027999550208028
2023-04-16,TJ,Tajikistan,0,17786,0,125,0.7027999550208028
2023-04-23,TJ,Tajikistan,0,17786,0,125,0.7027999550208028
2023-04-30,TJ,Tajikistan,0,17786,0,125,0.7027999550208028
2023-05-07,TJ,Tajikistan,0,17786,0,125,0.7027999550208028
2023-05-14,TJ,Tajikistan,0,17786,0,125,0.7027999550208028
2023-05-21,TJ,Tajikistan,0,17786,0,125,0.7027999550208028
2023-05-28,TJ,Tajikistan,0,17786,0,125,0.7027999550208028
2023-06-04,TJ,Tajikistan,0,17786,0,125,0.7027999550208028
2023-06-11,TJ,Tajikistan,0,17786,0,125,0.7027999550208028
2023-06-18,TJ,Tajikistan,0,17786,0,125,0.7027999550208028
2023-06-25,TJ,Tajikistan,0,17786,0,125,0.7027999550208028
2023-07-02,TJ,Tajikistan,0,17786,0,125,0.7027999550208028
2023-07-09,TJ,Tajikistan,0,17786,0,125,0.7027999550208028
2023-07-16,TJ,Tajikistan,0,17786,0,125,0.7027999550208028
2023-07-23,TJ,Tajikistan,0,17786,0,125,0.7027999550208028
2023-07-30,TJ,Tajikistan,0,17786,0,125,0.7027999550208028
2023-08-06,TJ,Tajikistan,0,17786,0,125,0.7027999550208028
2023-08-13,TJ,Tajikistan,0,17786,0,125,0.7027999550208028
2023-08-20,TJ,Tajikistan,0,17786,0,125,0.7027999550208028
2023-08-27,TJ,Tajikistan,0,17786,0,125,0.7027999550208028
2023-09-03,TJ,Tajikistan,0,17786,0,125,0.7027999550208028
2023-09-10,TJ,Tajikistan,0,17786,0,125,0.7027999550208028
2023-09-17,TJ,Tajikistan,0,17786,0,125,0.7027999550208028
2023-09-24,TJ,Tajikistan,0,17786,0,125,0.7027999550208028
2023-10-01,TJ,Tajikistan,0,17786,0,125,0.7027999550208028
2023-10-08,TJ,Tajikistan,0,17786,0,125,0.7027999550208028
2023-10-15,TJ,Tajikistan,0,17786,0,125,0.7027999550208028
2023-10-22,TJ,Tajikistan,0,17786,0,125,0.7027999550208028
2023-10-29,TJ,Tajikistan,0,17786,0,125,0.7027999550208028
2023-11-05,TJ,Tajikistan,0,17786,0,125,0.7027999550208028
2023-11-12,TJ,Tajikistan,0,17786,0,125,0.7027999550208028
2023-11-19,TJ,Tajikistan,0,17786,0,125,0.7027999550208028
2023-11-26,TJ,Tajikistan,0,17786,0,125,0.7027999550208028
2023-12-03,TJ,Tajikistan,0,17786,0,125,0.7027999550208028
2023-12-10,TJ,Tajikistan,0,17786,0,125,0.7027999550208028
2023-12-17,TJ,Tajikistan,0,17786,0,125,0.7027999550208028
2023-12-24,TJ,Tajikistan,0,17786,0,125,0.7027999550208028
2023-12-31,TJ,Tajikistan,0,17786,0,125,0.7027999550208028
2024-01-07,TJ,Tajikistan,0,17786,0,125,0.7027999550208028
2024-01-14,TJ,Tajikistan,0,17786,0,125,0.7027999550208028
2020-03-15,TH,Thailand,60,114,0,1,0.8771929824561403
2020-03-22,TH,Thailand,485,599,0,1,0.1669449081803005
2020-03-29,TH,Thailand,789,1388,6,7,0.5043227665706052
2020-12-27,TH,Thailand,1234,6141,0,60,0.9770395701025891
2021-01-03,TH,Thailand,1553,7694,4,64,0.8318170002599428
2021-01-10,TH,Thailand,2604,10298,3,67,0.6506117692755875
2021-01-17,TH,Thailand,1756,12054,3,70,0.5807200929152149
2021-01-24,TH,Thailand,1446,13500,3,73,0.5407407407407407
2021-01-31,TH,Thailand,5282,18782,4,77,0.40996698967096157
2021-02-07,TH,Thailand,4589,23371,2,79,0.3380257584185529
2021-02-14,TH,Thailand,1200,24571,1,80,0.3255870741931545
2021-02-21,TH,Thailand,844,25415,3,83,0.3265787920519378
2021-02-28,TH,Thailand,536,25951,0,83,0.3198335324264961
2021-03-07,TH,Thailand,419,26370,2,85,0.3223359878649981
2021-03-14,TH,Thailand,557,26927,1,86,0.31938203290377687
2021-03-21,TH,Thailand,876,27803,4,90,0.3237060748840053
2021-03-28,TH,Thailand,931,28734,4,94,0.32713858147142755
2021-04-04,TH,Thailand,393,29127,1,95,0.32615786040443573
2021-04-11,TH,Thailand,3498,32625,2,97,0.2973180076628352
2021-04-18,TH,Thailand,9727,42352,4,101,0.23847752172270492
2021-04-25,TH,Thailand,13108,55460,39,140,0.25243418680129825
2021-05-02,TH,Thailand,13524,68984,105,245,0.3551548185086397
2021-05-09,TH,Thailand,14391,83375,154,399,0.47856071964017993
2021-05-16,TH,Thailand,18072,101447,190,589,0.5805987362859424
2021-05-23,TH,Thailand,28053,129500,187,776,0.5992277992277992
2021-05-30,TH,Thailand,24807,154307,236,1012,0.655835444924728
2021-06-06,TH,Thailand,23160,177467,224,1236,0.6964675122698868
2021-06-13,TH,Thailand,18442,195909,213,1449,0.73962911351699
2021-06-20,TH,Thailand,22222,218131,180,1629,0.7467989419202223
2021-06-27,TH,Thailand,26316,244447,283,1912,0.782173640911936
2021-07-04,TH,Thailand,38620,283067,314,2226,0.7863862619097245
2021-07-11,TH,Thailand,53304,336371,485,2711,0.8059553290860388
2021-07-18,TH,Thailand,67015,403386,630,3341,0.8282389572270729
2021-07-25,TH,Thailand,93916,497302,718,4059,0.8162042380686182
2021-08-01,TH,Thailand,118012,615314,931,4990,0.8109680585847225
2021-08-08,TH,Thailand,141191,756505,1214,6204,0.820087111122861
2021-08-15,TH,Thailand,150652,907157,1348,7552,0.8324909580149854
2021-08-22,TH,Thailand,142138,1049295,1768,9320,0.8882154208301765
2021-08-29,TH,Thailand,124796,1174091,1823,11143,0.9490746458323929
2021-11-21,TH,Thailand,46171,2064581,351,20387,0.9874642845206848
2021-11-28,TH,Thailand,42232,2106813,320,20707,0.9828589438170354
2021-12-05,TH,Thailand,34428,2141241,237,20944,0.9781243680650614
2021-12-12,TH,Thailand,27405,2168646,227,21171,0.9762312521269032
2021-12-19,TH,Thailand,22882,2191528,206,21377,0.9754381417896554
2021-12-26,TH,Thailand,18442,2209970,203,21580,0.9764838436720861
2022-01-02,TH,Thailand,19588,2229558,140,21720,0.974184120798831
2022-01-09,TH,Thailand,39992,2269550,105,21825,0.9616443788416206
2022-01-16,TH,Thailand,54935,2324485,100,21925,0.9432196809185691
2022-01-23,TH,Thailand,53015,2377500,107,22032,0.9266876971608834
2022-01-30,TH,Thailand,55034,2432534,125,22157,0.9108608553878383
2022-02-06,TH,Thailand,64467,2497001,134,22291,0.8927108959908305
2022-02-13,TH,Thailand,96326,2593327,145,22436,0.8651435009931258
2022-02-20,TH,Thailand,118988,2712315,188,22624,0.8341214055152149
2022-02-27,TH,Thailand,157301,2869616,267,22891,0.7977025497488166
2022-03-06,TH,Thailand,157079,3026695,344,23235,0.7676690251247648
2022-03-13,TH,Thailand,158130,3184825,474,23709,0.7444365075004121
2022-03-20,TH,Thailand,169144,3353969,537,24246,0.7229047137883504
2022-03-27,TH,Thailand,175116,3529085,553,24799,0.7027033919557052
2022-04-03,TH,Thailand,182510,3711595,616,25415,0.6847460458374365
2022-04-10,TH,Thailand,171890,3883485,668,26083,0.6716390046568997
2022-04-17,TH,Thailand,146474,4029959,799,26882,0.6670539328067606
2022-04-24,TH,Thailand,135915,4165874,893,27775,0.6667268381136827
2022-05-01,TH,Thailand,96610,4262484,842,28617,0.6713690890100702
2022-05-08,TH,Thailand,62366,4324850,471,29088,0.6725782397077354
2022-05-15,TH,Thailand,48996,4373846,384,29472,0.6738234496596359
2022-05-22,TH,Thailand,37648,4411494,274,29746,0.6742840407354062
2022-05-29,TH,Thailand,31154,4442648,226,29972,0.6746426905755306
2022-06-05,TH,Thailand,24145,4466793,199,30171,0.6754510450786504
2022-06-12,TH,Thailand,18070,4484863,163,30334,0.6763640271731823
2022-06-19,TH,Thailand,14181,4499044,133,30467,0.6771883093386061
2022-06-26,TH,Thailand,15111,4514155,125,30592,0.6776905090764496
2022-07-03,TH,Thailand,15950,4530105,108,30700,0.677688486249215
2022-07-10,TH,Thailand,14938,4545043,135,30835,0.6784314251812359
2022-07-17,TH,Thailand,13986,4559029,161,30996,0.6798816151421717
2022-07-24,TH,Thailand,16824,4575853,161,31157,0.6809003698326848
2022-07-31,TH,Thailand,14323,4590176,228,31385,0.6837428455902345
2022-08-07,TH,Thailand,15433,4605609,211,31596,0.6860330523064376
2022-08-14,TH,Thailand,14816,4620425,232,31828,0.6888543802788705
2022-08-21,TH,Thailand,13755,4634180,199,32027,0.691103927771472
2022-08-28,TH,Thailand,12232,4646412,195,32222,0.6934813357059167
2022-09-04,TH,Thailand,12130,4658542,178,32400,0.6954965738207362
2022-09-11,TH,Thailand,9004,4667546,139,32539,0.6971329259529525
2022-09-18,TH,Thailand,5841,4673387,90,32629,0.6981874173912839
2022-09-25,TH,Thailand,4965,4678352,89,32718,0.6993488305283571
2022-10-02,TH,Thailand,3780,4682132,53,32771,0.6999161920253423
2022-10-09,TH,Thailand,2915,4685047,58,32829,0.7007186907623338
2022-10-16,TH,Thailand,2234,4687281,53,32882,0.7015154414680921
2022-10-23,TH,Thailand,2616,4689897,40,32922,0.7019770370223483
2022-10-30,TH,Thailand,2551,4692448,33,32955,0.702298672249538
2022-11-06,TH,Thailand,2759,4695207,40,32995,0.7027379197551886
2022-11-13,TH,Thailand,3166,4698373,42,33037,0.7031583060774443
2022-11-20,TH,Thailand,3957,4702330,69,33106,0.7040339576337689
2022-11-27,TH,Thailand,4914,4707244,74,33180,0.7048710455629664
2022-12-04,TH,Thailand,4284,4711528,105,33285,0.7064587114838329
2022-12-11,TH,Thailand,3961,4715489,107,33392,0.7081344055727836
2022-12-18,TH,Thailand,3419,4718908,113,33505,0.7100159613198648
2022-12-25,TH,Thailand,2900,4721808,89,33594,0.7114647609559728
2023-01-01,TH,Thailand,2111,4723919,75,33669,0.7127344901553139
2023-01-08,TH,Thailand,997,4724916,58,33727,0.7138116317835068
2023-01-15,TH,Thailand,969,4725885,65,33792,0.7150406749212053
2023-01-22,TH,Thailand,627,4726512,44,33836,0.7158767395491644
2023-01-29,TH,Thailand,472,4726984,29,33865,0.716418756653291
2023-02-05,TH,Thailand,252,4727236,17,33882,0.7167401839045057
2023-02-12,TH,Thailand,392,4727628,12,33894,0.7169345811472476
2023-02-19,TH,Thailand,203,4727831,8,33902,0.7170730087433328
2023-02-26,TH,Thailand,204,4728035,9,33911,0.7172324231948367
2023-03-05,TH,Thailand,147,4728182,7,33918,0.7173581727606932
2023-03-12,TH,Thailand,122,4728304,6,33924,0.7174665588337805
2023-03-19,TH,Thailand,178,4728482,5,33929,0.7175452925484331
2023-03-26,TH,Thailand,150,4728632,6,33935,0.7176494174213599
2023-04-02,TH,Thailand,167,4728799,3,33938,0.7176875143138882
2023-04-09,TH,Thailand,168,4728967,2,33940,0.7177043104762626
2023-04-16,TH,Thailand,435,4729402,2,33942,0.7176805862559368
2023-04-23,TH,Thailand,1088,4730490,5,33947,0.7176212189434922
2023-04-30,TH,Thailand,1811,4732301,10,33957,0.7175579068195367
2023-05-07,TH,Thailand,1699,4734000,10,33967,0.7175116180819603
2023-05-14,TH,Thailand,2356,4736356,22,33989,0.7176191992324901
2023-05-21,TH,Thailand,2632,4738988,64,34053,0.7185711379729174
2023-05-28,TH,Thailand,2970,4741958,42,34095,0.7190067900221807
2023-06-04,TH,Thailand,3085,4745043,68,34163,0.7199724006716061
2023-06-11,TH,Thailand,2709,4747752,69,34232,0.7210149140056178
2023-06-18,TH,Thailand,2158,4749910,60,34292,0.7219505211677695
2023-06-25,TH,Thailand,1653,4751563,36,34328,0.7224570104616101
2023-07-02,TH,Thailand,859,4752422,43,34371,0.7232312282032193
2023-07-09,TH,Thailand,1193,4753615,25,34396,0.723575636647057
2023-07-16,TH,Thailand,613,4754228,14,34410,0.7237768150791254
2023-07-23,TH,Thailand,556,4754784,8,34418,0.7238604319354991
2023-07-30,TH,Thailand,391,4755175,7,34425,0.723948119680138
2023-08-06,TH,Thailand,268,4755443,12,34437,0.7241596629378168
2023-08-13,TH,Thailand,318,4755761,7,34444,0.7242584309850727
2023-08-20,TH,Thailand,389,4756150,9,34453,0.7243884234096906
2023-08-27,TH,Thailand,256,4756406,6,34459,0.7244755809323258
2023-09-03,TH,Thailand,187,4756593,6,34465,0.7245732397117013
2023-09-10,TH,Thailand,244,4756837,3,34468,0.7245991401429143
2023-09-17,TH,Thailand,212,4757049,3,34471,0.7246299123679407
2023-09-24,TH,Thailand,234,4757283,2,34473,0.7246363102636526
2023-10-01,TH,Thailand,190,4757473,1,34474,0.7246283899036315
2023-10-08,TH,Thailand,131,4757604,5,34479,0.7247135322738084
2023-10-15,TH,Thailand,124,4757728,3,34482,0.724757699473362
2023-10-22,TH,Thailand,191,4757919,3,34485,0.72479165786555
2023-10-29,TH,Thailand,206,4758125,2,34487,0.724802311835019
2023-11-05,TH,Thailand,304,4758429,1,34488,0.7247770219961253
2023-11-12,TH,Thailand,287,4758716,1,34489,0.7247543244858488
2023-11-19,TH,Thailand,390,4759106,1,34490,0.7247159445492494
2023-11-26,TH,Thailand,480,4759586,2,34492,0.7246848780545199
2023-12-03,TH,Thailand,536,4760122,3,34495,0.7246663005696072
2023-12-10,TH,Thailand,590,4760712,5,34500,0.7246815182266855
2023-12-17,TH,Thailand,514,4761226,6,34506,0.7247293029148375
2023-12-24,TH,Thailand,555,4761781,8,34514,0.7248128378856566
2023-12-31,TH,Thailand,594,4762375,3,34517,0.7247854274390404
2024-01-07,TH,Thailand,664,4763039,4,34521,0.7247683674225636
2024-01-14,TH,Thailand,625,4763664,7,34528,0.7248202224170303
2022-03-06,GB,United Kingdom of Great Britain and Northern Ireland,277241,19208202,796,188233,0.9799615809954518
2022-03-13,GB,United Kingdom of Great Britain and Northern Ireland,437488,19645690,778,189011,0.9620990660037902
2022-03-20,GB,United Kingdom of Great Britain and Northern Ireland,581248,20226938,951,189962,0.9391535189359852
2022-03-27,GB,United Kingdom of Great Britain and Northern Ireland,606372,20833310,1176,191138,0.9174634275590389
2022-04-03,GB,United Kingdom of Great Britain and Northern Ireland,478671,21311981,1272,192410,0.9028255045835485
2022-04-10,GB,United Kingdom of Great Britain and Northern Ireland,299046,21611027,1426,193836,0.8969309973098456
2022-04-17,GB,United Kingdom of Great Britain and Northern Ireland,209920,21820947,1340,195176,0.8944433071580258
2022-04-24,GB,United Kingdom of Great Britain and Northern Ireland,146688,21967635,1137,196313,0.8936464940354297
2022-05-01,GB,United Kingdom of Great Britain and Northern Ireland,94269,22061904,904,197217,0.8939255650826874
2022-05-08,GB,United Kingdom of Great Britain and Northern Ireland,73460,22135364,712,197929,0.894175492212371
2022-05-15,GB,United Kingdom of Great Britain and Northern Ireland,60338,22195702,592,198521,0.894411900105705
2022-05-22,GB,United Kingdom of Great Britain and Northern Ireland,52075,22247777,441,198962,0.8943005856270494
2022-05-29,GB,United Kingdom of Great Britain and Northern Ireland,42463,22290240,346,199308,0.8941491881648649
2022-06-05,GB,United Kingdom of Great Britain and Northern Ireland,44731,22334971,266,199574,0.8935494028624438
2022-06-12,GB,United Kingdom of Great Britain and Northern Ireland,74352,22409323,258,199832,0.8917359975578021
2022-06-19,GB,United Kingdom of Great Britain and Northern Ireland,96164,22505487,299,200131,0.8892542516409443
2022-06-26,GB,United Kingdom of Great Britain and Northern Ireland,130271,22635758,380,200511,0.8858152662702968
2022-07-03,GB,United Kingdom of Great Britain and Northern Ireland,160214,22795972,513,201024,0.8818400022600484
2022-07-10,GB,United Kingdom of Great Britain and Northern Ireland,195623,22991595,679,201703,0.8772901575554023
2022-07-17,GB,United Kingdom of Great Britain and Northern Ireland,166429,23158024,873,202576,0.8747551172759818
2022-07-24,GB,United Kingdom of Great Britain and Northern Ireland,110346,23268370,1067,203643,0.8751923748848759
2022-07-31,GB,United Kingdom of Great Britain and Northern Ireland,74614,23342984,852,204495,0.8760448107234275
2022-08-07,GB,United Kingdom of Great Britain and Northern Ireland,56953,23399937,649,205144,0.8766861209925481
2022-08-14,GB,United Kingdom of Great Britain and Northern Ireland,45624,23445561,636,205780,0.8776927965170038
2022-08-21,GB,United Kingdom of Great Britain and Northern Ireland,35449,23481010,530,206310,0.8786248973106352
2022-08-28,GB,United Kingdom of Great Britain and Northern Ireland,29390,23510400,425,206735,0.8793342520756772
2022-09-04,GB,United Kingdom of Great Britain and Northern Ireland,29213,23539613,383,207118,0.879870030148754
2022-09-11,GB,United Kingdom of Great Britain and Northern Ireland,28943,23568556,324,207442,0.8801642323780887
2022-09-18,GB,United Kingdom of Great Britain and Northern Ireland,31812,23600368,305,207747,0.8802701720583341
2022-09-25,GB,United Kingdom of Great Britain and Northern Ireland,42707,23643075,320,208067,0.8800335827721224
2022-10-02,GB,United Kingdom of Great Britain and Northern Ireland,53755,23696830,417,208484,0.8797970023838632
2022-10-09,GB,United Kingdom of Great Britain and Northern Ireland,67496,23764326,617,209101,0.8798945107889868
2022-10-16,GB,United Kingdom of Great Britain and Northern Ireland,60442,23824768,751,209852,0.8808144532614127
2022-10-23,GB,United Kingdom of Great Britain and Northern Ireland,52930,23877698,778,210630,0.882120211085675
2022-10-30,GB,United Kingdom of Great Britain and Northern Ireland,37668,23915366,725,211355,0.883762347605301
2022-11-06,GB,United Kingdom of Great Britain and Northern Ireland,28331,23943697,625,211980,0.8853269401128824
2022-11-13,GB,United Kingdom of Great Britain and Northern Ireland,23756,23967453,471,212451,0.8864145889844867
2022-11-20,GB,United Kingdom of Great Britain and Northern Ireland,21872,23989325,398,212849,0.8872654816256814
2022-11-27,GB,United Kingdom of Great Britain and Northern Ireland,22911,24012236,387,213236,0.8880305857397037
2022-12-04,GB,United Kingdom of Great Britain and Northern Ireland,26105,24038341,374,213610,0.8886220559064372
2022-12-11,GB,United Kingdom of Great Britain and Northern Ireland,31048,24069389,450,214060,0.8893453838815768
2022-12-18,GB,United Kingdom of Great Britain and Northern Ireland,41009,24110398,522,214582,0.8899977511777284
2022-12-25,GB,United Kingdom of Great Britain and Northern Ireland,48639,24159037,763,215345,0.8913641715106443
2023-01-01,GB,United Kingdom of Great Britain and Northern Ireland,41644,24200681,971,216316,0.8938426154206156
2023-01-08,GB,United Kingdom of Great Britain and Northern Ireland,33390,24234071,951,217267,0.8965352952873663
2023-01-15,GB,United Kingdom of Great Britain and Northern Ireland,19533,24253604,817,218084,0.8991818288119159
2023-01-22,GB,United Kingdom of Great Britain and Northern Ireland,14136,24267740,679,218763,0.9014560070282606
2023-01-29,GB,United Kingdom of Great Britain and Northern Ireland,16501,24284241,529,219292,0.9030218403778812
2023-02-05,GB,United Kingdom of Great Britain and Northern Ireland,21190,24305431,493,219785,0.9042629196742078
2023-02-12,GB,United Kingdom of Great Britain and Northern Ireland,23225,24328656,475,220260,0.9053521082298998
2023-02-19,GB,United Kingdom of Great Britain and Northern Ireland,27956,24356612,495,220755,0.9063452667390686
2023-02-26,GB,United Kingdom of Great Britain and Northern Ireland,27843,24384455,519,221274,0.9074387760563031
2023-03-05,GB,United Kingdom of Great Britain and Northern Ireland,27238,24411693,582,221856,0.9088103803369966
2023-03-12,GB,United Kingdom of Great Britain and Northern Ireland,29418,24441111,665,222521,0.9104373365024201
2023-03-19,GB,United Kingdom of Great Britain and Northern Ireland,33341,24474452,713,223234,0.9121103099673079
2023-03-26,GB,United Kingdom of Great Britain and Northern Ireland,31649,24506101,739,223973,0.9139479185203717
2023-04-02,GB,United Kingdom of Great Britain and Northern Ireland,25172,24531273,691,224664,0.9158269120399907
2023-04-09,GB,United Kingdom of Great Britain and Northern Ireland,16894,24548167,605,225269,0.9176611842342445
2023-04-16,GB,United Kingdom of Great Britain and Northern Ireland,14917,24563084,550,225819,0.919343027121513
2023-04-23,GB,United Kingdom of Great Britain and Northern Ireland,12823,24575907,520,226339,0.920979233848826
2023-04-30,GB,United Kingdom of Great Britain and Northern Ireland,11492,24587399,406,226745,0.9222000261190701
2023-05-07,GB,United Kingdom of Great Britain and Northern Ireland,11103,24598502,354,227099,0.923222885686291
2023-05-14,GB,United Kingdom of Great Britain and Northern Ireland,8978,24607480,320,227419,0.9241864668791766
2023-05-21,GB,United Kingdom of Great Britain and Northern Ireland,7493,24614973,277,227696,0.9250304682438611
2023-05-28,GB,United Kingdom of Great Britain and Northern Ireland,6759,24621732,236,227932,0.9257350376488542
2023-06-04,GB,United Kingdom of Great Britain and Northern Ireland,5261,24626993,199,228131,0.9263453317260455
2023-06-11,GB,United Kingdom of Great Britain and Northern Ireland,4895,24631888,171,228302,0.9268554647536559
2023-06-18,GB,United Kingdom of Great Britain and Northern Ireland,3620,24635508,187,228489,0.9274783373657243
2023-06-25,GB,United Kingdom of Great Britain and Northern Ireland,2804,24638312,115,228604,0.9278395370591946
2023-07-02,GB,United Kingdom of Great Britain and Northern Ireland,2194,24640506,103,228707,0.9281749327712671
2023-07-09,GB,United Kingdom of Great Britain and Northern Ireland,2455,24642961,75,228782,0.9283868119581895
2023-07-16,GB,United Kingdom of Great Britain and Northern Ireland,3114,24646075,65,228847,0.9285332451516113
2023-07-23,GB,United Kingdom of Great Britain and Northern Ireland,3618,24649693,65,228912,0.9286606530961663
2023-07-30,GB,United Kingdom of Great Britain and Northern Ireland,4677,24654370,84,228996,0.9288251940730994
2023-08-06,GB,United Kingdom of Great Britain and Northern Ireland,6313,24660683,103,229099,0.9290050887884979
2023-08-13,GB,United Kingdom of Great Britain and Northern Ireland,7777,24668460,141,229240,0.9292837899082471
2023-08-20,GB,United Kingdom of Great Britain and Northern Ireland,8546,24677006,206,229446,0.9297967508700204
2023-08-27,GB,United Kingdom of Great Britain and Northern Ireland,8988,24685994,228,229674,0.9303818189374915
2023-09-03,GB,United Kingdom of Great Britain and Northern Ireland,10471,24696465,197,229871,0.9307850334045784
2023-09-10,GB,United Kingdom of Great Britain and Northern Ireland,13933,24710398,287,230158,0.9314216630586039
2023-09-17,GB,United Kingdom of Great Britain and Northern Ireland,12273,24722671,303,230461,0.932184875978813
2023-09-24,GB,United Kingdom of Great Britain and Northern Ireland,13562,24736233,266,230727,0.9327491376718516
2023-10-01,GB,United Kingdom of Great Britain and Northern Ireland,17422,24753655,289,231016,0.9332601589543039
2023-10-08,GB,United Kingdom of Great Britain and Northern Ireland,17083,24770738,344,231360,0.9340052767099631
2023-10-15,GB,United Kingdom of Great Britain and Northern Ireland,13260,24783998,364,231724,0.9349742523381418
2023-10-22,GB,United Kingdom of Great Britain and Northern Ireland,9271,24793269,388,232112,0.9361895762918557
2023-10-29,GB,United Kingdom of Great Britain and Northern Ireland,7325,24800594,0,232112,0.93591306724347
2023-11-05,GB,United Kingdom of Great Britain and Northern Ireland,6599,24807193,0,232112,0.9356641035525461
2023-11-12,GB,United Kingdom of Great Britain and Northern Ireland,4882,24812075,0,232112,0.9354800031839337
2023-11-19,GB,United Kingdom of Great Britain and Northern Ireland,5217,24817292,0,232112,0.9352833500125638
2023-11-26,GB,United Kingdom of Great Britain and Northern Ireland,4718,24822010,0,232112,0.935105577670785
2023-12-03,GB,United Kingdom of Great Britain and Northern Ireland,5357,24827367,0,232112,0.9349038099771112
2023-12-10,GB,United Kingdom of Great Britain and Northern Ireland,7499,24834866,0,232112,0.9346215115475155
2023-12-17,GB,United Kingdom of Great Britain and Northern Ireland,9417,24844283,0,232112,0.9342672517456028
2023-12-24,GB,United Kingdom of Great Britain and Northern Ireland,10567,24854850,0,232112,0.9338700495074401
2023-12-31,GB,United Kingdom of Great Britain and Northern Ireland,9776,24864626,0,232112,0.9335028807591959
2024-01-07,GB,United Kingdom of Great Britain and Northern Ireland,8027,24872653,0,232112,0.9332016170530743
2024-01-14,GB,United Kingdom of Great Britain and Northern Ireland,0,24872653,0,232112,0.9332016170530743
2021-04-11,TL,Timor-Leste,332,1046,1,1,0.09560229445506692
2021-04-18,TL,Timor-Leste,260,1306,1,2,0.1531393568147014
2021-04-25,TL,Timor-Leste,591,1897,1,3,0.158144438587243
2021-05-02,TL,Timor-Leste,547,2444,1,4,0.16366612111292964
2021-05-09,TL,Timor-Leste,783,3227,1,5,0.15494267121165167
2021-05-16,TL,Timor-Leste,1231,4458,5,10,0.22431583669807087
2021-05-23,TL,Timor-Leste,1179,5637,3,13,0.23061912364733014
2021-05-30,TL,Timor-Leste,1260,6897,3,16,0.23198492098013632
2021-06-06,TL,Timor-Leste,843,7740,1,17,0.21963824289405687
2021-06-13,TL,Timor-Leste,545,8285,1,18,0.21726010863005432
2021-06-20,TL,Timor-Leste,422,8707,1,19,0.21821522912599056
2021-06-27,TL,Timor-Leste,328,9035,2,21,0.2324294410625346
2021-07-04,TL,Timor-Leste,441,9476,3,24,0.2532714225411566
2021-07-11,TL,Timor-Leste,347,9823,1,25,0.25450473378804844
2021-07-18,TL,Timor-Leste,305,10128,1,26,0.2567140600315956
2021-07-25,TL,Timor-Leste,220,10348,0,26,0.25125628140703515
2021-08-01,TL,Timor-Leste,618,10966,0,26,0.23709648002918113
2021-08-08,TL,Timor-Leste,563,11529,1,27,0.234192037470726
2021-08-15,TL,Timor-Leste,1036,12565,3,30,0.23875845602865103
2021-08-22,TL,Timor-Leste,1651,14216,18,48,0.3376477208778841
2021-08-29,TL,Timor-Leste,2186,16402,14,62,0.37800268259968295
2021-09-05,TL,Timor-Leste,1216,17618,18,80,0.45408105346804406
2021-09-12,TL,Timor-Leste,897,18515,15,95,0.5130974885228193
2021-09-19,TL,Timor-Leste,518,19033,9,104,0.546419376871749
2021-09-26,TL,Timor-Leste,349,19382,9,113,0.583015168713239
2021-10-03,TL,Timor-Leste,200,19582,5,118,0.6025942191808804
2021-10-10,TL,Timor-Leste,91,19673,1,119,0.6048899506938443
2021-10-17,TL,Timor-Leste,41,19714,0,119,0.6036319366947347
2021-10-24,TL,Timor-Leste,56,19770,2,121,0.6120384420839656
2021-10-31,TL,Timor-Leste,20,19790,1,122,0.6164729661445174
2021-11-07,TL,Timor-Leste,9,19799,0,122,0.6161927370069196
2021-11-14,TL,Timor-Leste,10,19809,0,122,0.6158816699480034
2021-11-21,TL,Timor-Leste,10,19819,0,122,0.6155709167970129
2021-11-28,TL,Timor-Leste,3,19822,0,122,0.6154777519927354
2021-12-05,TL,Timor-Leste,6,19828,0,122,0.6152915069598548
2021-12-12,TL,Timor-Leste,1,19829,0,122,0.6152604770790258
2021-12-19,TL,Timor-Leste,4,19833,0,122,0.6151363888468714
2021-12-26,TL,Timor-Leste,0,19833,0,122,0.6151363888468714
2022-01-02,TL,Timor-Leste,6,19839,0,122,0.6149503503200766
2022-01-09,TL,Timor-Leste,17,19856,0,122,0.6144238517324738
2022-01-16,TL,Timor-Leste,7,19863,0,122,0.6142073201429794
2022-01-23,TL,Timor-Leste,5,19868,0,122,0.6140527481377089
2022-01-30,TL,Timor-Leste,69,19937,0,122,0.6119275718513317
2022-02-06,TL,Timor-Leste,466,20403,0,122,0.5979512816742636
2022-02-13,TL,Timor-Leste,1228,21631,2,124,0.573251352225972
2022-02-20,TL,Timor-Leste,727,22358,1,125,0.5590839967796761
2022-02-27,TL,Timor-Leste,310,22668,3,128,0.5646726663137462
2022-03-06,TL,Timor-Leste,91,22759,1,129,0.5668087350059317
2022-03-13,TL,Timor-Leste,32,22791,0,129,0.5660128998288798
2022-03-20,TL,Timor-Leste,14,22805,1,130,0.5700504275378206
2022-03-27,TL,Timor-Leste,16,22821,0,130,0.5696507602646685
2022-04-03,TL,Timor-Leste,11,22832,0,130,0.5693763139453398
2022-04-10,TL,Timor-Leste,10,22842,0,130,0.5691270466684178
2022-04-17,TL,Timor-Leste,11,22853,0,130,0.5688531046252133
2022-04-24,TL,Timor-Leste,7,22860,0,130,0.5686789151356081
2022-05-01,TL,Timor-Leste,11,22871,0,130,0.5684054042236893
2022-05-08,TL,Timor-Leste,14,22885,0,130,0.5680576797028621
2022-05-15,TL,Timor-Leste,4,22889,1,131,0.5723273187994233
2022-05-22,TL,Timor-Leste,6,22895,0,131,0.5721773312950426
2022-05-29,TL,Timor-Leste,17,22912,0,131,0.5717527932960893
2022-06-05,TL,Timor-Leste,13,22925,0,131,0.5714285714285714
2022-06-12,TL,Timor-Leste,8,22933,2,133,0.579950289975145
2022-06-19,TL,Timor-Leste,11,22944,0,133,0.5796722454672246
2022-06-26,TL,Timor-Leste,7,22951,0,133,0.5794954468214892
2022-07-03,TL,Timor-Leste,8,22959,0,133,0.5792935232370747
2022-07-10,TL,Timor-Leste,12,22971,0,133,0.5789909015715468
2022-07-17,TL,Timor-Leste,7,22978,0,133,0.5788145182348333
2022-07-24,TL,Timor-Leste,8,22986,0,133,0.5786130688245019
2022-07-31,TL,Timor-Leste,18,23004,0,133,0.5781603199443575
2022-08-07,TL,Timor-Leste,35,23039,1,134,0.5816224662528756
2022-08-14,TL,Timor-Leste,44,23083,1,135,0.5848459905558203
2022-08-21,TL,Timor-Leste,33,23116,0,135,0.5840110745803772
2022-08-28,TL,Timor-Leste,44,23160,2,137,0.5915371329879102
2022-09-04,TL,Timor-Leste,25,23185,1,138,0.5952124218244554
2022-09-11,TL,Timor-Leste,33,23218,0,138,0.5943664398311654
2022-09-18,TL,Timor-Leste,21,23239,0,138,0.5938293386118163
2022-09-25,TL,Timor-Leste,14,23253,0,138,0.5934718100890208
2022-10-02,TL,Timor-Leste,4,23257,0,138,0.5933697381433547
2022-10-09,TL,Timor-Leste,14,23271,0,138,0.5930127626659791
2022-10-16,TL,Timor-Leste,16,23287,0,138,0.5926053162708808
2022-10-23,TL,Timor-Leste,12,23299,0,138,0.5923000987166831
2022-10-30,TL,Timor-Leste,2,23301,0,138,0.5922492596884253
2022-11-06,TL,Timor-Leste,4,23305,0,138,0.592147607809483
2022-11-13,TL,Timor-Leste,9,23314,0,138,0.5919190186154242
2022-11-20,TL,Timor-Leste,13,23327,0,138,0.5915891456252411
2022-11-27,TL,Timor-Leste,11,23338,0,138,0.591310309366698
2022-12-04,TL,Timor-Leste,17,23355,0,138,0.5908798972382788
2022-12-11,TL,Timor-Leste,14,23369,0,138,0.5905259103941118
2022-12-18,TL,Timor-Leste,16,23385,0,138,0.59012187299551
2022-12-25,TL,Timor-Leste,3,23388,0,138,0.5900461775269369
2023-01-01,TL,Timor-Leste,9,23397,0,138,0.5898192075907168
2023-01-08,TL,Timor-Leste,6,23403,0,138,0.5896679912831688
2023-01-15,TL,Timor-Leste,2,23405,0,138,0.5896176030762658
2023-01-22,TL,Timor-Leste,5,23410,0,138,0.589491670226399
2023-01-29,TL,Timor-Leste,4,23414,0,138,0.5893909626719057
2023-02-05,TL,Timor-Leste,2,23416,0,138,0.5893406217970618
2023-02-12,TL,Timor-Leste,1,23417,0,138,0.5893154545842764
2023-02-19,TL,Timor-Leste,1,23418,0,138,0.5892902895208814
2023-02-26,TL,Timor-Leste,0,23418,0,138,0.5892902895208814
2023-03-05,TL,Timor-Leste,1,23419,0,138,0.5892651266066016
2023-03-12,TL,Timor-Leste,0,23419,0,138,0.5892651266066016
2023-03-19,TL,Timor-Leste,2,23421,0,138,0.5892148072242859
2023-03-26,TL,Timor-Leste,2,23423,0,138,0.5891644964351279
2023-04-02,TL,Timor-Leste,0,23423,0,138,0.5891644964351279
2023-04-09,TL,Timor-Leste,0,23423,0,138,0.5891644964351279
2023-04-16,TL,Timor-Leste,2,23425,0,138,0.5891141942369263
2023-04-23,TL,Timor-Leste,2,23427,0,138,0.5890639006274812
2023-04-30,TL,Timor-Leste,1,23428,0,138,0.5890387570428547
2023-05-07,TL,Timor-Leste,3,23431,0,138,0.588963339166062
2023-05-14,TL,Timor-Leste,11,23442,0,138,0.5886869721013566
2023-05-21,TL,Timor-Leste,1,23443,0,138,0.5886618606833596
2023-05-28,TL,Timor-Leste,5,23448,0,138,0.5885363357215967
2023-06-04,TL,Timor-Leste,2,23450,0,138,0.5884861407249466
2023-06-11,TL,Timor-Leste,6,23456,0,138,0.5883356070941337
2023-06-18,TL,Timor-Leste,0,23456,0,138,0.5883356070941337
2023-06-25,TL,Timor-Leste,1,23457,0,138,0.5883105256426653
2023-07-02,TL,Timor-Leste,0,23457,0,138,0.5883105256426653
2023-07-09,TL,Timor-Leste,1,23458,0,138,0.5882854463296103
2023-07-16,TL,Timor-Leste,2,23460,0,138,0.5882352941176471
2023-07-23,TL,Timor-Leste,0,23460,0,138,0.5882352941176471
2023-07-30,TL,Timor-Leste,0,23460,0,138,0.5882352941176471
2023-08-06,TL,Timor-Leste,0,23460,0,138,0.5882352941176471
2023-08-13,TL,Timor-Leste,0,23460,0,138,0.5882352941176471
2023-08-20,TL,Timor-Leste,0,23460,0,138,0.5882352941176471
2023-08-27,TL,Timor-Leste,0,23460,0,138,0.5882352941176471
2023-09-03,TL,Timor-Leste,0,23460,0,138,0.5882352941176471
2023-09-10,TL,Timor-Leste,0,23460,0,138,0.5882352941176471
2023-09-17,TL,Timor-Leste,0,23460,0,138,0.5882352941176471
2023-09-24,TL,Timor-Leste,0,23460,0,138,0.5882352941176471
2023-10-01,TL,Timor-Leste,0,23460,0,138,0.5882352941176471
2023-10-08,TL,Timor-Leste,0,23460,0,138,0.5882352941176471
2023-10-15,TL,Timor-Leste,0,23460,0,138,0.5882352941176471
2023-10-22,TL,Timor-Leste,0,23460,0,138,0.5882352941176471
2023-10-29,TL,Timor-Leste,0,23460,0,138,0.5882352941176471
2023-11-05,TL,Timor-Leste,0,23460,0,138,0.5882352941176471
2023-11-12,TL,Timor-Leste,0,23460,0,138,0.5882352941176471
2023-11-19,TL,Timor-Leste,0,23460,0,138,0.5882352941176471
2023-11-26,TL,Timor-Leste,0,23460,0,138,0.5882352941176471
2023-12-03,TL,Timor-Leste,0,23460,0,138,0.5882352941176471
2023-12-10,TL,Timor-Leste,0,23460,0,138,0.5882352941176471
2023-12-17,TL,Timor-Leste,0,23460,0,138,0.5882352941176471
2023-12-24,TL,Timor-Leste,0,23460,0,138,0.5882352941176471
2023-12-31,TL,Timor-Leste,0,23460,0,138,0.5882352941176471
2024-01-07,TL,Timor-Leste,0,23460,0,138,0.5882352941176471
2024-01-14,TL,Timor-Leste,0,23460,0,138,0.5882352941176471
2021-04-11,TG,Togo,883,11947,6,116,0.9709550514773584
2021-04-18,TG,Togo,549,12496,3,119,0.9523047375160051
2021-04-25,TG,Togo,291,12787,2,121,0.9462735590834442
2021-05-02,TG,Togo,205,12992,2,123,0.9467364532019705
2021-05-09,TG,Togo,149,13141,1,124,0.9436115972909215
2021-05-16,TG,Togo,103,13244,1,125,0.9438236182422229
2021-05-23,TG,Togo,119,13363,0,125,0.935418693407169
2021-05-30,TG,Togo,84,13447,0,125,0.9295753699709972
2021-06-06,TG,Togo,86,13533,0,125,0.9236680706421341
2021-06-13,TG,Togo,87,13620,1,126,0.9251101321585903
2021-06-20,TG,Togo,95,13715,1,127,0.9259934378417791
2021-06-27,TG,Togo,101,13816,1,128,0.9264620729588882
2021-07-04,TG,Togo,223,14039,2,130,0.925991879763516
2021-07-11,TG,Togo,193,14232,3,133,0.9345137717818999
2021-07-18,TG,Togo,370,14602,4,137,0.9382276400493084
2021-07-25,TG,Togo,470,15072,6,143,0.9487791932059447
2021-08-01,TG,Togo,726,15798,9,152,0.9621471072287632
2021-08-08,TG,Togo,930,16728,5,157,0.9385461501673841
2021-08-15,TG,Togo,1118,17846,8,165,0.924576936008069
2021-08-22,TG,Togo,1645,19491,7,172,0.8824585706223385
2021-08-29,TG,Togo,1546,21037,8,180,0.8556353092170936
2021-09-05,TG,Togo,1407,22444,14,194,0.8643735519515238
2021-09-12,TG,Togo,1174,23618,11,205,0.8679820475908204
2021-09-19,TG,Togo,901,24519,8,213,0.8687140584852563
2021-09-26,TG,Togo,644,25163,9,222,0.8822477447045264
2021-10-03,TG,Togo,372,25535,11,233,0.9124730761699628
2021-10-10,TG,Togo,225,25760,2,235,0.9122670807453416
2021-10-17,TG,Togo,126,25886,3,238,0.9194159004867496
2021-10-24,TG,Togo,103,25989,4,242,0.9311631844241796
2021-10-31,TG,Togo,79,26068,0,242,0.9283412613165567
2021-11-07,TG,Togo,46,26114,1,243,0.9305353450256567
2021-11-14,TG,Togo,38,26152,0,243,0.9291832364637505
2021-11-21,TG,Togo,53,26205,0,243,0.9273039496279336
2021-11-28,TG,Togo,38,26243,0,243,0.9259612087032733
2021-12-05,TG,Togo,48,26291,0,243,0.9242706629645125
2021-12-12,TG,Togo,98,26389,0,243,0.920838228049566
2021-12-19,TG,Togo,213,26602,1,244,0.9172242688519661
2021-12-26,TG,Togo,1390,27992,2,246,0.8788225207202058
2022-01-02,TG,Togo,3173,31165,2,248,0.7957644793839243
2022-01-09,TG,Togo,2750,33915,5,253,0.7459826035677429
2022-01-16,TG,Togo,1936,35851,8,261,0.7280131656020753
2022-01-23,TG,Togo,429,36280,5,266,0.7331863285556781
2022-01-30,TG,Togo,207,36487,2,268,0.7345081809959711
2022-02-06,TG,Togo,70,36557,0,268,0.7331017315425227
2022-02-13,TG,Togo,77,36634,2,270,0.737020254408473
2022-02-20,TG,Togo,90,36724,1,271,0.7379370438950006
2022-02-27,TG,Togo,74,36798,1,272,0.7391706070982118
2022-03-06,TG,Togo,23,36821,0,272,0.7387088889492409
2022-03-13,TG,Togo,29,36850,0,272,0.7381275440976933
2022-03-20,TG,Togo,28,36878,0,272,0.7375671131840121
2022-03-27,TG,Togo,33,36911,0,272,0.7369076968925253
2022-04-03,TG,Togo,32,36943,0,272,0.7362693879760712
2022-04-10,TG,Togo,14,36957,0,272,0.7359904754173769
2022-04-17,TG,Togo,6,36963,1,273,0.7385764142520899
2022-04-24,TG,Togo,14,36977,0,273,0.7382967790788869
2022-05-01,TG,Togo,12,36989,0,273,0.7380572602665657
2022-05-08,TG,Togo,11,37000,0,273,0.7378378378378379
2022-05-15,TG,Togo,23,37023,0,273,0.737379466817924
2022-05-22,TG,Togo,21,37044,0,273,0.7369614512471655
2022-05-29,TG,Togo,35,37079,0,273,0.7362658108363225
2022-06-05,TG,Togo,47,37126,0,273,0.7353337283844207
2022-06-12,TG,Togo,63,37189,0,273,0.7340880367850708
2022-06-19,TG,Togo,58,37247,0,273,0.7329449351625634
2022-06-26,TG,Togo,81,37328,2,275,0.7367123874839262
2022-07-03,TG,Togo,140,37468,0,275,0.7339596455642148
2022-07-10,TG,Togo,140,37608,0,275,0.7312273984258668
2022-07-17,TG,Togo,190,37798,0,275,0.7275517223133499
2022-07-24,TG,Togo,158,37956,1,276,0.7271577616187164
2022-07-31,TG,Togo,128,38084,4,280,0.7352168889822498
2022-08-07,TG,Togo,108,38192,1,281,0.7357561793045664
2022-08-14,TG,Togo,93,38285,0,281,0.7339689173305473
2022-08-21,TG,Togo,70,38355,1,282,0.7352366053969496
2022-08-28,TG,Togo,82,38437,0,282,0.73366808023519
2022-09-04,TG,Togo,102,38539,1,283,0.7343210773502167
2022-09-11,TG,Togo,100,38639,1,284,0.7350086699966355
2022-09-18,TG,Togo,128,38767,0,284,0.7325818350659066
2022-09-25,TG,Togo,196,38963,0,284,0.728896645535508
2022-10-02,TG,Togo,123,39086,1,285,0.7291613365399375
2022-10-09,TG,Togo,103,39189,1,286,0.7297966266044043
2022-10-16,TG,Togo,63,39252,1,287,0.7311729338632427
2022-10-23,TG,Togo,32,39284,2,289,0.7356684655330414
2022-10-30,TG,Togo,14,39298,1,290,0.7379510407654334
2022-11-06,TG,Togo,13,39311,0,290,0.7377070031288951
2022-11-13,TG,Togo,8,39319,0,290,0.7375569063302728
2022-11-20,TG,Togo,4,39323,0,290,0.7374818808331002
2022-11-27,TG,Togo,3,39326,0,290,0.7374256217260846
2022-12-04,TG,Togo,6,39332,0,290,0.7373131292586189
2022-12-11,TG,Togo,5,39337,0,290,0.7372194117497521
2022-12-18,TG,Togo,2,39339,0,290,0.7371819314166603
2022-12-25,TG,Togo,2,39341,0,290,0.737144454894385
2023-01-01,TG,Togo,3,39344,0,290,0.7370882472549817
2023-01-08,TG,Togo,5,39349,0,290,0.7369945869018273
2023-01-15,TG,Togo,2,39351,0,290,0.7369571294249193
2023-01-22,TG,Togo,2,39353,0,290,0.7369196757553427
2023-01-29,TG,Togo,1,39354,0,290,0.7369009503481222
2023-02-05,TG,Togo,2,39356,0,290,0.7368635023884541
2023-02-12,TG,Togo,6,39362,0,290,0.7367511813424115
2023-02-19,TG,Togo,5,39367,0,290,0.736657606624838
2023-02-26,TG,Togo,8,39375,0,290,0.7365079365079366
2023-03-05,TG,Togo,17,39392,0,290,0.7361900893582453
2023-03-12,TG,Togo,15,39407,0,290,0.7359098637297943
2023-03-19,TG,Togo,14,39421,0,290,0.7356485122143019
2023-03-26,TG,Togo,20,39441,0,290,0.7352754747597677
2023-04-02,TG,Togo,17,39458,0,290,0.7349586902529271
2023-04-09,TG,Togo,10,39468,0,290,0.7347724739029087
2023-04-16,TG,Togo,3,39471,0,290,0.7347166273973297
2023-04-23,TG,Togo,5,39476,0,290,0.7346235687506333
2023-04-30,TG,Togo,10,39486,0,290,0.7344375221597528
2023-05-07,TG,Togo,4,39490,0,290,0.7343631299063054
2023-05-14,TG,Togo,1,39491,0,290,0.7343445341976653
2023-05-21,TG,Togo,5,39496,0,290,0.7342515697792181
2023-05-28,TG,Togo,3,39499,0,290,0.7341958024253779
2023-06-04,TG,Togo,0,39499,0,290,0.7341958024253779
2023-06-11,TG,Togo,1,39500,0,290,0.7341772151898734
2023-06-18,TG,Togo,3,39503,0,290,0.7341214591296863
2023-06-25,TG,Togo,1,39504,0,290,0.7341028756581612
2023-07-02,TG,Togo,2,39506,0,290,0.7340657115374879
2023-07-09,TG,Togo,0,39506,0,290,0.7340657115374879
2023-07-16,TG,Togo,1,39507,0,290,0.7340471308881971
2023-07-23,TG,Togo,3,39510,0,290,0.7339913945836497
2023-07-30,TG,Togo,0,39510,0,290,0.7339913945836497
2023-08-06,TG,Togo,1,39511,0,290,0.7339728176963377
2023-08-13,TG,Togo,2,39513,0,290,0.733935666742591
2023-08-20,TG,Togo,0,39513,0,290,0.733935666742591
2023-08-27,TG,Togo,1,39514,0,290,0.7339170926760136
2023-09-03,TG,Togo,0,39514,0,290,0.7339170926760136
2023-09-10,TG,Togo,0,39514,0,290,0.7339170926760136
2023-09-17,TG,Togo,2,39516,0,290,0.7338799473630934
2023-09-24,TG,Togo,2,39518,0,290,0.7338428058100106
2023-10-01,TG,Togo,4,39522,0,290,0.7337685339810739
2023-10-08,TG,Togo,2,39524,0,290,0.7337314037040785
2023-10-15,TG,Togo,1,39525,0,290,0.7337128399746996
2023-10-22,TG,Togo,2,39527,0,290,0.7336757153338225
2023-10-29,TG,Togo,0,39527,0,290,0.7336757153338225
2023-11-05,TG,Togo,0,39527,0,290,0.7336757153338225
2023-11-12,TG,Togo,0,39527,0,290,0.7336757153338225
2023-11-19,TG,Togo,0,39527,0,290,0.7336757153338225
2023-11-26,TG,Togo,0,39527,0,290,0.7336757153338225
2023-12-03,TG,Togo,0,39527,0,290,0.7336757153338225
2023-12-10,TG,Togo,0,39527,0,290,0.7336757153338225
2023-12-17,TG,Togo,0,39527,0,290,0.7336757153338225
2023-12-24,TG,Togo,0,39527,0,290,0.7336757153338225
2023-12-31,TG,Togo,1,39528,0,290,0.7336571544221818
2024-01-07,TG,Togo,0,39528,0,290,0.7336571544221818
2024-01-14,TG,Togo,0,39528,0,290,0.7336571544221818
2022-03-13,TO,Tonga,861,1863,2,2,0.10735373054213634
2022-03-20,TO,Tonga,1555,3418,0,2,0.058513750731421885
2022-03-27,TO,Tonga,2173,5591,0,2,0.03577177606868181
2022-04-03,TO,Tonga,1536,7127,7,9,0.1262803423600393
2022-04-10,TO,Tonga,804,7931,0,9,0.1134787542554533
2022-04-17,TO,Tonga,1094,9025,2,11,0.1218836565096953
2022-04-24,TO,Tonga,528,9553,0,11,0.1151470742175233
2022-05-01,TO,Tonga,643,10196,0,11,0.10788544527265594
2022-05-08,TO,Tonga,569,10765,0,11,0.10218300046446818
2022-05-15,TO,Tonga,352,11117,0,11,0.09894755779436899
2022-05-22,TO,Tonga,371,11488,0,11,0.09575208913649025
2022-05-29,TO,Tonga,156,11644,1,12,0.10305736860185502
2022-06-05,TO,Tonga,125,11769,0,12,0.10196278358399186
2022-06-12,TO,Tonga,140,11909,0,12,0.10076412797044253
2022-06-19,TO,Tonga,170,12079,0,12,0.09934597234870436
2022-06-26,TO,Tonga,222,12301,0,12,0.09755304446792944
2022-07-03,TO,Tonga,0,12301,0,12,0.09755304446792944
2022-07-10,TO,Tonga,81,12382,0,12,0.09691487643353255
2022-07-17,TO,Tonga,57,12439,0,12,0.09647077739368116
2022-07-24,TO,Tonga,76,12515,0,12,0.09588493807431082
2022-07-31,TO,Tonga,39,12554,0,12,0.09558706388402102
2022-08-07,TO,Tonga,0,12554,0,12,0.09558706388402102
2022-08-14,TO,Tonga,851,13405,0,12,0.08951883625512869
2022-08-21,TO,Tonga,730,14135,0,12,0.08489564909798374
2022-08-28,TO,Tonga,1100,15235,0,12,0.07876599934361667
2022-09-04,TO,Tonga,947,16182,0,12,0.07415647015202076
2022-09-11,TO,Tonga,0,16182,0,12,0.07415647015202076
2022-09-18,TO,Tonga,0,16182,0,12,0.07415647015202076
2022-09-25,TO,Tonga,0,16182,0,12,0.07415647015202076
2022-10-02,TO,Tonga,0,16182,0,12,0.07415647015202076
2022-10-09,TO,Tonga,0,16182,0,12,0.07415647015202076
2022-10-16,TO,Tonga,0,16182,0,12,0.07415647015202076
2022-10-23,TO,Tonga,0,16182,0,12,0.07415647015202076
2022-10-30,TO,Tonga,0,16182,0,12,0.07415647015202076
2022-11-06,TO,Tonga,0,16182,0,12,0.07415647015202076
2022-11-13,TO,Tonga,0,16182,0,12,0.07415647015202076
2022-11-20,TO,Tonga,0,16182,0,12,0.07415647015202076
2022-11-27,TO,Tonga,29,16211,0,12,0.07402381099253594
2022-12-04,TO,Tonga,0,16211,0,12,0.07402381099253594
2022-12-11,TO,Tonga,0,16211,0,12,0.07402381099253594
2022-12-18,TO,Tonga,0,16211,0,12,0.07402381099253594
2022-12-25,TO,Tonga,201,16412,0,12,0.073117231294175
2023-01-01,TO,Tonga,75,16487,0,12,0.07278461818402378
2023-01-08,TO,Tonga,103,16590,0,12,0.07233273056057866
2023-01-15,TO,Tonga,0,16590,0,12,0.07233273056057866
2023-01-22,TO,Tonga,82,16672,0,12,0.07197696737044146
2023-01-29,TO,Tonga,62,16734,0,12,0.07171029042667623
2023-02-05,TO,Tonga,45,16779,0,12,0.07151796888968354
2023-02-12,TO,Tonga,16,16795,0,12,0.0714498362607919
2023-02-19,TO,Tonga,6,16801,0,12,0.07142431998095351
2023-02-26,TO,Tonga,6,16807,0,12,0.07139882191943833
2023-03-05,TO,Tonga,3,16810,0,12,0.07138607971445568
2023-03-12,TO,Tonga,2,16812,0,12,0.07137758743754462
2023-03-19,TO,Tonga,1,16813,0,12,0.07137334205674181
2023-03-26,TO,Tonga,1,16814,0,12,0.07136909718092066
2023-04-02,TO,Tonga,0,16814,0,12,0.07136909718092066
2023-04-09,TO,Tonga,0,16814,0,12,0.07136909718092066
2023-04-16,TO,Tonga,0,16814,0,12,0.07136909718092066
2023-04-23,TO,Tonga,0,16814,0,12,0.07136909718092066
2023-04-30,TO,Tonga,0,16814,0,12,0.07136909718092066
2023-05-07,TO,Tonga,2,16816,0,12,0.071360608943863
2023-05-14,TO,Tonga,1,16817,0,12,0.07135636558244633
2023-05-21,TO,Tonga,0,16817,0,12,0.07135636558244633
2023-05-28,TO,Tonga,0,16817,0,12,0.07135636558244633
2023-06-04,TO,Tonga,0,16817,0,12,0.07135636558244633
2023-06-11,TO,Tonga,0,16817,0,12,0.07135636558244633
2023-06-18,TO,Tonga,1,16818,0,12,0.07135212272565108
2023-06-25,TO,Tonga,1,16819,0,12,0.07134788037338724
2023-07-02,TO,Tonga,0,16819,0,12,0.07134788037338724
2023-07-09,TO,Tonga,0,16819,0,12,0.07134788037338724
2023-07-16,TO,Tonga,0,16819,0,12,0.07134788037338724
2023-07-23,TO,Tonga,0,16819,0,12,0.07134788037338724
2023-07-30,TO,Tonga,0,16819,0,12,0.07134788037338724
2023-08-06,TO,Tonga,0,16819,0,12,0.07134788037338724
2023-08-13,TO,Tonga,2,16821,0,12,0.07133939718209381
2023-08-20,TO,Tonga,0,16821,0,12,0.07133939718209381
2023-08-27,TO,Tonga,0,16821,0,12,0.07133939718209381
2023-09-03,TO,Tonga,0,16821,0,12,0.07133939718209381
2023-09-10,TO,Tonga,0,16821,0,12,0.07133939718209381
2023-09-17,TO,Tonga,4,16825,0,12,0.0713224368499257
2023-09-24,TO,Tonga,0,16825,0,12,0.0713224368499257
2023-10-01,TO,Tonga,0,16825,0,12,0.0713224368499257
2023-10-08,TO,Tonga,2,16827,0,12,0.07131395970761277
2023-10-15,TO,Tonga,12,16839,0,12,0.07126313914127917
2023-10-22,TO,Tonga,7,16846,0,12,0.07123352724682416
2023-10-29,TO,Tonga,14,16860,0,12,0.0711743772241993
2023-11-05,TO,Tonga,5,16865,0,12,0.07115327601541654
2023-11-12,TO,Tonga,11,16876,0,12,0.0711068973690448
2023-11-19,TO,Tonga,12,16888,0,12,0.07105637138796779
2023-11-26,TO,Tonga,0,16888,0,12,0.07105637138796779
2023-12-03,TO,Tonga,0,16888,0,12,0.07105637138796779
2023-12-10,TO,Tonga,0,16888,0,12,0.07105637138796779
2023-12-17,TO,Tonga,0,16888,0,12,0.07105637138796779
2023-12-24,TO,Tonga,0,16888,0,12,0.07105637138796779
2023-12-31,TO,Tonga,61,16949,0,12,0.07080063720573486
2024-01-07,TO,Tonga,1,16950,0,12,0.07079646017699115
2024-01-14,TO,Tonga,0,16950,0,12,0.07079646017699115
2020-11-29,TR,Türkiye,142929,1371148,1154,13373,0.9753141163463026
2020-12-06,TR,Türkiye,219546,1590694,1332,14705,0.9244392699035767
2020-12-13,TR,Türkiye,219115,1809809,1494,16199,0.8950668274939511
2020-12-20,TR,Türkiye,194476,2004285,1652,17851,0.8906417999436207
2020-12-27,TR,Türkiye,129088,2133373,1773,19624,0.9198578963922389
2021-01-03,TR,Türkiye,98662,2232035,1671,21295,0.9540621002806856
2021-01-10,TR,Türkiye,85083,2317118,1336,22631,0.9766874194581372
2021-03-28,TR,Türkiye,186421,3179115,964,30923,0.9726920856905146
2021-04-04,TR,Türkiye,265937,3445052,1155,32078,0.9311325344290885
2021-04-11,TR,Türkiye,353281,3798333,1624,33702,0.887283974311889
2021-04-18,TR,Türkiye,414312,4212645,1906,35608,0.8452646733821625
2021-04-25,TR,Türkiye,378771,4591416,2403,38011,0.8278709661681711
2021-05-02,TR,Türkiye,257992,4849408,2493,40504,0.835235971071108
2021-05-09,TR,Türkiye,166733,5016141,2242,42746,0.8521690279439912
2021-05-16,TR,Türkiye,90721,5106862,1791,44537,0.8721011063153851
2021-05-23,TR,Türkiye,71786,5178648,1534,46071,0.8896337422431492
2021-05-30,TR,Türkiye,57330,5235978,1200,47271,0.9028112799557217
2021-06-06,TR,Türkiye,46616,5282594,797,48068,0.9099317494397638
2021-06-13,TR,Türkiye,42841,5325435,600,48668,0.9138783967882437
2021-06-20,TR,Türkiye,39773,5365208,454,49122,0.9155656220597599
2021-06-27,TR,Türkiye,38936,5404144,402,49524,0.9164078529365614
2021-07-04,TR,Türkiye,36224,5440368,350,49874,0.9167394558603388
2021-07-11,TR,Türkiye,35926,5476294,326,50200,0.9166783229680511
2021-07-18,TR,Türkiye,45745,5522039,295,50495,0.9144267181017737
2021-07-25,TR,Türkiye,65339,5587378,371,50866,0.9103733450645366
2021-08-01,TR,Türkiye,139667,5727045,432,51298,0.8957149804131102
2021-08-08,TR,Türkiye,168796,5895841,723,52021,0.8823338349863912
2021-08-15,TR,Türkiye,163965,6059806,884,52905,0.873047751033614
2021-08-22,TR,Türkiye,137235,6197041,1235,54140,0.8736427595040924
2021-08-29,TR,Türkiye,132508,6329549,1618,55758,0.880915844083046
2021-09-05,TR,Türkiye,149114,6478663,1846,57604,0.889134069791869
2021-09-12,TR,Türkiye,158236,6636899,1825,59429,0.8954332437483229
2021-09-19,TR,Türkiye,183962,6820861,1756,61185,0.8970275160276686
2021-09-26,TR,Türkiye,192778,7013639,1605,62790,0.8952556582966417
2021-10-03,TR,Türkiye,197277,7210916,1519,64309,0.8918284445415811
2021-10-10,TR,Türkiye,205266,7416182,1514,65823,0.8875591240883786
2021-10-17,TR,Türkiye,213981,7630163,1447,67270,0.8816325417949787
2021-10-24,TR,Türkiye,196850,7827013,1475,68745,0.8783044055248151
2021-10-31,TR,Türkiye,182027,8009040,1507,70252,0.8771588105440853
2021-11-07,TR,Türkiye,197335,8206375,1517,71769,0.8745517966215289
2021-11-14,TR,Türkiye,180167,8386542,1403,73172,0.8724930966779872
2021-11-21,TR,Türkiye,163835,8550377,1519,74691,0.8735404298547303
2021-11-28,TR,Türkiye,174023,8724400,1395,76086,0.872105818165146
2021-12-05,TR,Türkiye,157360,8881760,1376,77462,0.8721469618634144
2021-12-12,TR,Türkiye,140463,9022223,1361,78823,0.8736538655717111
2021-12-19,TR,Türkiye,131986,9154209,1275,80098,0.8749854848190597
2021-12-26,TR,Türkiye,132777,9286986,1205,81303,0.8754508728666115
2022-01-02,TR,Türkiye,232295,9519281,1103,82406,0.8656746239553176
2022-01-09,TR,Türkiye,397444,9916725,1027,83433,0.8413362274339562
2022-01-16,TR,Türkiye,486339,10403064,1057,84490,0.8121645699766915
2022-01-23,TR,Türkiye,478562,10881626,1155,85645,0.7870606837617833
2022-01-30,TR,Türkiye,556850,11438476,1271,86916,0.7598564703899365
2022-02-06,TR,Türkiye,712091,12150567,1441,88357,0.7271841717345372
2022-02-13,TR,Türkiye,683967,12834534,1682,90039,0.7015369626976717
2022-02-20,TR,Türkiye,599596,13434130,1916,91955,0.6844879422783612
2022-02-27,TR,Türkiye,541259,13975389,1895,93850,0.671537658093095
2022-03-06,TR,Türkiye,350828,14326217,1400,95250,0.6648649814532336
2022-03-13,TR,Türkiye,208022,14534239,1012,96262,0.6623119380381731
2022-03-20,TR,Türkiye,146597,14680836,860,97122,0.6615563309882353
2022-03-27,TR,Türkiye,108647,14789483,589,97711,0.6606789432734059
2022-04-03,TR,Türkiye,96227,14885710,412,98123,0.6591758135822879
2022-04-10,TR,Türkiye,67655,14953365,264,98387,0.657958927639364
2022-04-17,TR,Türkiye,38304,14991669,190,98577,0.6575452006044157
2022-04-24,TR,Türkiye,24601,15016270,128,98705,0.6573203598496831
2022-05-01,TR,Türkiye,15823,15032093,97,98802,0.6572737409221723
2022-05-08,TR,Türkiye,9806,15041899,66,98868,0.6572840304272752
2022-05-15,TR,Türkiye,11269,15053168,53,98921,0.6571440642926459
2022-05-22,TR,Türkiye,9225,15062393,35,98956,0.656973961574366
2022-05-29,TR,Türkiye,7607,15070000,30,98986,0.6568414067684141
2022-06-05,TR,Türkiye,7320,15077320,18,99004,0.656641896570478
2022-06-12,TR,Türkiye,7555,15084875,23,99027,0.6564654993826597
2022-06-19,TR,Türkiye,10956,15095831,15,99042,0.6560884260031793
2022-06-26,TR,Türkiye,26635,15122466,13,99055,0.6550188309234751
2022-07-03,TR,Türkiye,57114,15179580,29,99084,0.6527453328748226
2022-07-10,TR,Türkiye,117096,15296676,31,99115,0.6479512280968754
2022-07-17,TR,Türkiye,226532,15523208,94,99209,0.6391011445572333
2022-07-24,TR,Türkiye,365422,15888630,158,99367,0.625396903320173
2022-07-31,TR,Türkiye,406321,16294951,336,99703,0.6118643744310738
2022-08-07,TR,Türkiye,232254,16527205,381,100084,0.6055712384519948
2022-08-14,TR,Türkiye,143777,16670982,341,100425,0.6023940281382345
2022-08-21,TR,Türkiye,80022,16751004,228,100653,0.6008774160641356
2022-08-28,TR,Türkiye,45882,16796886,206,100859,0.6004624904878202
2022-09-04,TR,Türkiye,32191,16829077,141,101000,0.6001517492611151
2022-09-11,TR,Türkiye,22441,16851518,89,101089,0.5998806754382602
2022-09-18,TR,Türkiye,21411,16872929,73,101162,0.599552099105022
2022-09-25,TR,Türkiye,22729,16895658,38,101200,0.5989704573802334
2022-10-02,TR,Türkiye,23116,16918774,24,101224,0.5982939425752718
2022-10-09,TR,Türkiye,18723,16937497,38,101262,0.5978569324617445
2022-10-16,TR,Türkiye,15482,16952979,25,101287,0.5974584171902767
2022-10-23,TR,Türkiye,11808,16964787,42,101329,0.5972901398644145
2022-10-30,TR,Türkiye,11083,16975870,25,101354,0.5970474561833944
2022-11-06,TR,Türkiye,13508,16989378,30,101384,0.5967493336130375
2022-11-13,TR,Türkiye,15299,17004677,35,101419,0.59641826775069
2022-11-20,TR,Türkiye,0,17004677,0,101419,0.59641826775069
2022-11-27,TR,Türkiye,0,17004677,0,101419,0.59641826775069
2022-12-04,TR,Türkiye,0,17004677,0,101419,0.59641826775069
2022-12-11,TR,Türkiye,0,17004677,0,101419,0.59641826775069
2022-12-18,TR,Türkiye,0,17004677,0,101419,0.59641826775069
2022-12-25,TR,Türkiye,0,17004677,0,101419,0.59641826775069
2023-01-01,TR,Türkiye,0,17004677,0,101419,0.59641826775069
2023-01-08,TR,Türkiye,0,17004677,0,101419,0.59641826775069
2023-01-15,TR,Türkiye,0,17004677,0,101419,0.59641826775069
2023-01-22,TR,Türkiye,0,17004677,0,101419,0.59641826775069
2023-01-29,TR,Türkiye,0,17004677,0,101419,0.59641826775069
2023-02-05,TR,Türkiye,0,17004677,0,101419,0.59641826775069
2023-02-12,TR,Türkiye,0,17004677,0,101419,0.59641826775069
2023-02-19,TR,Türkiye,0,17004677,0,101419,0.59641826775069
2023-02-26,TR,Türkiye,0,17004677,0,101419,0.59641826775069
2023-03-05,TR,Türkiye,0,17004677,0,101419,0.59641826775069
2023-03-12,TR,Türkiye,0,17004677,0,101419,0.59641826775069
2023-03-19,TR,Türkiye,0,17004677,0,101419,0.59641826775069
2023-03-26,TR,Türkiye,0,17004677,0,101419,0.59641826775069
2023-04-02,TR,Türkiye,0,17004677,0,101419,0.59641826775069
2023-04-09,TR,Türkiye,0,17004677,0,101419,0.59641826775069
2023-04-16,TR,Türkiye,0,17004677,0,101419,0.59641826775069
2023-04-23,TR,Türkiye,0,17004677,0,101419,0.59641826775069
2023-04-30,TR,Türkiye,0,17004677,0,101419,0.59641826775069
2023-05-07,TR,Türkiye,0,17004677,0,101419,0.59641826775069
2023-05-14,TR,Türkiye,0,17004677,0,101419,0.59641826775069
2023-05-21,TR,Türkiye,0,17004677,0,101419,0.59641826775069
2023-05-28,TR,Türkiye,0,17004677,0,101419,0.59641826775069
2023-06-04,TR,Türkiye,0,17004677,0,101419,0.59641826775069
2023-06-11,TR,Türkiye,0,17004677,0,101419,0.59641826775069
2023-06-18,TR,Türkiye,0,17004677,0,101419,0.59641826775069
2023-06-25,TR,Türkiye,0,17004677,0,101419,0.59641826775069
2023-07-02,TR,Türkiye,0,17004677,0,101419,0.59641826775069
2023-07-09,TR,Türkiye,0,17004677,0,101419,0.59641826775069
2023-07-16,TR,Türkiye,0,17004677,0,101419,0.59641826775069
2023-07-23,TR,Türkiye,0,17004677,0,101419,0.59641826775069
2023-07-30,TR,Türkiye,0,17004677,0,101419,0.59641826775069
2023-08-06,TR,Türkiye,0,17004677,0,101419,0.59641826775069
2023-08-13,TR,Türkiye,0,17004677,0,101419,0.59641826775069
2023-08-20,TR,Türkiye,0,17004677,0,101419,0.59641826775069
2023-08-27,TR,Türkiye,0,17004677,0,101419,0.59641826775069
2023-09-03,TR,Türkiye,0,17004677,0,101419,0.59641826775069
2023-09-10,TR,Türkiye,0,17004677,0,101419,0.59641826775069
2023-09-17,TR,Türkiye,0,17004677,0,101419,0.59641826775069
2023-09-24,TR,Türkiye,0,17004677,0,101419,0.59641826775069
2023-10-01,TR,Türkiye,0,17004677,0,101419,0.59641826775069
2023-10-08,TR,Türkiye,0,17004677,0,101419,0.59641826775069
2023-10-15,TR,Türkiye,0,17004677,0,101419,0.59641826775069
2023-10-22,TR,Türkiye,0,17004677,0,101419,0.59641826775069
2023-10-29,TR,Türkiye,0,17004677,0,101419,0.59641826775069
2023-11-05,TR,Türkiye,0,17004677,0,101419,0.59641826775069
2023-11-12,TR,Türkiye,0,17004677,0,101419,0.59641826775069
2023-11-19,TR,Türkiye,0,17004677,0,101419,0.59641826775069
2023-11-26,TR,Türkiye,0,17004677,0,101419,0.59641826775069
2023-12-03,TR,Türkiye,0,17004677,0,101419,0.59641826775069
2023-12-10,TR,Türkiye,0,17004677,0,101419,0.59641826775069
2023-12-17,TR,Türkiye,0,17004677,0,101419,0.59641826775069
2023-12-24,TR,Türkiye,0,17004677,0,101419,0.59641826775069
2023-12-31,TR,Türkiye,0,17004677,0,101419,0.59641826775069
2024-01-07,TR,Türkiye,0,17004677,0,101419,0.59641826775069
2024-01-14,TR,Türkiye,0,17004677,0,101419,0.59641826775069
2020-08-16,TC,Turks and Caicos Islands,104,274,0,2,0.7299270072992701
2020-08-23,TC,Turks and Caicos Islands,73,347,0,2,0.5763688760806917
2020-08-30,TC,Turks and Caicos Islands,143,490,1,3,0.6122448979591837
2020-09-06,TC,Turks and Caicos Islands,101,591,2,5,0.8460236886632826
2020-09-13,TC,Turks and Caicos Islands,50,641,0,5,0.7800312012480499
2020-09-20,TC,Turks and Caicos Islands,26,667,0,5,0.7496251874062968
2020-09-27,TC,Turks and Caicos Islands,13,680,0,5,0.7352941176470588
2020-10-04,TC,Turks and Caicos Islands,15,695,1,6,0.8633093525179856
2020-10-11,TC,Turks and Caicos Islands,0,695,0,6,0.8633093525179856
2020-10-18,TC,Turks and Caicos Islands,2,697,0,6,0.860832137733142
2020-10-25,TC,Turks and Caicos Islands,2,699,0,6,0.8583690987124464
2020-11-01,TC,Turks and Caicos Islands,4,703,0,6,0.8534850640113799
2020-11-08,TC,Turks and Caicos Islands,4,707,0,6,0.8486562942008486
2020-11-15,TC,Turks and Caicos Islands,9,716,0,6,0.8379888268156425
2020-11-22,TC,Turks and Caicos Islands,24,740,0,6,0.8108108108108109
2020-11-29,TC,Turks and Caicos Islands,8,748,0,6,0.8021390374331552
2020-12-06,TC,Turks and Caicos Islands,7,755,0,6,0.7947019867549668
2020-12-13,TC,Turks and Caicos Islands,14,769,0,6,0.7802340702210664
2020-12-20,TC,Turks and Caicos Islands,20,789,0,6,0.7604562737642585
2020-12-27,TC,Turks and Caicos Islands,55,844,0,6,0.7109004739336493
2021-01-03,TC,Turks and Caicos Islands,64,908,0,6,0.6607929515418502
2021-01-10,TC,Turks and Caicos Islands,57,965,0,6,0.6217616580310881
2021-01-17,TC,Turks and Caicos Islands,114,1079,0,6,0.5560704355885079
2021-01-24,TC,Turks and Caicos Islands,165,1244,1,7,0.5627009646302251
2021-01-31,TC,Turks and Caicos Islands,215,1459,1,8,0.5483207676490748
2021-02-07,TC,Turks and Caicos Islands,195,1654,1,9,0.5441354292623942
2021-02-14,TC,Turks and Caicos Islands,179,1833,3,12,0.6546644844517185
2021-02-21,TC,Turks and Caicos Islands,165,1998,2,14,0.7007007007007007
2021-02-28,TC,Turks and Caicos Islands,101,2099,0,14,0.6669842782277274
2021-03-07,TC,Turks and Caicos Islands,73,2172,0,14,0.6445672191528545
2021-03-14,TC,Turks and Caicos Islands,28,2200,1,15,0.6818181818181818
2021-03-21,TC,Turks and Caicos Islands,90,2290,0,15,0.6550218340611353
2021-03-28,TC,Turks and Caicos Islands,35,2325,2,17,0.7311827956989247
2021-04-04,TC,Turks and Caicos Islands,19,2344,0,17,0.7252559726962458
2021-04-11,TC,Turks and Caicos Islands,0,2344,0,17,0.7252559726962458
2021-04-18,TC,Turks and Caicos Islands,25,2369,0,17,0.7176023638666104
2021-04-25,TC,Turks and Caicos Islands,7,2376,0,17,0.7154882154882155
2021-05-02,TC,Turks and Caicos Islands,14,2390,0,17,0.7112970711297071
2021-05-09,TC,Turks and Caicos Islands,12,2402,0,17,0.7077435470441299
2021-05-16,TC,Turks and Caicos Islands,2,2404,0,17,0.7071547420965058
2021-05-23,TC,Turks and Caicos Islands,4,2408,0,17,0.7059800664451827
2021-05-30,TC,Turks and Caicos Islands,4,2412,0,17,0.7048092868988391
2021-06-06,TC,Turks and Caicos Islands,8,2420,0,17,0.7024793388429752
2021-06-13,TC,Turks and Caicos Islands,1,2421,1,18,0.7434944237918215
2021-06-20,TC,Turks and Caicos Islands,2,2423,0,18,0.7428807263722659
2021-06-27,TC,Turks and Caicos Islands,1,2424,0,18,0.7425742574257426
2021-07-04,TC,Turks and Caicos Islands,1,2425,0,18,0.7422680412371134
2021-07-11,TC,Turks and Caicos Islands,5,2430,0,18,0.7407407407407408
2021-07-18,TC,Turks and Caicos Islands,16,2446,0,18,0.7358953393295176
2021-07-25,TC,Turks and Caicos Islands,16,2462,0,18,0.7311129163281885
2021-08-01,TC,Turks and Caicos Islands,22,2484,0,18,0.7246376811594203
2021-08-08,TC,Turks and Caicos Islands,30,2514,0,18,0.7159904534606205
2021-08-15,TC,Turks and Caicos Islands,48,2562,1,19,0.741608118657299
2021-08-22,TC,Turks and Caicos Islands,45,2607,0,19,0.728807057920982
2021-08-29,TC,Turks and Caicos Islands,30,2637,1,20,0.7584376185058779
2021-09-05,TC,Turks and Caicos Islands,55,2692,0,20,0.7429420505200593
2021-09-12,TC,Turks and Caicos Islands,61,2753,0,20,0.726480203414457
2021-09-19,TC,Turks and Caicos Islands,47,2800,1,21,0.75
2021-09-26,TC,Turks and Caicos Islands,30,2830,1,22,0.7773851590106008
2021-10-03,TC,Turks and Caicos Islands,29,2859,1,23,0.8044770898915705
2021-10-10,TC,Turks and Caicos Islands,31,2890,0,23,0.795847750865052
2021-10-17,TC,Turks and Caicos Islands,32,2922,0,23,0.7871321013004791
2021-10-24,TC,Turks and Caicos Islands,29,2951,0,23,0.7793968146391054
2021-10-31,TC,Turks and Caicos Islands,29,2980,0,23,0.7718120805369127
2021-11-07,TC,Turks and Caicos Islands,31,3011,0,23,0.7638658253072069
2021-11-14,TC,Turks and Caicos Islands,20,3031,0,23,0.7588254701418674
2021-11-21,TC,Turks and Caicos Islands,45,3076,0,23,0.7477243172951885
2021-11-28,TC,Turks and Caicos Islands,20,3096,1,24,0.7751937984496124
2021-12-05,TC,Turks and Caicos Islands,7,3103,1,25,0.8056719303899453
2021-12-12,TC,Turks and Caicos Islands,27,3130,0,25,0.7987220447284344
2021-12-19,TC,Turks and Caicos Islands,33,3163,0,25,0.7903888713246918
2021-12-26,TC,Turks and Caicos Islands,72,3235,1,26,0.80370942812983
2022-01-02,TC,Turks and Caicos Islands,173,3408,0,26,0.7629107981220657
2022-01-09,TC,Turks and Caicos Islands,472,3880,0,26,0.6701030927835051
2022-01-16,TC,Turks and Caicos Islands,1076,4956,4,30,0.6053268765133172
2022-01-23,TC,Turks and Caicos Islands,568,5524,3,33,0.5973931933381608
2022-01-30,TC,Turks and Caicos Islands,168,5692,1,34,0.5973295853829936
2022-02-06,TC,Turks and Caicos Islands,86,5778,1,35,0.6057459328487366
2022-02-13,TC,Turks and Caicos Islands,45,5823,0,35,0.6010647432594882
2022-02-20,TC,Turks and Caicos Islands,20,5843,1,36,0.616121855211364
2022-02-27,TC,Turks and Caicos Islands,12,5855,0,36,0.6148590947907772
2022-03-06,TC,Turks and Caicos Islands,12,5867,0,36,0.6136014999147775
2022-03-13,TC,Turks and Caicos Islands,7,5874,0,36,0.6128702757916241
2022-03-20,TC,Turks and Caicos Islands,0,5874,0,36,0.6128702757916241
2022-03-27,TC,Turks and Caicos Islands,14,5888,0,36,0.6114130434782609
2022-04-03,TC,Turks and Caicos Islands,22,5910,0,36,0.6091370558375634
2022-04-10,TC,Turks and Caicos Islands,13,5923,0,36,0.6078001013000169
2022-04-17,TC,Turks and Caicos Islands,13,5936,0,36,0.6064690026954178
2022-04-24,TC,Turks and Caicos Islands,5,5941,0,36,0.6059585928294899
2022-05-01,TC,Turks and Caicos Islands,22,5963,0,36,0.6037229582424953
2022-05-08,TC,Turks and Caicos Islands,32,5995,0,36,0.6005004170141784
2022-05-15,TC,Turks and Caicos Islands,51,6046,0,36,0.5954349983460139
2022-05-22,TC,Turks and Caicos Islands,51,6097,0,36,0.5904543217976054
2022-05-29,TC,Turks and Caicos Islands,26,6123,0,36,0.5879470847623713
2022-06-05,TC,Turks and Caicos Islands,25,6148,0,36,0.5855562784645413
2022-06-12,TC,Turks and Caicos Islands,12,6160,0,36,0.5844155844155844
2022-06-19,TC,Turks and Caicos Islands,29,6189,0,36,0.58167716917111
2022-06-26,TC,Turks and Caicos Islands,22,6211,0,36,0.5796168088874577
2022-07-03,TC,Turks and Caicos Islands,8,6219,0,36,0.5788712011577424
2022-07-10,TC,Turks and Caicos Islands,15,6234,0,36,0.5774783445620789
2022-07-17,TC,Turks and Caicos Islands,21,6255,0,36,0.5755395683453237
2022-07-24,TC,Turks and Caicos Islands,24,6279,0,36,0.5733397037744864
2022-07-31,TC,Turks and Caicos Islands,24,6303,0,36,0.5711565920990005
2022-08-07,TC,Turks and Caicos Islands,25,6328,0,36,0.5689001264222503
2022-08-14,TC,Turks and Caicos Islands,10,6338,0,36,0.5680025244556642
2022-08-21,TC,Turks and Caicos Islands,13,6351,0,36,0.5668398677373643
2022-08-28,TC,Turks and Caicos Islands,8,6359,0,36,0.5661267494889133
2022-09-04,TC,Turks and Caicos Islands,10,6369,0,36,0.5652378709373528
2022-09-11,TC,Turks and Caicos Islands,3,6372,0,36,0.5649717514124294
2022-09-18,TC,Turks and Caicos Islands,8,6380,0,36,0.5642633228840125
2022-09-25,TC,Turks and Caicos Islands,0,6380,0,36,0.5642633228840125
2022-10-02,TC,Turks and Caicos Islands,0,6380,0,36,0.5642633228840125
2022-10-09,TC,Turks and Caicos Islands,0,6380,0,36,0.5642633228840125
2022-10-16,TC,Turks and Caicos Islands,0,6380,0,36,0.5642633228840125
2022-10-23,TC,Turks and Caicos Islands,0,6380,0,36,0.5642633228840125
2022-10-30,TC,Turks and Caicos Islands,49,6429,0,36,0.5599626691553896
2022-11-06,TC,Turks and Caicos Islands,2,6431,0,36,0.5597885243352512
2022-11-13,TC,Turks and Caicos Islands,7,6438,0,36,0.5591798695246971
2022-11-20,TC,Turks and Caicos Islands,2,6440,0,36,0.5590062111801243
2022-11-27,TC,Turks and Caicos Islands,6,6446,0,36,0.5584858827179646
2022-12-04,TC,Turks and Caicos Islands,0,6446,0,36,0.5584858827179646
2022-12-11,TC,Turks and Caicos Islands,0,6446,0,36,0.5584858827179646
2022-12-18,TC,Turks and Caicos Islands,17,6463,0,36,0.557016865232864
2022-12-25,TC,Turks and Caicos Islands,16,6479,0,36,0.5556413026701652
2023-01-01,TC,Turks and Caicos Islands,0,6479,0,36,0.5556413026701652
2023-01-08,TC,Turks and Caicos Islands,0,6479,0,36,0.5556413026701652
2023-01-15,TC,Turks and Caicos Islands,0,6479,0,36,0.5556413026701652
2023-01-22,TC,Turks and Caicos Islands,43,6522,2,38,0.5826433609322293
2023-01-29,TC,Turks and Caicos Islands,0,6522,0,38,0.5826433609322293
2023-02-05,TC,Turks and Caicos Islands,15,6537,0,38,0.5813064096680434
2023-02-12,TC,Turks and Caicos Islands,7,6544,0,38,0.5806845965770171
2023-02-19,TC,Turks and Caicos Islands,7,6551,0,38,0.5800641123492597
2023-02-26,TC,Turks and Caicos Islands,0,6551,0,38,0.5800641123492597
2023-03-05,TC,Turks and Caicos Islands,6,6557,0,38,0.5795333231660821
2023-03-12,TC,Turks and Caicos Islands,4,6561,0,38,0.5791800030483159
2023-03-19,TC,Turks and Caicos Islands,1,6562,0,38,0.5790917403230723
2023-03-26,TC,Turks and Caicos Islands,3,6565,0,38,0.5788271134805788
2023-04-02,TC,Turks and Caicos Islands,0,6565,0,38,0.5788271134805788
2023-04-09,TC,Turks and Caicos Islands,0,6565,0,38,0.5788271134805788
2023-04-16,TC,Turks and Caicos Islands,0,6565,0,38,0.5788271134805788
2023-04-23,TC,Turks and Caicos Islands,0,6565,0,38,0.5788271134805788
2023-04-30,TC,Turks and Caicos Islands,0,6565,0,38,0.5788271134805788
2023-05-07,TC,Turks and Caicos Islands,23,6588,0,38,0.5768063145112325
2023-05-14,TC,Turks and Caicos Islands,0,6588,0,38,0.5768063145112325
2023-05-21,TC,Turks and Caicos Islands,5,6593,0,38,0.5763688760806917
2023-05-28,TC,Turks and Caicos Islands,2,6595,0,38,0.576194086429113
2023-06-04,TC,Turks and Caicos Islands,3,6598,0,38,0.5759321006365565
2023-06-11,TC,Turks and Caicos Islands,4,6602,0,38,0.5755831566192063
2023-06-18,TC,Turks and Caicos Islands,2,6604,0,38,0.5754088431253785
2023-06-25,TC,Turks and Caicos Islands,4,6608,1,39,0.5901937046004843
2023-07-02,TC,Turks and Caicos Islands,4,6612,0,39,0.58983666061706
2023-07-09,TC,Turks and Caicos Islands,4,6616,0,39,0.5894800483675937
2023-07-16,TC,Turks and Caicos Islands,4,6620,0,39,0.5891238670694864
2023-07-23,TC,Turks and Caicos Islands,5,6625,0,39,0.5886792452830188
2023-07-30,TC,Turks and Caicos Islands,16,6641,0,39,0.5872609546755007
2023-08-06,TC,Turks and Caicos Islands,3,6644,0,39,0.5869957856712823
2023-08-13,TC,Turks and Caicos Islands,2,6646,0,39,0.586819139331929
2023-08-20,TC,Turks and Caicos Islands,3,6649,0,39,0.5865543690780568
2023-08-27,TC,Turks and Caicos Islands,2,6651,0,39,0.5863779882724403
2023-09-03,TC,Turks and Caicos Islands,0,6651,0,39,0.5863779882724403
2023-09-10,TC,Turks and Caicos Islands,0,6651,0,39,0.5863779882724403
2023-09-17,TC,Turks and Caicos Islands,0,6651,0,39,0.5863779882724403
2023-09-24,TC,Turks and Caicos Islands,0,6651,0,39,0.5863779882724403
2023-10-01,TC,Turks and Caicos Islands,0,6651,1,40,0.6014133213050669
2023-10-08,TC,Turks and Caicos Islands,15,6666,0,40,0.6000600060006
2023-10-15,TC,Turks and Caicos Islands,1,6667,0,40,0.5999700014999251
2023-10-22,TC,Turks and Caicos Islands,1,6668,0,40,0.599880023995201
2023-10-29,TC,Turks and Caicos Islands,5,6673,0,40,0.5994305409860633
2023-11-05,TC,Turks and Caicos Islands,0,6673,0,40,0.5994305409860633
2023-11-12,TC,Turks and Caicos Islands,0,6673,0,40,0.5994305409860633
2023-11-19,TC,Turks and Caicos Islands,23,6696,0,40,0.5973715651135006
2023-11-26,TC,Turks and Caicos Islands,1,6697,0,40,0.5972823652381664
2023-12-03,TC,Turks and Caicos Islands,1,6698,0,40,0.5971931919976112
2023-12-10,TC,Turks and Caicos Islands,6,6704,0,40,0.5966587112171837
2023-12-17,TC,Turks and Caicos Islands,7,6711,0,40,0.5960363582178513
2023-12-24,TC,Turks and Caicos Islands,0,6711,0,40,0.5960363582178513
2023-12-31,TC,Turks and Caicos Islands,2,6713,0,40,0.5958587814687919
2024-01-07,TC,Turks and Caicos Islands,0,6713,0,40,0.5958587814687919
2024-01-14,TC,Turks and Caicos Islands,0,6713,0,40,0.5958587814687919
2023-06-18,TV,Tuvalu,2,2943,1,1,0.03397893306150187
2023-06-25,TV,Tuvalu,0,2943,0,1,0.03397893306150187
2023-07-02,TV,Tuvalu,0,2943,0,1,0.03397893306150187
2023-07-09,TV,Tuvalu,0,2943,0,1,0.03397893306150187
2023-07-16,TV,Tuvalu,0,2943,0,1,0.03397893306150187
2023-07-23,TV,Tuvalu,0,2943,0,1,0.03397893306150187
2023-07-30,TV,Tuvalu,0,2943,0,1,0.03397893306150187
2023-08-06,TV,Tuvalu,0,2943,0,1,0.03397893306150187
2023-08-13,TV,Tuvalu,0,2943,0,1,0.03397893306150187
2023-08-20,TV,Tuvalu,0,2943,0,1,0.03397893306150187
2023-08-27,TV,Tuvalu,0,2943,0,1,0.03397893306150187
2023-09-03,TV,Tuvalu,0,2943,0,1,0.03397893306150187
2023-09-10,TV,Tuvalu,0,2943,0,1,0.03397893306150187
2023-09-17,TV,Tuvalu,0,2943,0,1,0.03397893306150187
2023-09-24,TV,Tuvalu,0,2943,0,1,0.03397893306150187
2023-10-01,TV,Tuvalu,0,2943,0,1,0.03397893306150187
2023-10-08,TV,Tuvalu,0,2943,0,1,0.03397893306150187
2023-10-15,TV,Tuvalu,0,2943,0,1,0.03397893306150187
2023-10-22,TV,Tuvalu,0,2943,0,1,0.03397893306150187
2023-10-29,TV,Tuvalu,0,2943,0,1,0.03397893306150187
2023-11-05,TV,Tuvalu,0,2943,0,1,0.03397893306150187
2023-11-12,TV,Tuvalu,0,2943,0,1,0.03397893306150187
2023-11-19,TV,Tuvalu,0,2943,0,1,0.03397893306150187
2023-11-26,TV,Tuvalu,0,2943,0,1,0.03397893306150187
2023-12-03,TV,Tuvalu,0,2943,0,1,0.03397893306150187
2023-12-10,TV,Tuvalu,0,2943,0,1,0.03397893306150187
2023-12-17,TV,Tuvalu,0,2943,0,1,0.03397893306150187
2023-12-24,TV,Tuvalu,0,2943,0,1,0.03397893306150187
2023-12-31,TV,Tuvalu,0,2943,0,1,0.03397893306150187
2024-01-07,TV,Tuvalu,0,2943,0,1,0.03397893306150187
2024-01-14,TV,Tuvalu,0,2943,0,1,0.03397893306150187
2020-07-26,UG,Uganda,52,1115,2,2,0.17937219730941703
2020-08-02,UG,Uganda,67,1182,2,4,0.338409475465313
2020-08-09,UG,Uganda,101,1283,3,7,0.5455962587685114
2020-12-13,UG,Uganda,5034,27535,17,258,0.936989286362811
2020-12-20,UG,Uganda,3656,31191,19,277,0.8880766887884325
2020-12-27,UG,Uganda,2624,33815,21,298,0.8812657104835132
2021-01-03,UG,Uganda,2107,35922,7,305,0.8490618562440844
2021-01-10,UG,Uganda,1820,37742,6,311,0.8240156854432727
2021-01-17,UG,Uganda,677,38419,4,315,0.819906816939535
2021-01-24,UG,Uganda,730,39149,4,319,0.8148356279853891
2021-01-31,UG,Uganda,430,39579,2,321,0.8110361555370272
2021-02-07,UG,Uganda,269,39848,3,324,0.8130897410158603
2021-02-14,UG,Uganda,208,40056,2,326,0.8138605951667665
2021-02-21,UG,Uganda,157,40213,4,330,0.8206301444806406
2021-02-28,UG,Uganda,144,40357,1,331,0.8201798944421043
2021-03-07,UG,Uganda,122,40479,0,331,0.8177079473307147
2021-03-14,UG,Uganda,102,40581,0,331,0.8156526453266307
2021-03-21,UG,Uganda,107,40688,1,332,0.8159653952025167
2021-03-28,UG,Uganda,132,40820,1,333,0.8157765801077903
2021-04-04,UG,Uganda,196,41016,1,334,0.8143163643456212
2021-04-11,UG,Uganda,158,41174,1,335,0.8136202457861758
2021-04-18,UG,Uganda,222,41396,3,338,0.8165040100492802
2021-04-25,UG,Uganda,321,41717,1,339,0.8126183570247142
2021-05-02,UG,Uganda,264,41981,4,343,0.8170362783163811
2021-05-09,UG,Uganda,405,42386,3,346,0.8163072712688152
2021-05-16,UG,Uganda,475,42861,3,349,0.8142600499288397
2021-05-23,UG,Uganda,1060,43921,4,353,0.8037157623915667
2021-05-30,UG,Uganda,3226,47147,9,362,0.7678113135512333
2021-06-06,UG,Uganda,6814,53961,21,383,0.7097718722781268
2021-06-13,UG,Uganda,9138,63099,51,434,0.68780804767112
2021-06-20,UG,Uganda,9580,72679,246,680,0.9356210184509969
2020-03-29,AE,United Arab Emirates,315,468,0,2,0.4273504273504274
2020-04-05,AE,United Arab Emirates,1037,1505,8,10,0.6644518272425249
2020-04-12,AE,United Arab Emirates,2231,3736,10,20,0.5353319057815845
2020-04-19,AE,United Arab Emirates,2566,6302,17,37,0.587115201523326
2020-04-26,AE,United Arab Emirates,3511,9813,34,71,0.7235300112096199
2020-05-03,AE,United Arab Emirates,3786,13599,48,119,0.8750643429663946
2020-05-17,AE,United Arab Emirates,5210,22627,29,214,0.9457727493702214
2020-05-24,AE,United Arab Emirates,6077,28704,30,244,0.8500557413600892
2020-05-31,AE,United Arab Emirates,5192,33896,18,262,0.7729525607741327
2020-06-07,AE,United Arab Emirates,4372,38268,13,275,0.7186160760949096
2020-06-14,AE,United Arab Emirates,3722,41990,13,288,0.6858775899023577
2020-06-21,AE,United Arab Emirates,2543,44533,13,301,0.6759032627489727
2020-06-28,AE,United Arab Emirates,2827,47360,10,311,0.6566722972972973
2020-07-05,AE,United Arab Emirates,3497,50857,10,321,0.631181548262776
2020-07-12,AE,United Arab Emirates,3596,54453,10,331,0.6078636622408315
2020-07-19,AE,United Arab Emirates,2258,56711,7,338,0.5960043025162667
2020-07-26,AE,United Arab Emirates,1851,58562,5,343,0.5857040401625627
2020-08-02,AE,United Arab Emirates,2198,60760,8,351,0.5776826859776168
2020-08-09,AE,United Arab Emirates,1540,62300,5,356,0.5714285714285714
2020-08-16,AE,United Arab Emirates,1802,64102,5,361,0.5631649558516115
2020-08-23,AE,United Arab Emirates,2515,66617,11,372,0.5584160199348515
2020-08-30,AE,United Arab Emirates,2711,69328,7,379,0.5466766674359567
2020-09-06,AE,United Arab Emirates,4143,73471,9,388,0.5280995222604837
2020-09-13,AE,United Arab Emirates,5378,78849,11,399,0.5060305140204695
2020-09-20,AE,United Arab Emirates,5393,84242,5,404,0.47957076042828994
2020-09-27,AE,United Arab Emirates,6376,90618,7,411,0.45355227438257306
2020-10-04,AE,United Arab Emirates,7142,97760,15,426,0.4357610474631751
2020-10-11,AE,United Arab Emirates,7373,105133,17,443,0.4213710252727498
2020-10-18,AE,United Arab Emirates,9254,114387,16,459,0.40126937501639176
2020-10-25,AE,United Arab Emirates,9377,123764,16,475,0.38379496461006435
2020-11-01,AE,United Arab Emirates,8865,132629,20,495,0.37322154279984016
2020-11-08,AE,United Arab Emirates,8403,141032,19,514,0.3644562936071246
2020-11-15,AE,United Arab Emirates,8103,149135,14,528,0.35404164012471917
2020-11-22,AE,United Arab Emirates,8650,157785,20,548,0.3473080457584688
2020-11-29,AE,United Arab Emirates,8717,166502,21,569,0.34173763678514374
2020-12-06,AE,United Arab Emirates,8774,175276,20,589,0.33604144320956664
2020-12-13,AE,United Arab Emirates,8479,183755,20,609,0.3314195532094365
2020-12-20,AE,United Arab Emirates,8649,192404,25,634,0.3295149788985676
2020-12-27,AE,United Arab Emirates,8488,200892,21,655,0.3260458355733429
2021-01-03,AE,United Arab Emirates,10749,211641,19,674,0.3184638137222939
2021-01-10,AE,United Arab Emirates,16061,227702,28,702,0.30829768732817453
2021-01-17,AE,United Arab Emirates,22106,249808,38,740,0.29622750272209053
2021-01-24,AE,United Arab Emirates,24568,274376,43,783,0.28537481412368426
2021-01-31,AE,United Arab Emirates,26285,300661,55,838,0.2787192219809021
2021-02-07,AE,United Arab Emirates,22741,323402,76,914,0.28262039195799654
2021-02-14,AE,United Arab Emirates,22203,345605,87,1001,0.2896370133533948
2021-02-21,AE,United Arab Emirates,22570,368175,107,1108,0.30094384463909823
2021-02-28,AE,United Arab Emirates,20419,388594,105,1213,0.3121509853471747
2021-03-07,AE,United Arab Emirates,19642,408236,97,1310,0.3208928169000284
2021-03-14,AE,United Arab Emirates,16169,424405,78,1388,0.3270460998338851
2021-03-21,AE,United Arab Emirates,14233,438638,45,1433,0.3266930817667416
2021-03-28,AE,United Arab Emirates,14431,453069,44,1477,0.32599890965835226
2021-04-04,AE,United Arab Emirates,14954,468023,27,1504,0.32135172844069626
2021-04-11,AE,United Arab Emirates,13914,481937,25,1529,0.31726138478680826
2021-04-18,AE,United Arab Emirates,13287,495224,21,1550,0.3129896773985106
2021-04-25,AE,United Arab Emirates,13701,508925,19,1569,0.3082969003291251
2021-05-02,AE,United Arab Emirates,13023,521948,22,1591,0.30481963720523886
2021-05-09,AE,United Arab Emirates,12497,534445,19,1610,0.30124708810074
2021-05-16,AE,United Arab Emirates,10486,544931,19,1629,0.2989369296296228
2021-05-23,AE,United Arab Emirates,9585,554516,19,1648,0.297196113367333
2021-05-30,AE,United Arab Emirates,12747,567263,25,1673,0.2949249290011864
2021-06-06,AE,United Arab Emirates,13934,581197,23,1696,0.2918115544299093
2021-06-13,AE,United Arab Emirates,14820,596017,28,1724,0.289253494447306
2021-06-20,AE,United Arab Emirates,14162,610179,28,1752,0.28712885890861534
2021-06-27,AE,United Arab Emirates,14635,624814,40,1792,0.2868053532731341
2021-07-04,AE,United Arab Emirates,13063,637877,39,1831,0.2870459351881319
2021-07-11,AE,United Arab Emirates,10825,648702,29,1860,0.28672641675222216
2021-07-18,AE,United Arab Emirates,10747,659449,36,1896,0.28751275686216826
2021-07-25,AE,United Arab Emirates,10659,670108,20,1916,0.2859240600022683
2021-08-01,AE,United Arab Emirates,10750,680858,33,1949,0.28625645876232636
2021-08-08,AE,United Arab Emirates,10696,691554,22,1971,0.28501028119279187
2021-08-15,AE,United Arab Emirates,9033,700587,26,1997,0.2850466822821434
2021-08-22,AE,United Arab Emirates,7715,708302,21,2018,0.2849067205796397
2021-08-29,AE,United Arab Emirates,7092,715394,18,2036,0.2845984170960338
2021-09-05,AE,United Arab Emirates,6898,722292,9,2045,0.2831264917789481
2021-09-12,AE,United Arab Emirates,5974,728266,17,2062,0.2831383038615012
2021-09-19,AE,United Arab Emirates,4033,732299,11,2073,0.28308109119362446
2021-09-26,AE,United Arab Emirates,2297,734596,16,2089,0.2843739960468067
2021-10-03,AE,United Arab Emirates,1928,736524,11,2100,0.28512309171187905
2021-10-10,AE,United Arab Emirates,1131,737655,13,2113,0.28644827188862004
2021-10-17,AE,United Arab Emirates,832,738487,5,2118,0.2868026112849651
2021-10-24,AE,United Arab Emirates,703,739190,11,2129,0.2880179656110067
2021-10-31,AE,United Arab Emirates,634,739824,7,2136,0.2887173165509635
2021-11-07,AE,United Arab Emirates,538,740362,3,2139,0.2889127210742853
2021-11-14,AE,United Arab Emirates,517,740879,4,2143,0.2892510112987411
2021-11-21,AE,United Arab Emirates,491,741370,1,2144,0.2891943294171601
2021-11-28,AE,United Arab Emirates,488,741858,1,2145,0.28913889180948377
2021-12-05,AE,United Arab Emirates,420,742278,3,2148,0.2893794508257014
2021-12-12,AE,United Arab Emirates,441,742719,3,2151,0.2896115489168851
2021-12-19,AE,United Arab Emirates,1133,743852,0,2151,0.2891704263751392
2021-12-26,AE,United Arab Emirates,5678,749530,5,2156,0.2876469254065881
2022-01-02,AE,United Arab Emirates,14963,764493,9,2165,0.2831942215298243
2022-01-09,AE,United Arab Emirates,18373,782866,8,2173,0.2775698523118899
2022-01-16,AE,United Arab Emirates,19315,802181,15,2188,0.2727563978703061
2022-01-23,AE,United Arab Emirates,20705,822886,23,2211,0.2686884939104566
2022-01-30,AE,United Arab Emirates,17853,840739,28,2239,0.2663133267280333
2022-02-06,AE,United Arab Emirates,14903,855642,23,2262,0.26436289943691405
2022-02-13,AE,United Arab Emirates,11329,866971,22,2284,0.2634459514793459
2022-02-20,AE,United Arab Emirates,6911,873882,9,2293,0.26239240538196235
2022-02-27,AE,United Arab Emirates,4864,878746,8,2301,0.261850409560897
2022-03-06,AE,United Arab Emirates,3731,882477,0,2301,0.2607433394864682
2022-03-13,AE,United Arab Emirates,2612,885089,1,2302,0.26008683872469324
2022-03-20,AE,United Arab Emirates,2296,887385,0,2302,0.2594138958851006
2022-03-27,AE,United Arab Emirates,2412,889797,0,2302,0.25871069468654084
2022-04-03,AE,United Arab Emirates,2075,891872,0,2302,0.25810878691112626
2022-04-10,AE,United Arab Emirates,1666,893538,0,2302,0.25762754354039785
2022-04-17,AE,United Arab Emirates,1726,895264,0,2302,0.25713085749008113
2022-04-24,AE,United Arab Emirates,1628,896892,0,2302,0.2566641245545729
2022-05-01,AE,United Arab Emirates,1679,898571,0,2302,0.25618454190041745
2022-05-08,AE,United Arab Emirates,1455,900026,0,2302,0.2557703888554331
2022-05-15,AE,United Arab Emirates,2135,902161,0,2302,0.25516509802574044
2022-05-22,AE,United Arab Emirates,2305,904466,0,2302,0.2545148186885964
2022-05-29,AE,United Arab Emirates,2603,907069,0,2302,0.25378444197740196
2022-06-05,AE,United Arab Emirates,3269,910338,3,2305,0.2532026565956821
2022-06-12,AE,United Arab Emirates,5909,916247,0,2305,0.25156971864573635
2022-06-19,AE,United Arab Emirates,9651,925898,3,2308,0.24927151802898376
2022-06-26,AE,United Arab Emirates,11139,937037,3,2311,0.24662846824618453
2022-07-03,AE,United Arab Emirates,12347,949384,6,2317,0.24405298593614386
2022-07-10,AE,United Arab Emirates,11961,961345,6,2323,0.2416406180923602
2022-07-17,AE,United Arab Emirates,10662,972007,2,2325,0.2391958082606401
2022-07-24,AE,United Arab Emirates,9650,981657,6,2331,0.2374556489690391
2022-07-31,AE,United Arab Emirates,8743,990400,3,2334,0.23566235864297255
2022-08-07,AE,United Arab Emirates,7369,997769,3,2337,0.23422255051018825
2022-08-14,AE,United Arab Emirates,6160,1003929,2,2339,0.23298460349287647
2022-08-21,AE,United Arab Emirates,5187,1009116,2,2341,0.23198522270977767
2022-08-28,AE,United Arab Emirates,4215,1013331,0,2341,0.23102026879667156
2022-09-04,AE,United Arab Emirates,3414,1016745,0,2341,0.23024455492773507
2022-09-11,AE,United Arab Emirates,2880,1019625,1,2342,0.22969228883167833
2022-09-18,AE,United Arab Emirates,2913,1022538,0,2342,0.22903794284417794
2022-09-25,AE,United Arab Emirates,2675,1025213,1,2343,0.2285378745685043
2022-10-02,AE,United Arab Emirates,2720,1027933,2,2345,0.22812770871253282
2022-10-09,AE,United Arab Emirates,2545,1030478,1,2346,0.22766133774811298
2022-10-16,AE,United Arab Emirates,2044,1032522,0,2346,0.22721065507563037
2022-10-23,AE,United Arab Emirates,2262,1034784,2,2348,0.22690725793982125
2022-10-30,AE,United Arab Emirates,2239,1037023,0,2348,0.2264173504348505
2022-11-06,AE,United Arab Emirates,2067,1039090,0,2348,0.22596695185210136
2022-11-13,AE,United Arab Emirates,1731,1040821,0,2348,0.22559114391427537
2022-11-20,AE,United Arab Emirates,1519,1042340,0,2348,0.22526239039085136
2022-11-27,AE,United Arab Emirates,1458,1043798,0,2348,0.22494773893032943
2022-12-04,AE,United Arab Emirates,906,1044704,0,2348,0.22475265721199497
2022-12-11,AE,United Arab Emirates,719,1045423,0,2348,0.2245980813508025
2022-12-18,AE,United Arab Emirates,663,1046086,0,2348,0.2244557330850427
2022-12-25,AE,United Arab Emirates,463,1046549,0,2348,0.22435643242695755
2023-01-01,AE,United Arab Emirates,459,1047008,0,2348,0.22425807634707662
2023-01-08,AE,United Arab Emirates,456,1047464,0,2348,0.22416044847364683
2023-01-15,AE,United Arab Emirates,556,1048020,0,2348,0.22404152592507776
2023-01-22,AE,United Arab Emirates,603,1048623,0,2348,0.22391269312231374
2023-01-29,AE,United Arab Emirates,586,1049209,0,2348,0.22378763430355628
2023-02-05,AE,United Arab Emirates,520,1049729,0,2348,0.22367677753020063
2023-02-12,AE,United Arab Emirates,601,1050330,0,2348,0.2235487894280845
2023-02-19,AE,United Arab Emirates,631,1050961,1,2349,0.2235097211028763
2023-02-26,AE,United Arab Emirates,771,1051732,0,2349,0.2233458713816828
2023-03-05,AE,United Arab Emirates,787,1052519,0,2349,0.22317886898003741
2023-03-12,AE,United Arab Emirates,1067,1053586,0,2349,0.22295284865212714
2023-03-19,AE,United Arab Emirates,1287,1054873,0,2349,0.2226808345649192
2023-03-26,AE,United Arab Emirates,1612,1056485,0,2349,0.22234106494649714
2023-04-02,AE,United Arab Emirates,1515,1058000,0,2349,0.22202268431001893
2023-04-09,AE,United Arab Emirates,1468,1059468,0,2349,0.22171504943990758
2023-04-16,AE,United Arab Emirates,1149,1060617,0,2349,0.22147485850217374
2023-04-23,AE,United Arab Emirates,1040,1061657,0,2349,0.22125790156331096
2023-04-30,AE,United Arab Emirates,1143,1062800,0,2349,0.22101994730899513
2023-05-07,AE,United Arab Emirates,1437,1064237,0,2349,0.2207215122195526
2023-05-14,AE,United Arab Emirates,1370,1065607,0,2349,0.2204377411184424
2023-05-21,AE,United Arab Emirates,1034,1066641,0,2349,0.22022404914118246
2023-05-28,AE,United Arab Emirates,389,1067030,0,2349,0.2201437635305474
2023-06-04,AE,United Arab Emirates,0,1067030,0,2349,0.2201437635305474
2023-06-11,AE,United Arab Emirates,0,1067030,0,2349,0.2201437635305474
2023-06-18,AE,United Arab Emirates,0,1067030,0,2349,0.2201437635305474
2023-06-25,AE,United Arab Emirates,0,1067030,0,2349,0.2201437635305474
2023-07-02,AE,United Arab Emirates,0,1067030,0,2349,0.2201437635305474
2023-07-09,AE,United Arab Emirates,0,1067030,0,2349,0.2201437635305474
2023-07-16,AE,United Arab Emirates,0,1067030,0,2349,0.2201437635305474
2023-07-23,AE,United Arab Emirates,0,1067030,0,2349,0.2201437635305474
2023-07-30,AE,United Arab Emirates,0,1067030,0,2349,0.2201437635305474
2023-08-06,AE,United Arab Emirates,0,1067030,0,2349,0.2201437635305474
2023-08-13,AE,United Arab Emirates,0,1067030,0,2349,0.2201437635305474
2023-08-20,AE,United Arab Emirates,0,1067030,0,2349,0.2201437635305474
2023-08-27,AE,United Arab Emirates,0,1067030,0,2349,0.2201437635305474
2023-09-03,AE,United Arab Emirates,0,1067030,0,2349,0.2201437635305474
2023-09-10,AE,United Arab Emirates,0,1067030,0,2349,0.2201437635305474
2023-09-17,AE,United Arab Emirates,0,1067030,0,2349,0.2201437635305474
2023-09-24,AE,United Arab Emirates,0,1067030,0,2349,0.2201437635305474
2023-10-01,AE,United Arab Emirates,0,1067030,0,2349,0.2201437635305474
2023-10-08,AE,United Arab Emirates,0,1067030,0,2349,0.2201437635305474
2023-10-15,AE,United Arab Emirates,0,1067030,0,2349,0.2201437635305474
2023-10-22,AE,United Arab Emirates,0,1067030,0,2349,0.2201437635305474
2023-10-29,AE,United Arab Emirates,0,1067030,0,2349,0.2201437635305474
2023-11-05,AE,United Arab Emirates,0,1067030,0,2349,0.2201437635305474
2023-11-12,AE,United Arab Emirates,0,1067030,0,2349,0.2201437635305474
2023-11-19,AE,United Arab Emirates,0,1067030,0,2349,0.2201437635305474
2023-11-26,AE,United Arab Emirates,0,1067030,0,2349,0.2201437635305474
2023-12-03,AE,United Arab Emirates,0,1067030,0,2349,0.2201437635305474
2023-12-10,AE,United Arab Emirates,0,1067030,0,2349,0.2201437635305474
2023-12-17,AE,United Arab Emirates,0,1067030,0,2349,0.2201437635305474
2023-12-24,AE,United Arab Emirates,0,1067030,0,2349,0.2201437635305474
2023-12-31,AE,United Arab Emirates,0,1067030,0,2349,0.2201437635305474
2024-01-07,AE,United Arab Emirates,0,1067030,0,2349,0.2201437635305474
2024-01-14,AE,United Arab Emirates,0,1067030,0,2349,0.2201437635305474
2021-02-07,VI,United States Virgin Islands,51,2449,0,24,0.9799918334013884
2021-02-21,VI,United States Virgin Islands,51,2575,0,25,0.9708737864077669
2021-02-28,VI,United States Virgin Islands,71,2646,0,25,0.944822373393802
2021-03-07,VI,United States Virgin Islands,68,2714,0,25,0.9211495946941783
2021-03-14,VI,United States Virgin Islands,53,2767,0,25,0.9035056017347307
2021-03-21,VI,United States Virgin Islands,47,2814,0,25,0.8884150675195452
2021-03-28,VI,United States Virgin Islands,87,2901,1,26,0.8962426749396759
2021-04-04,VI,United States Virgin Islands,30,2931,0,26,0.8870692596383487
2021-04-11,VI,United States Virgin Islands,40,2971,0,26,0.8751262201279031
2021-04-18,VI,United States Virgin Islands,68,3039,1,27,0.8884501480750246
2021-04-25,VI,United States Virgin Islands,41,3080,0,27,0.8766233766233765
2021-05-02,VI,United States Virgin Islands,45,3125,0,27,0.864
2021-05-09,VI,United States Virgin Islands,85,3210,0,27,0.8411214953271028
2021-05-16,VI,United States Virgin Islands,57,3267,0,27,0.8264462809917356
2021-05-23,VI,United States Virgin Islands,79,3346,0,27,0.8069336521219366
2021-05-30,VI,United States Virgin Islands,119,3465,0,27,0.7792207792207793
2021-06-06,VI,United States Virgin Islands,95,3560,1,28,0.7865168539325843
2021-06-13,VI,United States Virgin Islands,130,3690,0,28,0.7588075880758808
2021-06-20,VI,United States Virgin Islands,78,3768,2,30,0.7961783439490446
2021-06-27,VI,United States Virgin Islands,71,3839,0,30,0.7814535035165407
2021-07-04,VI,United States Virgin Islands,63,3902,0,30,0.768836494105587
2021-07-11,VI,United States Virgin Islands,103,4005,2,32,0.7990012484394506
2021-07-18,VI,United States Virgin Islands,155,4160,0,32,0.7692307692307693
2021-07-25,VI,United States Virgin Islands,176,4336,3,35,0.8071955719557196
2021-08-01,VI,United States Virgin Islands,293,4629,2,37,0.7993087059840137
2021-08-08,VI,United States Virgin Islands,278,4907,3,40,0.8151620134501733
2021-08-15,VI,United States Virgin Islands,335,5242,1,41,0.782144219763449
2021-08-22,VI,United States Virgin Islands,352,5594,4,45,0.8044333214158027
2021-08-29,VI,United States Virgin Islands,180,5774,8,53,0.9179078628333911
2022-01-02,VI,United States Virgin Islands,2099,10106,1,89,0.8806649515139521
2022-01-09,VI,United States Virgin Islands,2032,12138,0,89,0.7332344702586917
2022-01-16,VI,United States Virgin Islands,1383,13521,2,91,0.6730271429627986
2022-01-23,VI,United States Virgin Islands,780,14301,4,95,0.6642892105447172
2022-01-30,VI,United States Virgin Islands,545,14846,4,99,0.6668462885625758
2022-02-06,VI,United States Virgin Islands,142,14988,3,102,0.6805444355484388
2022-02-13,VI,United States Virgin Islands,183,15171,3,105,0.6921099466086613
2022-02-20,VI,United States Virgin Islands,112,15283,3,108,0.7066675390957273
2022-02-27,VI,United States Virgin Islands,112,15395,1,109,0.7080220850925625
2022-03-06,VI,United States Virgin Islands,31,15426,0,109,0.7065992480228186
2022-03-13,VI,United States Virgin Islands,130,15556,0,109,0.7006942658781178
2022-03-20,VI,United States Virgin Islands,22,15578,1,110,0.7061240210553344
2022-03-27,VI,United States Virgin Islands,33,15611,0,110,0.7046313496893216
2022-04-03,VI,United States Virgin Islands,45,15656,1,111,0.7089933571793562
2022-04-10,VI,United States Virgin Islands,108,15764,0,111,0.704136006089825
2022-04-17,VI,United States Virgin Islands,118,15882,0,111,0.6989044200982244
2022-04-24,VI,United States Virgin Islands,209,16091,0,111,0.6898266111490896
2022-05-01,VI,United States Virgin Islands,258,16349,0,111,0.6789406079882562
2022-05-08,VI,United States Virgin Islands,818,17167,2,113,0.6582396458321198
2022-05-15,VI,United States Virgin Islands,870,18037,0,113,0.626489992792593
2022-05-22,VI,United States Virgin Islands,817,18854,0,113,0.5993423146281956
2022-05-29,VI,United States Virgin Islands,678,19532,0,113,0.5785377841490887
2022-06-05,VI,United States Virgin Islands,551,20083,0,113,0.5626649404969377
2022-06-12,VI,United States Virgin Islands,328,20411,2,115,0.5634216843858704
2022-06-19,VI,United States Virgin Islands,195,20606,2,117,0.5677957876346695
2022-06-26,VI,United States Virgin Islands,183,20789,1,118,0.5676078695463947
2022-07-03,VI,United States Virgin Islands,171,20960,0,118,0.5629770992366412
2022-07-10,VI,United States Virgin Islands,143,21103,1,119,0.5639008671752831
2022-07-17,VI,United States Virgin Islands,223,21326,1,120,0.5626934258651412
2022-07-24,VI,United States Virgin Islands,243,21569,0,120,0.5563540266122676
2022-07-31,VI,United States Virgin Islands,206,21775,0,120,0.5510907003444316
2022-08-07,VI,United States Virgin Islands,182,21957,1,121,0.5510771052511728
2022-08-14,VI,United States Virgin Islands,178,22135,1,122,0.5511633160153603
2022-08-21,VI,United States Virgin Islands,165,22300,0,122,0.547085201793722
2022-08-28,VI,United States Virgin Islands,181,22481,0,122,0.5426804857435168
2022-09-04,VI,United States Virgin Islands,290,22771,0,122,0.5357691800974924
2022-09-11,VI,United States Virgin Islands,140,22911,0,122,0.5324953079306883
2022-09-18,VI,United States Virgin Islands,120,23031,1,123,0.5340627849420346
2022-09-25,VI,United States Virgin Islands,89,23120,0,123,0.5320069204152249
2022-10-02,VI,United States Virgin Islands,34,23154,0,123,0.5312257061414873
2022-10-09,VI,United States Virgin Islands,53,23207,0,123,0.5300124962295859
2022-10-16,VI,United States Virgin Islands,33,23240,0,123,0.5292598967297762
2022-10-23,VI,United States Virgin Islands,43,23283,0,123,0.5282824378301765
2022-10-30,VI,United States Virgin Islands,50,23333,1,124,0.5314361633737625
2022-11-06,VI,United States Virgin Islands,69,23402,0,124,0.5298692419451329
2022-11-13,VI,United States Virgin Islands,43,23445,0,124,0.5288974194924291
2022-11-20,VI,United States Virgin Islands,24,23469,0,124,0.5283565554561337
2022-11-27,VI,United States Virgin Islands,26,23495,0,124,0.5277718663545435
2022-12-04,VI,United States Virgin Islands,50,23545,1,125,0.5308982798895732
2022-12-11,VI,United States Virgin Islands,88,23633,1,126,0.5331527948208014
2022-12-18,VI,United States Virgin Islands,46,23679,0,126,0.5321170657544659
2022-12-25,VI,United States Virgin Islands,55,23734,1,127,0.5350973287267212
2023-01-01,VI,United States Virgin Islands,47,23781,0,127,0.5340397796560279
2023-01-08,VI,United States Virgin Islands,50,23831,0,127,0.5329193067852797
2023-01-15,VI,United States Virgin Islands,201,24032,1,128,0.5326231691078562
2023-01-22,VI,United States Virgin Islands,237,24269,1,129,0.53154229675718
2023-01-29,VI,United States Virgin Islands,206,24475,0,129,0.5270684371807968
2023-02-05,VI,United States Virgin Islands,109,24584,0,129,0.5247315327041978
2023-02-12,VI,United States Virgin Islands,88,24672,0,129,0.5228599221789882
2023-02-19,VI,United States Virgin Islands,33,24705,1,130,0.5262092693786683
2023-02-26,VI,United States Virgin Islands,51,24756,0,130,0.5251252221683632
2023-03-05,VI,United States Virgin Islands,24,24780,0,130,0.5246166263115416
2023-03-12,VI,United States Virgin Islands,33,24813,0,130,0.5239189134727764
2023-03-19,VI,United States Virgin Islands,18,24831,0,130,0.523539124481495
2023-03-26,VI,United States Virgin Islands,7,24838,0,130,0.5233915774216925
2023-04-02,VI,United States Virgin Islands,25,24863,0,130,0.5228653018541608
2023-04-09,VI,United States Virgin Islands,23,24886,0,130,0.5223820622036486
2023-04-16,VI,United States Virgin Islands,12,24898,0,130,0.5221302915896859
2023-04-23,VI,United States Virgin Islands,9,24907,0,130,0.5219416228369534
2023-04-30,VI,United States Virgin Islands,12,24919,0,130,0.5216902764958465
2023-05-07,VI,United States Virgin Islands,17,24936,1,131,0.5253448829002246
2023-05-14,VI,United States Virgin Islands,58,24994,0,131,0.5241257901896456
2023-05-21,VI,United States Virgin Islands,52,25046,0,131,0.5230376107961351
2023-05-28,VI,United States Virgin Islands,40,25086,0,131,0.5222036195487523
2023-06-04,VI,United States Virgin Islands,36,25122,0,131,0.5214552981450521
2023-06-11,VI,United States Virgin Islands,60,25182,0,131,0.5202128504487332
2023-06-18,VI,United States Virgin Islands,29,25211,0,131,0.519614454008171
2023-06-25,VI,United States Virgin Islands,34,25245,0,131,0.5189146365616953
2023-07-02,VI,United States Virgin Islands,25,25270,1,132,0.5223585278986942
2023-07-09,VI,United States Virgin Islands,23,25293,0,132,0.5218835250859922
2023-07-16,VI,United States Virgin Islands,5,25298,0,132,0.5217803778954858
2023-07-23,VI,United States Virgin Islands,27,25325,0,132,0.5212240868706811
2023-07-30,VI,United States Virgin Islands,64,25389,0,132,0.5199101973295521
2023-08-06,VI,United States Virgin Islands,0,25389,0,132,0.5199101973295521
2023-08-13,VI,United States Virgin Islands,0,25389,0,132,0.5199101973295521
2023-08-20,VI,United States Virgin Islands,0,25389,0,132,0.5199101973295521
2023-08-27,VI,United States Virgin Islands,0,25389,0,132,0.5199101973295521
2023-09-03,VI,United States Virgin Islands,0,25389,0,132,0.5199101973295521
2023-09-10,VI,United States Virgin Islands,0,25389,0,132,0.5199101973295521
2023-09-17,VI,United States Virgin Islands,0,25389,0,132,0.5199101973295521
2023-09-24,VI,United States Virgin Islands,0,25389,0,132,0.5199101973295521
2023-10-01,VI,United States Virgin Islands,0,25389,0,132,0.5199101973295521
2023-10-08,VI,United States Virgin Islands,0,25389,0,132,0.5199101973295521
2023-10-15,VI,United States Virgin Islands,0,25389,0,132,0.5199101973295521
2023-10-22,VI,United States Virgin Islands,0,25389,0,132,0.5199101973295521
2023-10-29,VI,United States Virgin Islands,0,25389,0,132,0.5199101973295521
2023-11-05,VI,United States Virgin Islands,0,25389,0,132,0.5199101973295521
2023-11-12,VI,United States Virgin Islands,0,25389,0,132,0.5199101973295521
2023-11-19,VI,United States Virgin Islands,0,25389,0,132,0.5199101973295521
2023-11-26,VI,United States Virgin Islands,0,25389,0,132,0.5199101973295521
2023-12-03,VI,United States Virgin Islands,0,25389,0,132,0.5199101973295521
2023-12-10,VI,United States Virgin Islands,0,25389,0,132,0.5199101973295521
2023-12-17,VI,United States Virgin Islands,0,25389,0,132,0.5199101973295521
2023-12-24,VI,United States Virgin Islands,0,25389,0,132,0.5199101973295521
2023-12-31,VI,United States Virgin Islands,0,25389,0,132,0.5199101973295521
2024-01-07,VI,United States Virgin Islands,0,25389,0,132,0.5199101973295521
2024-01-14,VI,United States Virgin Islands,0,25389,0,132,0.5199101973295521
2020-12-20,UY,Uruguay,3101,11950,19,109,0.9121338912133891
2020-12-27,UY,Uruguay,3898,15848,34,143,0.9023220595658759
2021-01-03,UY,Uruguay,3905,19753,50,193,0.9770667746671392
2021-01-10,UY,Uruguay,4586,24339,47,240,0.9860717367188463
2021-01-17,UY,Uruguay,6607,30946,51,291,0.940347702449428
2021-03-21,UY,Uruguay,9327,78401,71,760,0.9693753906200177
2021-03-28,UY,Uruguay,13942,92343,115,875,0.9475542271747723
2021-04-04,UY,Uruguay,19225,111568,166,1041,0.933063243940915
2021-04-11,UY,Uruguay,26378,137946,322,1363,0.9880677946442811
2022-02-06,UY,Uruguay,66243,710874,195,6606,0.9292786063352999
2022-02-13,UY,Uruguay,55086,765960,123,6729,0.8785054049819835
2022-02-20,UY,Uruguay,42052,808012,125,6854,0.848254728890165
2022-02-27,UY,Uruguay,27334,835346,95,6949,0.831870865485679
2022-03-06,UY,Uruguay,15895,851241,82,7031,0.8259705535800084
2022-03-13,UY,Uruguay,10912,862153,52,7083,0.8215479155091961
2022-03-20,UY,Uruguay,10785,872938,44,7127,0.8164382808401054
2022-03-27,UY,Uruguay,9441,882379,22,7149,0.810196072209334
2022-04-03,UY,Uruguay,6260,888639,12,7161,0.805839041500542
2022-04-10,UY,Uruguay,4370,893009,20,7181,0.8041352326796258
2022-04-17,UY,Uruguay,2442,895451,12,7193,0.8032823683261284
2022-04-24,UY,Uruguay,2416,897867,10,7203,0.8022346294050232
2022-05-01,UY,Uruguay,1856,899723,7,7210,0.8013577512189862
2022-05-08,UY,Uruguay,2817,902540,3,7213,0.7991889556141557
2022-05-15,UY,Uruguay,5538,908078,2,7215,0.7945352711991701
2022-05-22,UY,Uruguay,8310,916388,12,7227,0.7886397464829309
2022-05-29,UY,Uruguay,9389,925777,11,7238,0.781829749496909
2022-06-05,UY,Uruguay,9184,934961,24,7262,0.7767168897954032
2022-06-12,UY,Uruguay,8916,943877,28,7290,0.7723463968292479
2022-06-19,UY,Uruguay,8071,951948,22,7312,0.7681091824343347
2022-06-26,UY,Uruguay,5681,957629,19,7331,0.7655365491228858
2022-07-03,UY,Uruguay,4622,962251,20,7351,0.7639378914649089
2022-07-10,UY,Uruguay,3119,965370,22,7373,0.7637486145208573
2022-07-17,UY,Uruguay,2438,967808,14,7387,0.7632712273508795
2022-07-24,UY,Uruguay,1995,969803,16,7403,0.7633509073492245
2022-07-31,UY,Uruguay,1925,971728,12,7415,0.7630736173085472
2022-08-07,UY,Uruguay,1692,973420,8,7423,0.7625690863142324
2022-08-14,UY,Uruguay,1844,975264,6,7429,0.7617424615283657
2022-08-21,UY,Uruguay,2041,977305,9,7438,0.7610725413253795
2022-08-28,UY,Uruguay,1855,979160,7,7445,0.7603456023530373
2022-09-04,UY,Uruguay,2026,981186,10,7455,0.7597947789715711
2022-09-11,UY,Uruguay,1660,982846,7,7462,0.7592237237573334
2022-09-18,UY,Uruguay,1306,984152,11,7473,0.7593339240279957
2022-09-25,UY,Uruguay,1270,985422,12,7485,0.7595730560105214
2022-10-02,UY,Uruguay,1024,986446,10,7495,0.7597983062428151
2022-10-09,UY,Uruguay,1117,987563,6,7501,0.7595464795663669
2022-10-16,UY,Uruguay,964,988527,9,7510,0.7597162242407137
2022-10-23,UY,Uruguay,1102,989629,5,7515,0.7593754831355993
2022-10-30,UY,Uruguay,931,990560,3,7518,0.7589646260701017
2022-11-06,UY,Uruguay,659,991219,8,7526,0.7592671246212996
2022-11-13,UY,Uruguay,816,992035,3,7529,0.7589449969003109
2022-11-20,UY,Uruguay,852,992887,1,7530,0.7583944597925041
2022-11-27,UY,Uruguay,988,993875,7,7537,0.758344862281474
2022-12-04,UY,Uruguay,1527,995402,4,7541,0.7575833683275701
2022-12-11,UY,Uruguay,2645,998047,7,7548,0.7562770089985742
2022-12-18,UY,Uruguay,4941,1002988,4,7552,0.7529501848476752
2022-12-25,UY,Uruguay,9000,1011988,10,7562,0.7472420621588398
2023-01-01,UY,Uruguay,8173,1020161,8,7570,0.7420397368650635
2023-01-08,UY,Uruguay,5649,1025810,16,7586,0.7395131652060324
2023-01-15,UY,Uruguay,3754,1029564,11,7597,0.7378851630398887
2023-01-22,UY,Uruguay,2017,1031581,4,7601,0.7368301665114034
2023-01-29,UY,Uruguay,1129,1032710,8,7609,0.7367992950586322
2023-02-05,UY,Uruguay,555,1033265,5,7614,0.7368874393306654
2023-02-12,UY,Uruguay,501,1033766,3,7617,0.7368205183764991
2023-02-19,UY,Uruguay,280,1034046,0,7617,0.7366210013867855
2023-02-26,UY,Uruguay,257,1034303,0,7617,0.7364379683709706
2023-03-05,UY,Uruguay,0,1034303,0,7617,0.7364379683709706
2023-03-12,UY,Uruguay,743,1035046,2,7619,0.7361025500315928
2023-03-19,UY,Uruguay,0,1035046,0,7619,0.7361025500315928
2023-03-26,UY,Uruguay,1113,1036159,2,7621,0.7355048790774389
2023-04-02,UY,Uruguay,0,1036159,0,7621,0.7355048790774389
2023-04-09,UY,Uruguay,0,1036159,0,7621,0.7355048790774389
2023-04-16,UY,Uruguay,936,1037095,0,7621,0.7348410704901672
2023-04-23,UY,Uruguay,798,1037893,4,7625,0.7346614728107811
2023-04-30,UY,Uruguay,0,1037893,0,7625,0.7346614728107811
2023-05-07,UY,Uruguay,0,1037893,0,7625,0.7346614728107811
2023-05-14,UY,Uruguay,0,1037893,0,7625,0.7346614728107811
2023-05-21,UY,Uruguay,0,1037893,0,7625,0.7346614728107811
2023-05-28,UY,Uruguay,98,1037991,0,7625,0.7345921111069363
2023-06-04,UY,Uruguay,58,1038049,0,7625,0.7345510664718139
2023-06-11,UY,Uruguay,61,1038110,1,7626,0.734604232692104
2023-06-18,UY,Uruguay,45,1038155,0,7626,0.7345723904426603
2023-06-25,UY,Uruguay,34,1038189,0,7626,0.7345483336849071
2023-07-02,UY,Uruguay,49,1038238,0,7626,0.7345136664233056
2023-07-09,UY,Uruguay,38,1038276,0,7626,0.7344867838609387
2023-07-16,UY,Uruguay,27,1038303,0,7626,0.7344676842886904
2023-07-23,UY,Uruguay,23,1038326,0,7626,0.7344514150661738
2023-07-30,UY,Uruguay,20,1038346,0,7626,0.7344372685020215
2023-08-06,UY,Uruguay,48,1038394,0,7626,0.7344033189714116
2023-08-13,UY,Uruguay,41,1038435,0,7626,0.7343743228993629
2023-08-20,UY,Uruguay,69,1038504,0,7626,0.7343255298005592
2023-08-27,UY,Uruguay,85,1038589,0,7626,0.7342654312726208
2023-09-03,UY,Uruguay,120,1038709,0,7626,0.7341806030370392
2023-09-10,UY,Uruguay,149,1038858,0,7626,0.7340753019180677
2023-09-17,UY,Uruguay,220,1039078,1,7627,0.7340161181355008
2023-09-24,UY,Uruguay,263,1039341,0,7627,0.7338303790574989
2023-10-01,UY,Uruguay,207,1039548,7,7634,0.7343576246599484
2023-10-08,UY,Uruguay,199,1039747,7,7641,0.7348903146630863
2023-10-15,UY,Uruguay,211,1039958,5,7646,0.7352219993499738
2023-10-22,UY,Uruguay,224,1040182,3,7649,0.7353520826163115
2023-10-29,UY,Uruguay,191,1040373,5,7654,0.7356976776598393
2023-11-05,UY,Uruguay,115,1040488,1,7655,0.7357124733778766
2023-11-12,UY,Uruguay,108,1040596,1,7656,0.7357322149998654
2023-11-19,UY,Uruguay,144,1040740,2,7658,0.7358225877740838
2023-11-26,UY,Uruguay,128,1040868,2,7660,0.7359242478393033
2023-12-03,UY,Uruguay,129,1040997,0,7660,0.7358330523526966
2023-12-10,UY,Uruguay,114,1041111,0,7660,0.7357524798028261
2023-12-17,UY,Uruguay,0,1041111,0,7660,0.7357524798028261
2023-12-24,UY,Uruguay,0,1041111,0,7660,0.7357524798028261
2023-12-31,UY,Uruguay,0,1041111,0,7660,0.7357524798028261
2024-01-07,UY,Uruguay,0,1041111,0,7660,0.7357524798028261
2024-01-14,UY,Uruguay,0,1041111,0,7660,0.7357524798028261
2021-03-28,UZ,Uzbekistan,1123,1132,4,4,0.35335689045936397
2021-04-04,UZ,Uzbekistan,1271,2403,5,9,0.37453183520599254
2021-04-11,UZ,Uzbekistan,1312,3715,3,12,0.3230148048452221
2021-04-18,UZ,Uzbekistan,1868,5583,4,16,0.28658427368798134
2021-04-25,UZ,Uzbekistan,2373,7956,7,23,0.28908999497234794
2021-05-02,UZ,Uzbekistan,2651,10607,8,31,0.29225982841519754
2021-05-09,UZ,Uzbekistan,2753,13360,9,40,0.29940119760479045
2021-05-16,UZ,Uzbekistan,2134,15494,8,48,0.30979734090615724
2021-05-23,UZ,Uzbekistan,1764,17258,10,58,0.3360760227141036
2021-05-30,UZ,Uzbekistan,1678,18936,10,68,0.35910435149978875
2021-06-06,UZ,Uzbekistan,1629,20565,6,74,0.3598346705567712
2021-06-13,UZ,Uzbekistan,1849,22414,12,86,0.38368876594985274
2021-06-20,UZ,Uzbekistan,2639,25053,10,96,0.38318764219853907
2021-06-27,UZ,Uzbekistan,3240,28293,13,109,0.3852543031845333
2021-07-04,UZ,Uzbekistan,3380,31673,20,129,0.40728696365989964
2021-07-11,UZ,Uzbekistan,3349,35022,23,152,0.4340129061732625
2021-07-18,UZ,Uzbekistan,3552,38574,27,179,0.46404313786488305
2021-07-25,UZ,Uzbekistan,5022,43596,37,216,0.495458298926507
2021-08-01,UZ,Uzbekistan,6084,49680,47,263,0.5293880837359097
2021-08-08,UZ,Uzbekistan,6412,56092,48,311,0.5544462668473223
2021-08-15,UZ,Uzbekistan,6406,62498,48,359,0.5744183813882044
2021-08-22,UZ,Uzbekistan,5958,68456,47,406,0.593081687507304
2021-08-29,UZ,Uzbekistan,5763,74219,47,453,0.6103558388013851
2021-09-05,UZ,Uzbekistan,4872,79091,45,498,0.6296544486730474
2021-09-12,UZ,Uzbekistan,4379,83470,39,537,0.6433449143404816
2021-09-19,UZ,Uzbekistan,4048,87518,33,570,0.6512945908270298
2021-09-26,UZ,Uzbekistan,3555,91073,33,603,0.6621062224808669
2021-10-03,UZ,Uzbekistan,3222,94295,24,627,0.6649345140251339
2021-10-10,UZ,Uzbekistan,2922,97217,22,649,0.6675787156567267
2021-10-17,UZ,Uzbekistan,2675,99892,19,668,0.6687222199975974
2021-10-24,UZ,Uzbekistan,2616,102508,16,684,0.6672649939516916
2021-10-31,UZ,Uzbekistan,2316,104824,19,703,0.6706479432191101
2021-11-07,UZ,Uzbekistan,1915,106739,15,718,0.6726688464385089
2021-11-14,UZ,Uzbekistan,1746,108485,18,736,0.678434806655298
2021-11-21,UZ,Uzbekistan,1489,109974,21,757,0.6883445177951152
2021-11-28,UZ,Uzbekistan,1489,111463,21,778,0.6979894673568808
2021-12-05,UZ,Uzbekistan,1491,112954,22,800,0.7082529171167024
2021-12-12,UZ,Uzbekistan,1402,114356,19,819,0.7161845465039002
2021-12-19,UZ,Uzbekistan,1310,115666,21,840,0.7262289696194214
2021-12-26,UZ,Uzbekistan,1119,116785,20,860,0.7363959412595796
2022-01-02,UZ,Uzbekistan,799,117584,4,864,0.7347938495033338
2022-01-09,UZ,Uzbekistan,1548,119132,12,876,0.7353188060302858
2022-01-16,UZ,Uzbekistan,5392,124524,21,897,0.7203430663968392
2022-01-23,UZ,Uzbekistan,8941,133465,24,921,0.6900685572996665
2022-01-30,UZ,Uzbekistan,7945,141410,22,943,0.6668552436178488
2022-02-06,UZ,Uzbekistan,6620,148030,22,965,0.651894886171722
2022-02-13,UZ,Uzbekistan,4133,152163,18,983,0.6460177572734501
2022-02-20,UZ,Uzbekistan,1666,153829,17,1000,0.6500724830818636
2022-02-27,UZ,Uzbekistan,978,154807,14,1014,0.6550091404135472
2022-03-06,UZ,Uzbekistan,562,155369,2,1016,0.6539271025751598
2022-03-13,UZ,Uzbekistan,293,155662,0,1016,0.6526962264393364
2022-03-20,UZ,Uzbekistan,248,155910,0,1016,0.6516580078250273
2022-03-27,UZ,Uzbekistan,171,156081,0,1016,0.650944061096482
2022-04-03,UZ,Uzbekistan,209,156290,0,1016,0.6500735811632222
2022-04-10,UZ,Uzbekistan,200,156490,0,1016,0.649242763115854
2022-04-17,UZ,Uzbekistan,225,156715,0,1016,0.6483106275723447
2022-04-24,UZ,Uzbekistan,190,156905,0,1016,0.6475255727988273
2022-05-01,UZ,Uzbekistan,124,157029,0,1016,0.6470142457762579
2022-05-08,UZ,Uzbekistan,109,157138,0,1016,0.6465654392953964
2022-05-15,UZ,Uzbekistan,82,157220,0,1016,0.6462282152397913
2022-05-22,UZ,Uzbekistan,122,157342,0,1016,0.6457271421489494
2022-05-29,UZ,Uzbekistan,85,157427,0,1016,0.6453784928887675
2022-06-05,UZ,Uzbekistan,110,157537,0,1016,0.6449278582174346
2022-06-12,UZ,Uzbekistan,137,157674,0,1016,0.6443674924210713
2022-06-19,UZ,Uzbekistan,454,158128,0,1016,0.6425174542143074
2022-06-26,UZ,Uzbekistan,752,158880,0,1016,0.6394763343403826
2022-07-03,UZ,Uzbekistan,644,159524,0,1016,0.6368947619167022
2022-07-10,UZ,Uzbekistan,616,160140,0,1016,0.6344448607468465
2022-07-17,UZ,Uzbekistan,567,160707,0,1016,0.6322064378029582
2022-07-24,UZ,Uzbekistan,442,161149,0,1016,0.6304724199343464
2022-07-31,UZ,Uzbekistan,384,161533,0,1016,0.6289736462518495
2022-08-07,UZ,Uzbekistan,229,161762,0,1016,0.6280832333922677
2022-08-14,UZ,Uzbekistan,202,161964,0,1016,0.6272998938035613
2022-08-21,UZ,Uzbekistan,115,162079,0,1016,0.6268548053726887
2022-08-28,UZ,Uzbekistan,101,162180,0,1016,0.6264644222468861
2022-09-04,UZ,Uzbekistan,85,162265,0,1016,0.6261362585893446
2022-09-11,UZ,Uzbekistan,107,162372,0,1016,0.6257236469342005
2022-09-18,UZ,Uzbekistan,90,162462,0,1016,0.6253770112395515
2022-09-25,UZ,Uzbekistan,100,162562,0,1016,0.6249923106260996
2022-10-02,UZ,Uzbekistan,85,162647,0,1016,0.6246656870400314
2022-10-09,UZ,Uzbekistan,89,162736,0,1016,0.6243240585979746
2022-10-16,UZ,Uzbekistan,87,162823,0,1016,0.6239904681771002
2022-10-23,UZ,Uzbekistan,70,162893,0,1016,0.6237223207872652
2022-10-30,UZ,Uzbekistan,148,163041,0,1016,0.623156138639974
2022-11-06,UZ,Uzbekistan,179,163220,0,1016,0.6224727361842912
2022-11-13,UZ,Uzbekistan,220,163440,0,1016,0.6216348507097406
2022-11-20,UZ,Uzbekistan,461,163901,0,1016,0.619886394835907
2022-11-27,UZ,Uzbekistan,740,164641,0,1016,0.6171002362716456
2022-12-04,UZ,Uzbekistan,1056,165697,0,1016,0.6131674079796254
2022-12-11,UZ,Uzbekistan,906,166603,0,1016,0.6098329561892644
2022-12-18,UZ,Uzbekistan,689,167292,0,1016,0.6073213303684576
2022-12-25,UZ,Uzbekistan,0,167292,0,1016,0.6073213303684576
2023-01-01,UZ,Uzbekistan,0,167292,0,1016,0.6073213303684576
2023-01-08,UZ,Uzbekistan,291,167583,0,1016,0.606266745433606
2023-01-15,UZ,Uzbekistan,229,167812,0,1016,0.6054394203036731
2023-01-22,UZ,Uzbekistan,167,167979,0,1016,0.604837509450586
2023-01-29,UZ,Uzbekistan,135,168114,0,1016,0.6043518088915855
2023-02-05,UZ,Uzbekistan,113,168227,0,1016,0.6039458588692659
2023-02-12,UZ,Uzbekistan,123,168350,0,1016,0.6035046035046036
2023-02-19,UZ,Uzbekistan,128,168478,0,1016,0.6030460950391149
2023-02-26,UZ,Uzbekistan,129,168607,0,1016,0.6025847088199185
2023-03-05,UZ,Uzbekistan,173,168780,0,1016,0.6019670577082593
2023-03-12,UZ,Uzbekistan,180,168960,0,1016,0.6013257575757576
2023-03-19,UZ,Uzbekistan,0,168960,0,1016,0.6013257575757576
2023-03-26,UZ,Uzbekistan,169,169129,0,1016,0.6007248904682225
2023-04-02,UZ,Uzbekistan,246,169375,0,1016,0.5998523985239853
2023-04-09,UZ,Uzbekistan,212,169587,0,1016,0.5991025255473592
2023-04-16,UZ,Uzbekistan,235,169822,0,1016,0.5982734863563025
2023-04-23,UZ,Uzbekistan,0,169822,0,1016,0.5982734863563025
2023-04-30,UZ,Uzbekistan,273,170095,0,1016,0.597313266115994
2023-05-07,UZ,Uzbekistan,305,170400,0,1016,0.596244131455399
2023-05-14,UZ,Uzbekistan,231,170631,0,1016,0.5954369370161343
2023-05-21,UZ,Uzbekistan,260,170891,0,1016,0.594531016846996
2023-05-28,UZ,Uzbekistan,0,170891,0,1016,0.594531016846996
2023-06-04,UZ,Uzbekistan,0,170891,0,1016,0.594531016846996
2023-06-11,UZ,Uzbekistan,194,171085,0,1016,0.5938568547797878
2023-06-18,UZ,Uzbekistan,182,171267,0,1016,0.5932257819661698
2023-06-25,UZ,Uzbekistan,150,171417,0,1016,0.5927066743671865
2023-07-02,UZ,Uzbekistan,108,171525,0,1016,0.5923334790846816
2023-07-09,UZ,Uzbekistan,157,171682,0,1016,0.5917918011206766
2023-07-16,UZ,Uzbekistan,160,171842,0,1016,0.5912407909591368
2023-07-23,UZ,Uzbekistan,125,171967,0,1016,0.5908110276971744
2023-07-30,UZ,Uzbekistan,186,172153,0,1016,0.5901726952187879
2023-08-06,UZ,Uzbekistan,176,172329,0,1016,0.5895699505016567
2023-08-13,UZ,Uzbekistan,0,172329,0,1016,0.5895699505016567
2023-08-20,UZ,Uzbekistan,324,172653,0,1016,0.5884635656490185
2023-08-27,UZ,Uzbekistan,360,173013,0,1016,0.5872391091998868
2023-09-03,UZ,Uzbekistan,321,173334,0,1016,0.5861515917246471
2023-09-10,UZ,Uzbekistan,404,173738,0,1016,0.5847885897155487
2023-09-17,UZ,Uzbekistan,385,174123,0,1016,0.583495574967121
2023-09-24,UZ,Uzbekistan,0,174123,0,1016,0.583495574967121
2023-10-01,UZ,Uzbekistan,276,174399,0,1016,0.5825721477760767
2023-10-08,UZ,Uzbekistan,0,174399,0,1016,0.5825721477760767
2023-10-15,UZ,Uzbekistan,176,174575,0,1016,0.5819848202778175
2023-10-22,UZ,Uzbekistan,0,174575,0,1016,0.5819848202778175
2023-10-29,UZ,Uzbekistan,0,174575,0,1016,0.5819848202778175
2023-11-05,UZ,Uzbekistan,0,174575,0,1016,0.5819848202778175
2023-11-12,UZ,Uzbekistan,117,174692,0,1016,0.5815950358344973
2023-11-19,UZ,Uzbekistan,122,174814,0,1016,0.5811891496104431
2023-11-26,UZ,Uzbekistan,102,174916,0,1016,0.5808502366850374
2023-12-03,UZ,Uzbekistan,82,174998,0,1016,0.5805780637493
2023-12-10,UZ,Uzbekistan,83,175081,0,1016,0.5803028312609592
2023-12-17,UZ,Uzbekistan,0,175081,0,1016,0.5803028312609592
2023-12-24,UZ,Uzbekistan,0,175081,0,1016,0.5803028312609592
2023-12-31,UZ,Uzbekistan,0,175081,0,1016,0.5803028312609592
2024-01-07,UZ,Uzbekistan,0,175081,0,1016,0.5803028312609592
2024-01-14,UZ,Uzbekistan,0,175081,0,1016,0.5803028312609592
2022-04-03,VU,Vanuatu,1579,4114,2,2,0.04861448711716091
2022-04-10,VU,Vanuatu,1373,5487,2,4,0.07289958082741024
2022-04-17,VU,Vanuatu,142,5629,2,6,0.10659086871558003
2022-04-24,VU,Vanuatu,1233,6862,6,12,0.17487612940833577
2022-05-01,VU,Vanuatu,651,7513,1,13,0.17303340875815254
2022-05-08,VU,Vanuatu,394,7907,1,14,0.17705830276969772
2022-05-15,VU,Vanuatu,555,8462,0,14,0.16544552115339162
2022-05-22,VU,Vanuatu,204,8666,0,14,0.16155088852988692
2022-05-29,VU,Vanuatu,346,9012,0,14,0.1553484243231247
2022-06-05,VU,Vanuatu,1105,10117,0,14,0.1383809429672828
2022-06-12,VU,Vanuatu,521,10638,0,14,0.13160368490317728
2022-06-19,VU,Vanuatu,293,10931,0,14,0.1280761138047754
2022-06-26,VU,Vanuatu,250,11181,0,14,0.12521241391646543
2022-07-03,VU,Vanuatu,92,11273,0,14,0.12419054377716668
2022-07-10,VU,Vanuatu,315,11588,0,14,0.12081463583016915
2022-07-17,VU,Vanuatu,132,11720,0,14,0.11945392491467575
2022-07-24,VU,Vanuatu,0,11720,0,14,0.11945392491467575
2022-07-31,VU,Vanuatu,5,11725,0,14,0.11940298507462686
2022-08-07,VU,Vanuatu,6,11731,0,14,0.11934191458528684
2022-08-14,VU,Vanuatu,3,11734,0,14,0.11931140276120675
2022-08-21,VU,Vanuatu,36,11770,0,14,0.11894647408666101
2022-08-28,VU,Vanuatu,10,11780,0,14,0.11884550084889642
2022-09-04,VU,Vanuatu,83,11863,0,14,0.11801399308775183
2022-09-11,VU,Vanuatu,36,11899,0,14,0.11765694596184555
2022-09-18,VU,Vanuatu,51,11950,0,14,0.11715481171548119
2022-09-25,VU,Vanuatu,0,11950,0,14,0.11715481171548119
2022-10-02,VU,Vanuatu,24,11974,0,14,0.11691999331885754
2022-10-09,VU,Vanuatu,2,11976,0,14,0.11690046760187041
2022-10-16,VU,Vanuatu,0,11976,0,14,0.11690046760187041
2022-10-23,VU,Vanuatu,5,11981,0,14,0.11685168182956347
2022-10-30,VU,Vanuatu,0,11981,0,14,0.11685168182956347
2022-11-06,VU,Vanuatu,0,11981,0,14,0.11685168182956347
2022-11-13,VU,Vanuatu,0,11981,0,14,0.11685168182956347
2022-11-20,VU,Vanuatu,0,11981,0,14,0.11685168182956347
2022-11-27,VU,Vanuatu,0,11981,0,14,0.11685168182956347
2022-12-04,VU,Vanuatu,30,12011,0,14,0.11655982016484888
2022-12-11,VU,Vanuatu,0,12011,0,14,0.11655982016484888
2022-12-18,VU,Vanuatu,0,12011,0,14,0.11655982016484888
2022-12-25,VU,Vanuatu,2,12013,0,14,0.11654041455090318
2023-01-01,VU,Vanuatu,1,12014,0,14,0.1165307141668054
2023-01-08,VU,Vanuatu,0,12014,0,14,0.1165307141668054
2023-01-15,VU,Vanuatu,0,12014,0,14,0.1165307141668054
2023-01-22,VU,Vanuatu,0,12014,0,14,0.1165307141668054
2023-01-29,VU,Vanuatu,0,12014,0,14,0.1165307141668054
2023-02-05,VU,Vanuatu,0,12014,0,14,0.1165307141668054
2023-02-12,VU,Vanuatu,0,12014,0,14,0.1165307141668054
2023-02-19,VU,Vanuatu,0,12014,0,14,0.1165307141668054
2023-02-26,VU,Vanuatu,0,12014,0,14,0.1165307141668054
2023-03-05,VU,Vanuatu,0,12014,0,14,0.1165307141668054
2023-03-12,VU,Vanuatu,0,12014,0,14,0.1165307141668054
2023-03-19,VU,Vanuatu,0,12014,0,14,0.1165307141668054
2023-03-26,VU,Vanuatu,0,12014,0,14,0.1165307141668054
2023-04-02,VU,Vanuatu,0,12014,0,14,0.1165307141668054
2023-04-09,VU,Vanuatu,0,12014,0,14,0.1165307141668054
2023-04-16,VU,Vanuatu,0,12014,0,14,0.1165307141668054
2023-04-23,VU,Vanuatu,2,12016,0,14,0.11651131824234355
2023-04-30,VU,Vanuatu,0,12016,0,14,0.11651131824234355
2023-05-07,VU,Vanuatu,0,12016,0,14,0.11651131824234355
2023-05-14,VU,Vanuatu,0,12016,0,14,0.11651131824234355
2023-05-21,VU,Vanuatu,0,12016,0,14,0.11651131824234355
2023-05-28,VU,Vanuatu,0,12016,0,14,0.11651131824234355
2023-06-04,VU,Vanuatu,3,12019,0,14,0.11648223645894001
2023-06-11,VU,Vanuatu,0,12019,0,14,0.11648223645894001
2023-06-18,VU,Vanuatu,0,12019,0,14,0.11648223645894001
2023-06-25,VU,Vanuatu,0,12019,0,14,0.11648223645894001
2023-07-02,VU,Vanuatu,0,12019,0,14,0.11648223645894001
2023-07-09,VU,Vanuatu,0,12019,0,14,0.11648223645894001
2023-07-16,VU,Vanuatu,0,12019,0,14,0.11648223645894001
2023-07-23,VU,Vanuatu,0,12019,0,14,0.11648223645894001
2023-07-30,VU,Vanuatu,0,12019,0,14,0.11648223645894001
2023-08-06,VU,Vanuatu,0,12019,0,14,0.11648223645894001
2023-08-13,VU,Vanuatu,0,12019,0,14,0.11648223645894001
2023-08-20,VU,Vanuatu,0,12019,0,14,0.11648223645894001
2023-08-27,VU,Vanuatu,0,12019,0,14,0.11648223645894001
2023-09-03,VU,Vanuatu,0,12019,0,14,0.11648223645894001
2023-09-10,VU,Vanuatu,0,12019,0,14,0.11648223645894001
2023-09-17,VU,Vanuatu,0,12019,0,14,0.11648223645894001
2023-09-24,VU,Vanuatu,0,12019,0,14,0.11648223645894001
2023-10-01,VU,Vanuatu,0,12019,0,14,0.11648223645894001
2023-10-08,VU,Vanuatu,0,12019,0,14,0.11648223645894001
2023-10-15,VU,Vanuatu,0,12019,0,14,0.11648223645894001
2023-10-22,VU,Vanuatu,0,12019,0,14,0.11648223645894001
2023-10-29,VU,Vanuatu,0,12019,0,14,0.11648223645894001
2023-11-05,VU,Vanuatu,0,12019,0,14,0.11648223645894001
2023-11-12,VU,Vanuatu,0,12019,0,14,0.11648223645894001
2023-11-19,VU,Vanuatu,0,12019,0,14,0.11648223645894001
2023-11-26,VU,Vanuatu,0,12019,0,14,0.11648223645894001
2023-12-03,VU,Vanuatu,0,12019,0,14,0.11648223645894001
2023-12-10,VU,Vanuatu,0,12019,0,14,0.11648223645894001
2023-12-17,VU,Vanuatu,0,12019,0,14,0.11648223645894001
2023-12-24,VU,Vanuatu,0,12019,0,14,0.11648223645894001
2023-12-31,VU,Vanuatu,0,12019,0,14,0.11648223645894001
2024-01-07,VU,Vanuatu,0,12019,0,14,0.11648223645894001
2024-01-14,VU,Vanuatu,0,12019,0,14,0.11648223645894001
2020-06-07,VE,Venezuela (Bolivarian Republic of),775,2145,6,20,0.9324009324009324
2020-06-14,VE,Venezuela (Bolivarian Republic of),734,2879,3,23,0.798888502952414
2020-06-21,VE,Venezuela (Bolivarian Republic of),712,3591,7,30,0.835421888053467
2020-06-28,VE,Venezuela (Bolivarian Republic of),1188,4779,11,41,0.857920066959615
2020-07-05,VE,Venezuela (Bolivarian Republic of),1758,6537,18,59,0.90255468869512
2020-07-12,VE,Venezuela (Bolivarian Republic of),2266,8803,24,83,0.9428603885039192
2020-07-19,VE,Venezuela (Bolivarian Republic of),2388,11191,24,107,0.9561254579572871
2020-07-26,VE,Venezuela (Bolivarian Republic of),3072,14263,27,134,0.9394937951342636
2020-08-02,VE,Venezuela (Bolivarian Republic of),4311,18574,30,164,0.8829546678152256
2020-08-09,VE,Venezuela (Bolivarian Republic of),5592,24166,44,208,0.860713398990317
2020-08-16,VE,Venezuela (Bolivarian Republic of),7215,31381,58,266,0.8476466651795673
2020-08-23,VE,Venezuela (Bolivarian Republic of),6807,38188,51,317,0.8301036974965958
2020-08-30,VE,Venezuela (Bolivarian Republic of),5691,43879,41,358,0.8158800337291187
2020-09-06,VE,Venezuela (Bolivarian Republic of),7094,50973,54,412,0.8082710454554372
2020-09-13,VE,Venezuela (Bolivarian Republic of),7690,58663,56,468,0.7977771337981351
2020-09-20,VE,Venezuela (Bolivarian Republic of),6511,65174,62,530,0.8132077208702857
2020-09-27,VE,Venezuela (Bolivarian Republic of),6099,71273,61,591,0.8292060106912855
2020-10-04,VE,Venezuela (Bolivarian Republic of),5547,76820,52,643,0.837021608956001
2020-10-11,VE,Venezuela (Bolivarian Republic of),4876,81696,41,684,0.8372502937720329
2020-10-18,VE,Venezuela (Bolivarian Republic of),4062,85758,41,725,0.8454021782224399
2020-10-25,VE,Venezuela (Bolivarian Republic of),2658,88416,34,759,0.8584419109663409
2020-11-01,VE,Venezuela (Bolivarian Republic of),3173,91589,34,793,0.8658244985751564
2020-11-08,VE,Venezuela (Bolivarian Republic of),2716,94305,28,821,0.8705795026774826
2020-11-15,VE,Venezuela (Bolivarian Republic of),2136,96441,23,844,0.8751464626040792
2020-11-22,VE,Venezuela (Bolivarian Republic of),2576,99017,22,866,0.8745972913742085
2020-11-29,VE,Venezuela (Bolivarian Republic of),2507,101524,22,888,0.8746700287616722
2020-12-06,VE,Venezuela (Bolivarian Republic of),2353,103877,25,913,0.8789241121711255
2020-12-13,VE,Venezuela (Bolivarian Republic of),2838,106715,31,944,0.884599166002905
2020-12-20,VE,Venezuela (Bolivarian Republic of),2680,109395,35,979,0.8949220713926596
2020-12-27,VE,Venezuela (Bolivarian Republic of),2208,111603,31,1010,0.9049935933621855
2021-01-03,VE,Venezuela (Bolivarian Republic of),1959,113562,18,1028,0.9052323840721368
2021-01-10,VE,Venezuela (Bolivarian Republic of),2105,115667,28,1056,0.9129656686868338
2021-01-17,VE,Venezuela (Bolivarian Republic of),3189,118856,39,1095,0.9212828969509322
2021-01-24,VE,Venezuela (Bolivarian Republic of),3939,122795,41,1136,0.9251191009405921
2021-01-31,VE,Venezuela (Bolivarian Republic of),2981,125776,41,1177,0.93579061188144
2021-02-07,VE,Venezuela (Bolivarian Republic of),3455,129231,46,1223,0.9463673576773375
2021-02-14,VE,Venezuela (Bolivarian Republic of),3028,132259,44,1267,0.9579688338789799
2021-02-21,VE,Venezuela (Bolivarian Republic of),2855,135114,41,1308,0.968071406367956
2021-02-28,VE,Venezuela (Bolivarian Republic of),3181,138295,30,1338,0.9674970172457429
2021-03-07,VE,Venezuela (Bolivarian Republic of),3061,141356,33,1371,0.9698916211550979
2021-03-14,VE,Venezuela (Bolivarian Republic of),3430,144786,51,1422,0.9821391571008247
2021-03-21,VE,Venezuela (Bolivarian Republic of),4359,149145,53,1475,0.9889704649837407
2020-08-02,VN,Viet Nam,172,590,3,3,0.5084745762711864
2021-05-16,VN,Viet Nam,800,4212,2,37,0.8784425451092117
2021-05-23,VN,Viet Nam,1063,5275,5,42,0.7962085308056872
2021-05-30,VN,Viet Nam,1893,7168,5,47,0.6556919642857143
2021-06-06,VN,Viet Nam,1623,8791,6,53,0.6028893186213173
2021-06-13,VN,Viet Nam,1839,10630,7,60,0.5644402634054563
2021-06-20,VN,Viet Nam,2628,13258,7,67,0.5053552572031981
2021-06-27,VN,Viet Nam,2482,15740,13,80,0.5082592121982211
2021-07-04,VN,Viet Nam,4521,20261,19,99,0.48862346379744337
2021-07-11,VN,Viet Nam,10217,30478,63,162,0.5315309403504167
2021-07-18,VN,Viet Nam,25367,55845,92,254,0.454830333960068
2021-07-25,VN,Viet Nam,45328,101173,116,370,0.36571021912960966
2021-08-01,VN,Viet Nam,56334,157507,936,1306,0.8291694972286946
2022-03-06,VN,Viet Nam,1113695,4434700,669,40813,0.9203102802895349
2022-03-13,VN,Viet Nam,1677948,6112648,572,41385,0.6770388218003065
2022-03-20,VN,Viet Nam,1845400,7958048,495,41880,0.5262597058977277
2022-03-27,VN,Viet Nam,1053425,9011473,426,42306,0.4694681990391582
2022-04-03,VN,Viet Nam,806855,9818328,294,42600,0.4338824288616147
2022-04-10,VN,Viet Nam,379908,10198236,213,42813,0.41980789618910563
2022-04-17,VN,Viet Nam,234311,10432547,131,42944,0.41163485771978786
2022-04-24,VN,Viet Nam,130955,10563502,69,43013,0.4071850414758288
2022-05-01,VN,Viet Nam,90024,10653526,29,43042,0.4040164730437603
2022-05-08,VN,Viet Nam,22658,10676184,14,43056,0.4032901643508579
2022-05-15,VN,Viet Nam,20446,10696630,9,43065,0.40260343678336075
2022-05-22,VN,Viet Nam,12257,10708887,10,43075,0.4022360120150675
2022-05-29,VN,Viet Nam,8364,10717251,3,43078,0.4019500896265283
2022-06-05,VN,Viet Nam,7988,10725239,3,43081,0.4016786945260614
2022-06-12,VN,Viet Nam,6573,10731812,2,43083,0.4014513112976634
2022-06-19,VN,Viet Nam,5828,10737640,0,43083,0.40123341814402425
2022-06-26,VN,Viet Nam,5808,10743448,1,43084,0.40102581592054987
2022-07-03,VN,Viet Nam,4679,10748127,4,43088,0.4008884524717655
2022-07-10,VN,Viet Nam,6221,10754348,1,43089,0.4006658516164811
2022-07-17,VN,Viet Nam,5502,10759850,2,43091,0.40047956058866996
2022-07-24,VN,Viet Nam,7350,10767200,1,43092,0.4002154692027639
2022-07-31,VN,Viet Nam,7479,10774679,1,43093,0.3999469496956708
2022-08-07,VN,Viet Nam,571458,11346137,1,43094,0.3798120893481191
2022-08-14,VN,Viet Nam,18218,11364355,4,43098,0.37923841696251126
2022-08-21,VN,Viet Nam,17903,11382258,8,43106,0.37871220279842543
2022-08-28,VN,Viet Nam,19339,11401597,7,43113,0.3781312389834512
2022-09-04,VN,Viet Nam,15906,11417503,9,43122,0.3776832815371277
2022-09-11,VN,Viet Nam,20467,11437970,8,43130,0.3770774009723753
2022-09-18,VN,Viet Nam,18588,11456558,11,43141,0.37656161649947567
2022-09-25,VN,Viet Nam,14782,11471340,5,43146,0.3761199650607514
2022-10-02,VN,Viet Nam,8688,11480028,5,43151,0.3758788741630247
2022-10-09,VN,Viet Nam,5333,11485361,2,43153,0.37572175572017286
2022-10-16,VN,Viet Nam,6912,11492273,2,43155,0.37551318177004667
2022-10-23,VN,Viet Nam,4556,11496829,4,43159,0.37539916441307425
2022-10-30,VN,Viet Nam,5340,11502169,4,43163,0.37525965754806767
2022-11-06,VN,Viet Nam,3439,11505608,3,43166,0.3751735675333281
2022-11-13,VN,Viet Nam,2839,11508447,0,43166,0.37508101657851833
2022-11-20,VN,Viet Nam,2731,11511178,3,43169,0.3750180911110922
2022-11-27,VN,Viet Nam,2996,11514174,1,43170,0.3749291959631668
2022-12-04,VN,Viet Nam,3343,11517517,7,43177,0.3748811484280857
2022-12-11,VN,Viet Nam,2928,11520445,2,43179,0.37480323025716455
2022-12-18,VN,Viet Nam,2305,11522750,1,43180,0.37473693345772496
2022-12-25,VN,Viet Nam,1452,11524202,4,43184,0.37472442777382764
2023-01-01,VN,Viet Nam,1029,11525231,2,43186,0.37470832471817705
2023-01-08,VN,Viet Nam,480,11525711,0,43186,0.37469271960749323
2023-01-15,VN,Viet Nam,407,11526118,0,43186,0.37467948879232366
2023-01-22,VN,Viet Nam,200,11526318,0,43186,0.3746729875056371
2023-01-29,VN,Viet Nam,77,11526395,0,43186,0.37467048457041424
2023-02-05,VN,Viet Nam,171,11526566,0,43186,0.3746649262234737
2023-02-12,VN,Viet Nam,85,11526651,0,43186,0.3746621633638426
2023-02-19,VN,Viet Nam,155,11526806,0,43186,0.3746571253129445
2023-02-26,VN,Viet Nam,85,11526891,0,43186,0.374654362568363
2023-03-05,VN,Viet Nam,59,11526950,0,43186,0.37465244492255106
2023-03-12,VN,Viet Nam,83,11527033,0,43186,0.3746497472506585
2023-03-19,VN,Viet Nam,83,11527116,0,43186,0.37464704961761464
2023-03-26,VN,Viet Nam,87,11527203,0,43186,0.3746442220198603
2023-04-02,VN,Viet Nam,113,11527316,0,43186,0.37464054945661246
2023-04-09,VN,Viet Nam,385,11527701,0,43186,0.3746280372816748
2023-04-16,VN,Viet Nam,2655,11530356,0,43186,0.3745417747726089
2023-04-23,VN,Viet Nam,12704,11543060,1,43187,0.3741382267786878
2023-04-30,VN,Viet Nam,16802,11559862,4,43191,0.37362902775136936
2023-05-07,VN,Viet Nam,14069,11573931,5,43196,0.37321805357229104
2023-05-14,VN,Viet Nam,15636,11589567,5,43201,0.3727576707568109
2023-05-21,VN,Viet Nam,12192,11601759,2,43203,0.3723831877562704
2023-05-28,VN,Viet Nam,7778,11609537,3,43206,0.37215954434703125
2023-06-04,VN,Viet Nam,5046,11614583,0,43206,0.371997858209804
2023-06-11,VN,Viet Nam,2914,11617497,0,43206,0.3719045505240931
2023-06-18,VN,Viet Nam,1770,11619267,0,43206,0.3718478971177786
2023-06-25,VN,Viet Nam,780,11620047,0,43206,0.3718229366886382
2023-07-02,VN,Viet Nam,549,11620596,0,43206,0.37180537039580414
2023-07-09,VN,Viet Nam,437,11621033,0,43206,0.3717913889410692
2023-07-16,VN,Viet Nam,287,11621320,0,43206,0.371782207184726
2023-07-23,VN,Viet Nam,279,11621599,0,43206,0.37177328180055086
2023-07-30,VN,Viet Nam,199,11621798,0,43206,0.37176691592815503
2023-08-06,VN,Viet Nam,180,11621978,0,43206,0.37176115804039556
2023-08-13,VN,Viet Nam,226,11622204,0,43206,0.37175392894497467
2023-08-20,VN,Viet Nam,200,11622404,0,43206,0.37174753174988584
2023-08-27,VN,Viet Nam,279,11622683,0,43206,0.371738608030521
2023-09-03,VN,Viet Nam,229,11622912,0,43206,0.37173128386414694
2023-09-10,VN,Viet Nam,270,11623182,0,43206,0.37172264875487626
2023-09-17,VN,Viet Nam,190,11623372,0,43206,0.371716572436983
2023-09-24,VN,Viet Nam,199,11623571,0,43206,0.37171020850649084
2023-10-01,VN,Viet Nam,127,11623698,0,43206,0.37170614721752065
2023-10-08,VN,Viet Nam,147,11623845,0,43206,0.37170144646629405
2023-10-15,VN,Viet Nam,142,11623987,0,43206,0.37169690571746167
2023-10-22,VN,Viet Nam,13,11624000,0,43206,0.3716964900206469
2023-10-29,VN,Viet Nam,0,11624000,0,43206,0.3716964900206469
2023-11-05,VN,Viet Nam,0,11624000,0,43206,0.3716964900206469
2023-11-12,VN,Viet Nam,0,11624000,0,43206,0.3716964900206469
2023-11-19,VN,Viet Nam,0,11624000,0,43206,0.3716964900206469
2023-11-26,VN,Viet Nam,0,11624000,0,43206,0.3716964900206469
2023-12-03,VN,Viet Nam,0,11624000,0,43206,0.3716964900206469
2023-12-10,VN,Viet Nam,0,11624000,0,43206,0.3716964900206469
2023-12-17,VN,Viet Nam,0,11624000,0,43206,0.3716964900206469
2023-12-24,VN,Viet Nam,0,11624000,0,43206,0.3716964900206469
2023-12-31,VN,Viet Nam,0,11624000,0,43206,0.3716964900206469
2024-01-07,VN,Viet Nam,0,11624000,0,43206,0.3716964900206469
2024-01-14,VN,Viet Nam,0,11624000,0,43206,0.3716964900206469
2022-07-31,WF,Wallis and Futuna,174,761,0,7,0.9198423127463863
2022-08-07,WF,Wallis and Futuna,0,761,0,7,0.9198423127463863
2022-08-14,WF,Wallis and Futuna,0,761,0,7,0.9198423127463863
2022-08-21,WF,Wallis and Futuna,0,761,0,7,0.9198423127463863
2022-08-28,WF,Wallis and Futuna,0,761,0,7,0.9198423127463863
2022-09-04,WF,Wallis and Futuna,0,761,0,7,0.9198423127463863
2022-09-11,WF,Wallis and Futuna,0,761,0,7,0.9198423127463863
2022-09-18,WF,Wallis and Futuna,0,761,0,7,0.9198423127463863
2022-09-25,WF,Wallis and Futuna,0,761,0,7,0.9198423127463863
2022-10-02,WF,Wallis and Futuna,0,761,0,7,0.9198423127463863
2022-10-09,WF,Wallis and Futuna,0,761,0,7,0.9198423127463863
2022-10-16,WF,Wallis and Futuna,2654,3415,0,7,0.20497803806734993
2022-10-23,WF,Wallis and Futuna,0,3415,0,7,0.20497803806734993
2022-10-30,WF,Wallis and Futuna,0,3415,0,7,0.20497803806734993
2022-11-06,WF,Wallis and Futuna,0,3415,0,7,0.20497803806734993
2022-11-13,WF,Wallis and Futuna,0,3415,0,7,0.20497803806734993
2022-11-20,WF,Wallis and Futuna,0,3415,0,7,0.20497803806734993
2022-11-27,WF,Wallis and Futuna,0,3415,0,7,0.20497803806734993
2022-12-04,WF,Wallis and Futuna,0,3415,0,7,0.20497803806734993
2022-12-11,WF,Wallis and Futuna,0,3415,0,7,0.20497803806734993
2022-12-18,WF,Wallis and Futuna,0,3415,0,7,0.20497803806734993
2022-12-25,WF,Wallis and Futuna,0,3415,0,7,0.20497803806734993
2023-01-01,WF,Wallis and Futuna,12,3427,0,7,0.20426028596440038
2023-01-08,WF,Wallis and Futuna,0,3427,0,7,0.20426028596440038
2023-01-15,WF,Wallis and Futuna,0,3427,0,7,0.20426028596440038
2023-01-22,WF,Wallis and Futuna,0,3427,0,7,0.20426028596440038
2023-01-29,WF,Wallis and Futuna,0,3427,0,7,0.20426028596440038
2023-02-05,WF,Wallis and Futuna,0,3427,0,7,0.20426028596440038
2023-02-12,WF,Wallis and Futuna,0,3427,0,7,0.20426028596440038
2023-02-19,WF,Wallis and Futuna,0,3427,0,7,0.20426028596440038
2023-02-26,WF,Wallis and Futuna,0,3427,0,7,0.20426028596440038
2023-03-05,WF,Wallis and Futuna,0,3427,0,7,0.20426028596440038
2023-03-12,WF,Wallis and Futuna,0,3427,0,7,0.20426028596440038
2023-03-19,WF,Wallis and Futuna,0,3427,0,7,0.20426028596440038
2023-03-26,WF,Wallis and Futuna,0,3427,0,7,0.20426028596440038
2023-04-02,WF,Wallis and Futuna,0,3427,0,7,0.20426028596440038
2023-04-09,WF,Wallis and Futuna,0,3427,0,7,0.20426028596440038
2023-04-16,WF,Wallis and Futuna,0,3427,0,7,0.20426028596440038
2023-04-23,WF,Wallis and Futuna,0,3427,0,7,0.20426028596440038
2023-04-30,WF,Wallis and Futuna,0,3427,0,7,0.20426028596440038
2023-05-07,WF,Wallis and Futuna,0,3427,0,7,0.20426028596440038
2023-05-14,WF,Wallis and Futuna,0,3427,0,7,0.20426028596440038
2023-05-21,WF,Wallis and Futuna,81,3508,0,7,0.19954389965792474
2023-05-28,WF,Wallis and Futuna,0,3508,0,7,0.19954389965792474
2023-06-04,WF,Wallis and Futuna,42,3550,1,8,0.22535211267605634
2023-06-11,WF,Wallis and Futuna,0,3550,0,8,0.22535211267605634
2023-06-18,WF,Wallis and Futuna,0,3550,0,8,0.22535211267605634
2023-06-25,WF,Wallis and Futuna,0,3550,0,8,0.22535211267605634
2023-07-02,WF,Wallis and Futuna,0,3550,0,8,0.22535211267605634
2023-07-09,WF,Wallis and Futuna,0,3550,0,8,0.22535211267605634
2023-07-16,WF,Wallis and Futuna,0,3550,0,8,0.22535211267605634
2023-07-23,WF,Wallis and Futuna,0,3550,0,8,0.22535211267605634
2023-07-30,WF,Wallis and Futuna,0,3550,0,8,0.22535211267605634
2023-08-06,WF,Wallis and Futuna,0,3550,0,8,0.22535211267605634
2023-08-13,WF,Wallis and Futuna,0,3550,0,8,0.22535211267605634
2023-08-20,WF,Wallis and Futuna,0,3550,0,8,0.22535211267605634
2023-08-27,WF,Wallis and Futuna,0,3550,0,8,0.22535211267605634
2023-09-03,WF,Wallis and Futuna,0,3550,0,8,0.22535211267605634
2023-09-10,WF,Wallis and Futuna,0,3550,0,8,0.22535211267605634
2023-09-17,WF,Wallis and Futuna,0,3550,0,8,0.22535211267605634
2023-09-24,WF,Wallis and Futuna,0,3550,0,8,0.22535211267605634
2023-10-01,WF,Wallis and Futuna,0,3550,0,8,0.22535211267605634
2023-10-08,WF,Wallis and Futuna,0,3550,0,8,0.22535211267605634
2023-10-15,WF,Wallis and Futuna,0,3550,0,8,0.22535211267605634
2023-10-22,WF,Wallis and Futuna,0,3550,0,8,0.22535211267605634
2023-10-29,WF,Wallis and Futuna,0,3550,0,8,0.22535211267605634
2023-11-05,WF,Wallis and Futuna,0,3550,0,8,0.22535211267605634
2023-11-12,WF,Wallis and Futuna,0,3550,0,8,0.22535211267605634
2023-11-19,WF,Wallis and Futuna,0,3550,0,8,0.22535211267605634
2023-11-26,WF,Wallis and Futuna,0,3550,0,8,0.22535211267605634
2023-12-03,WF,Wallis and Futuna,0,3550,0,8,0.22535211267605634
2023-12-10,WF,Wallis and Futuna,0,3550,0,8,0.22535211267605634
2023-12-17,WF,Wallis and Futuna,0,3550,0,8,0.22535211267605634
2023-12-24,WF,Wallis and Futuna,0,3550,0,8,0.22535211267605634
2023-12-31,WF,Wallis and Futuna,0,3550,0,8,0.22535211267605634
2024-01-07,WF,Wallis and Futuna,0,3550,0,8,0.22535211267605634
2024-01-14,WF,Wallis and Futuna,0,3550,0,8,0.22535211267605634
2020-05-24,ZM,Zambia,241,920,0,9,0.9782608695652175
2020-05-31,ZM,Zambia,137,1057,0,9,0.8514664143803218
2020-06-07,ZM,Zambia,97,1154,0,9,0.779896013864818
2020-06-14,ZM,Zambia,203,1357,0,9,0.6632277081798084
2020-06-21,ZM,Zambia,81,1438,1,10,0.6954102920723227
